date,away_team,away_q1,away_q2,away_q3,away_q4,away_OT,away_final,home_team,home_q1,home_q2,home_q3,home_q4,home_OT,home_final
10/30/2014,NYK,18,24,25,28,0,95,CLE,25,19,20,26,0,90
10/31/2014,CLE,28,30,20,20,16,114,CHI,27,25,17,29,10,108
11/4/2014,CLE,34,16,19,13,0,82,POR,31,24,21,25,0,101
11/5/2014,CLE,23,25,27,25,0,100,UTA,32,27,17,26,0,102
11/7/2014,CLE,38,20,27,25,0,110,DEN,20,25,26,30,0,101
11/10/2014,NOP,28,28,23,32,0,111,CLE,24,27,34,33,0,118
11/14/2014,CLE,25,34,25,38,0,122,BOS,31,28,42,20,0,121
11/15/2014,ATL,25,18,26,25,0,94,CLE,41,30,30,26,0,127
11/17/2014,DEN,24,29,28,25,0,106,CLE,26,26,23,22,0,97
11/19/2014,SAS,23,21,28,20,0,92,CLE,20,27,22,21,0,90
11/21/2014,CLE,21,21,23,13,0,78,WAS,26,29,25,11,0,91
11/22/2014,TOR,21,35,29,25,0,110,CLE,34,20,17,22,0,93
11/24/2014,ORL,16,22,20,16,0,74,CLE,26,30,25,25,0,106
11/26/2014,WAS,18,28,21,20,0,87,CLE,31,27,23,32,0,113
11/29/2014,IND,21,28,22,26,0,97,CLE,29,23,35,22,0,109
12/2/2014,MIL,23,31,25,29,0,108,CLE,30,22,27,32,0,111
12/4/2014,CLE,25,25,18,22,0,90,NYK,24,29,20,14,0,87
12/5/2014,CLE,30,21,25,29,0,105,TOR,21,23,20,27,0,91
12/8/2014,CLE,22,28,35,25,0,110,BRK,25,24,18,21,0,88
12/9/2014,TOR,33,30,25,13,0,101,CLE,26,29,26,24,0,105
12/11/2014,CLE,26,21,19,28,0,94,OKC,18,29,31,25,0,103
12/12/2014,CLE,33,26,17,38,0,114,NOP,33,31,25,30,0,119
12/15/2014,CHO,17,28,23,20,0,88,CLE,34,20,26,17,0,97
12/17/2014,ATL,26,39,30,32,0,127,CLE,34,26,15,23,0,98
12/19/2014,BRK,33,16,22,20,0,91,CLE,26,28,20,21,0,95
12/21/2014,MEM,19,22,29,21,0,91,CLE,22,30,25,28,0,105
12/23/2014,MIN,26,30,23,25,0,104,CLE,27,37,32,29,0,125
12/25/2014,CLE,27,22,25,17,0,91,MIA,30,32,15,24,0,101
12/26/2014,CLE,27,22,22,27,0,98,ORL,32,21,22,14,0,89
12/28/2014,DET,17,33,27,26,0,103,CLE,28,19,14,19,0,80
12/30/2014,CLE,25,16,32,28,0,101,ATL,26,25,27,31,0,109
12/31/2014,MIL,31,21,19,25,0,96,CLE,18,29,7,26,0,80
1/2/2015,CLE,16,24,32,19,0,91,CHO,25,21,18,23,0,87
1/4/2015,DAL,28,29,32,20,0,109,CLE,25,22,24,19,0,90
1/5/2015,CLE,20,30,18,24,0,92,PHI,19,18,23,35,0,95
1/7/2015,HOU,26,23,24,32,0,105,CLE,23,25,26,19,0,93
1/9/2015,CLE,32,22,22,18,0,94,GSW,30,30,24,28,0,112
1/11/2015,CLE,29,15,20,20,0,84,SAC,30,29,26,18,0,103
1/13/2015,CLE,24,27,28,21,0,100,PHO,31,28,26,22,0,107
1/15/2015,CLE,30,27,22,30,0,109,LAL,30,31,14,27,0,102
1/16/2015,CLE,28,33,31,34,0,126,LAC,33,31,31,26,0,121
1/19/2015,CHI,19,20,23,32,0,94,CLE,24,30,30,24,0,108
1/21/2015,UTA,20,20,22,30,0,92,CLE,31,22,29,24,0,106
1/23/2015,CHO,13,27,23,27,0,90,CLE,33,42,28,26,0,129
1/25/2015,OKC,26,23,29,20,0,98,CLE,20,37,26,25,0,108
1/27/2015,CLE,17,30,28,28,0,103,DET,19,20,25,31,0,95
1/28/2015,POR,21,23,30,20,0,94,CLE,31,23,25,20,0,99
1/30/2015,SAC,20,24,21,25,0,90,CLE,30,25,31,15,0,101
1/31/2015,CLE,30,22,24,30,0,106,MIN,21,28,30,11,0,90
2/2/2015,PHI,15,20,30,19,0,84,CLE,24,23,22,28,0,97
2/5/2015,LAC,20,22,21,31,0,94,CLE,30,35,29,11,0,105
2/6/2015,CLE,31,24,15,29,0,99,IND,27,20,20,36,0,103
2/8/2015,LAL,28,21,30,26,0,105,CLE,32,32,32,24,0,120
2/11/2015,MIA,23,25,21,24,0,93,CLE,38,21,26,28,0,113
2/12/2015,CLE,26,22,29,21,0,98,CHI,30,25,32,26,0,113
2/20/2015,CLE,35,30,29,33,0,127,WAS,26,25,20,18,0,89
2/22/2015,CLE,36,26,19,20,0,101,NYK,17,21,17,28,0,83
2/24/2015,CLE,30,23,24,25,0,102,DET,27,35,12,19,0,93
2/26/2015,GSW,33,23,22,21,0,99,CLE,32,29,29,20,0,110
2/27/2015,CLE,28,17,16,25,0,86,IND,19,32,23,19,0,93
3/1/2015,CLE,26,21,27,24,5,103,HOU,29,21,32,16,7,105
3/3/2015,BOS,16,20,17,26,0,79,CLE,29,32,34,15,0,110
3/4/2015,CLE,28,29,27,36,0,120,TOR,25,18,31,38,0,112
3/6/2015,CLE,19,24,36,18,0,97,ATL,36,17,28,25,0,106
3/7/2015,PHO,24,13,15,27,0,79,CLE,30,23,27,9,0,89
3/10/2015,CLE,26,41,32,28,0,127,DAL,31,22,23,18,0,94
3/12/2015,CLE,30,32,17,31,18,128,SAS,31,33,20,26,15,125
3/15/2015,CLE,26,40,34,23,0,123,ORL,28,27,31,22,0,108
3/16/2015,CLE,22,16,25,29,0,92,MIA,27,29,27,23,0,106
3/18/2015,BRK,26,21,26,19,0,92,CLE,23,36,35,23,0,117
3/20/2015,IND,20,21,31,20,0,92,CLE,25,20,27,23,0,95
3/22/2015,CLE,25,19,31,33,0,108,MIL,26,27,20,17,0,90
3/25/2015,CLE,22,33,36,20,0,111,MEM,19,23,24,23,0,89
3/27/2015,CLE,27,29,23,19,0,98,BRK,29,28,22,27,0,106
3/29/2015,PHI,20,25,24,17,0,86,CLE,26,27,19,15,0,87
4/2/2015,MIA,27,23,22,16,0,88,CLE,34,27,30,23,0,114
4/5/2015,CHI,23,22,26,23,0,94,CLE,27,27,25,20,0,99
4/8/2015,CLE,26,26,22,30,0,104,MIL,22,22,28,27,0,99
4/10/2015,BOS,28,26,25,20,0,99,CLE,17,23,37,13,0,90
4/12/2015,CLE,22,9,24,23,0,78,BOS,21,34,29,33,0,117
4/13/2015,DET,14,23,36,24,0,97,CLE,36,26,31,16,0,109
4/15/2015,WAS,28,28,23,22,7,108,CLE,20,33,21,27,12,113
10/29/2014,BRK,23,18,31,33,0,105,BOS,32,35,34,20,0,121
11/1/2014,BOS,22,16,24,28,0,90,HOU,37,20,24,23,0,104
11/3/2014,BOS,19,22,38,34,0,113,DAL,40,27,24,27,0,118
11/5/2014,TOR,23,31,34,22,0,110,BOS,35,22,29,21,0,107
11/7/2014,IND,26,26,23,23,0,98,BOS,30,25,18,28,0,101
11/8/2014,BOS,20,36,27,23,0,106,CHI,25,16,26,34,0,101
11/12/2014,OKC,15,27,34,33,0,109,BOS,24,27,21,22,0,94
11/14/2014,CLE,25,34,25,38,0,122,BOS,31,28,42,20,0,121
11/17/2014,PHO,33,27,29,29,0,118,BOS,31,23,34,26,0,114
11/19/2014,BOS,22,24,27,28,0,101,PHI,27,19,22,22,0,90
11/21/2014,BOS,16,25,29,30,0,100,MEM,25,30,27,35,0,117
11/23/2014,POR,21,23,28,22,0,94,BOS,23,26,23,16,0,88
11/28/2014,CHI,24,30,31,24,0,109,BOS,35,25,31,11,0,102
11/30/2014,SAS,25,20,33,33,0,111,BOS,22,27,24,16,0,89
12/2/2014,BOS,42,24,19,20,0,105,ATL,30,20,30,29,0,109
12/3/2014,DET,23,20,15,30,14,102,BOS,21,21,19,27,21,109
12/5/2014,LAL,20,28,22,26,0,96,BOS,30,23,33,27,0,113
12/7/2014,WAS,15,21,23,34,0,93,BOS,24,29,24,24,0,101
12/8/2014,BOS,29,16,31,34,11,132,WAS,30,28,34,18,11,133
12/10/2014,BOS,16,29,21,21,0,87,CHO,22,18,33,23,0,96
12/12/2014,NYK,26,25,24,26,0,101,BOS,19,27,23,26,0,95
12/15/2014,BOS,30,27,31,17,0,105,PHI,25,13,26,23,0,87
12/17/2014,ORL,28,25,20,19,0,92,BOS,29,27,22,31,0,109
12/19/2014,MIN,24,24,29,21,0,98,BOS,27,26,30,31,0,114
12/21/2014,BOS,21,21,19,23,0,84,MIA,28,24,20,28,0,100
12/23/2014,BOS,9,21,30,35,0,95,ORL,26,27,32,15,0,100
12/26/2014,BRK,28,28,23,30,0,109,BOS,29,27,30,21,0,107
12/27/2014,BOS,12,27,24,25,0,88,WAS,30,26,24,21,0,101
12/31/2014,SAC,19,20,22,23,0,84,BOS,23,26,28,29,0,106
1/2/2015,DAL,31,28,33,27,0,119,BOS,17,29,18,37,0,101
1/3/2015,BOS,23,17,29,30,5,104,CHI,17,29,23,30,10,109
1/5/2015,CHO,24,26,29,25,0,104,BOS,16,20,26,33,0,95
1/7/2015,BOS,19,21,29,20,0,89,BRK,25,14,23,19,0,81
1/9/2015,BOS,17,20,23,34,9,103,IND,25,21,19,29,13,107
1/10/2015,BOS,26,17,22,31,0,96,TOR,19,28,35,27,0,109
1/12/2015,NOP,22,27,27,24,0,100,BOS,22,27,23,36,0,108
1/14/2015,ATL,24,33,32,16,0,105,BOS,24,21,29,17,0,91
1/16/2015,CHI,22,33,33,31,0,119,BOS,24,34,28,17,0,103
1/19/2015,BOS,17,20,25,31,0,93,LAC,23,24,27,28,0,102
1/22/2015,BOS,23,21,23,23,0,90,POR,19,23,30,17,0,89
1/23/2015,BOS,20,22,33,25,0,100,DEN,28,20,26,25,0,99
1/25/2015,BOS,23,26,28,34,0,111,GSW,30,26,33,25,0,114
1/26/2015,BOS,17,38,16,28,0,99,UTA,17,14,35,24,0,90
1/28/2015,BOS,22,27,25,24,0,98,MIN,26,22,33,29,0,110
1/30/2015,HOU,29,31,9,24,0,93,BOS,21,21,22,23,0,87
2/1/2015,MIA,25,19,17,22,0,83,BOS,15,16,28,16,0,75
2/3/2015,BOS,26,31,23,28,0,108,NYK,19,25,28,25,0,97
2/4/2015,DEN,29,22,27,22,0,100,BOS,26,35,22,21,0,104
2/6/2015,PHI,15,27,27,27,0,96,BOS,29,31,15,32,0,107
2/7/2015,BOS,23,23,29,18,0,93,MIL,23,30,27,16,0,96
2/11/2015,ATL,23,26,23,16,0,88,BOS,13,21,27,28,0,89
2/20/2015,BOS,27,24,23,27,0,101,SAC,28,28,26,27,0,109
2/22/2015,BOS,32,26,20,28,5,111,LAL,26,30,17,33,12,118
2/23/2015,BOS,26,41,22,26,0,115,PHO,21,29,29,31,0,110
2/25/2015,NYK,25,24,23,22,0,94,BOS,23,25,32,35,0,115
2/27/2015,CHO,21,28,26,23,0,98,BOS,27,18,24,37,0,106
3/1/2015,GSW,25,24,26,31,0,106,BOS,38,27,21,15,0,101
3/3/2015,BOS,16,20,17,26,0,79,CLE,29,32,34,15,0,110
3/4/2015,UTA,19,14,22,29,0,84,BOS,18,16,27,24,0,85
3/6/2015,BOS,27,20,24,33,0,104,NOP,25,22,21,30,0,98
3/8/2015,BOS,31,18,20,29,0,98,ORL,17,26,26,34,0,103
3/9/2015,BOS,24,19,30,27,0,100,MIA,19,21,24,26,0,90
3/11/2015,MEM,18,21,24,29,0,92,BOS,23,16,25,31,0,95
3/13/2015,ORL,23,27,22,16,0,88,BOS,19,21,26,29,0,95
3/14/2015,BOS,20,25,22,26,0,93,IND,18,19,23,29,0,89
3/16/2015,PHI,18,16,34,21,0,89,BOS,38,19,32,19,0,108
3/18/2015,BOS,24,33,24,37,0,118,OKC,28,25,40,29,0,122
3/20/2015,BOS,19,23,21,26,0,89,SAS,32,24,28,17,0,101
3/22/2015,DET,26,15,22,25,17,105,BOS,23,24,22,19,9,97
3/23/2015,BOS,23,31,29,27,0,110,BRK,28,21,25,17,0,91
3/25/2015,MIA,27,30,25,11,0,93,BOS,20,20,22,24,0,86
3/27/2015,BOS,21,26,23,26,0,96,NYK,22,17,24,29,0,92
3/29/2015,LAC,34,34,37,14,0,119,BOS,20,27,32,27,0,106
3/30/2015,BOS,26,30,29,31,0,116,CHO,24,20,25,35,0,104
4/1/2015,IND,16,23,23,25,0,87,BOS,22,28,18,32,0,100
4/3/2015,MIL,21,29,36,24,0,110,BOS,25,27,23,26,0,101
4/4/2015,BOS,15,32,34,23,13,117,TOR,24,23,23,34,12,116
4/8/2015,BOS,30,25,36,22,0,113,DET,16,31,27,29,0,103
4/10/2015,BOS,28,26,25,20,0,99,CLE,17,23,37,13,0,90
4/12/2015,CLE,22,9,24,23,0,78,BOS,21,34,29,33,0,117
4/14/2015,TOR,26,27,17,23,0,93,BOS,19,27,27,22,0,95
4/15/2015,BOS,22,27,24,32,0,105,MIL,25,20,27,28,0,100
10/29/2014,WAS,28,24,18,25,0,95,MIA,22,31,19,35,0,107
10/30/2014,WAS,28,26,28,23,0,105,ORL,23,28,15,32,0,98
11/1/2014,MIL,17,27,24,29,0,97,WAS,29,20,34,25,0,108
11/4/2014,WAS,17,23,32,26,0,98,NYK,23,22,15,23,0,83
11/5/2014,IND,24,17,20,23,10,94,WAS,24,22,20,18,12,96
11/7/2014,WAS,18,17,23,26,0,84,TOR,28,31,23,21,0,103
11/8/2014,WAS,32,22,19,24,0,97,IND,14,21,30,25,0,90
11/12/2014,DET,34,25,26,18,0,103,WAS,24,33,25,25,0,107
11/15/2014,ORL,17,21,24,31,0,93,WAS,24,24,21,29,0,98
11/19/2014,DAL,23,31,22,29,0,105,WAS,29,24,20,29,0,102
11/21/2014,CLE,21,21,23,13,0,78,WAS,26,29,25,11,0,91
11/22/2014,WAS,21,26,27,37,0,111,MIL,28,24,18,30,0,100
11/25/2014,ATL,22,19,27,38,0,106,WAS,19,20,28,35,0,102
11/26/2014,WAS,18,28,21,20,0,87,CLE,31,27,23,32,0,113
11/29/2014,NOP,18,18,21,23,0,80,WAS,23,17,25,18,0,83
12/1/2014,MIA,22,27,17,20,0,86,WAS,30,34,17,26,0,107
12/3/2014,LAL,33,19,17,26,0,95,WAS,27,27,24,33,0,111
12/5/2014,DEN,28,18,23,20,0,89,WAS,30,35,25,29,0,119
12/7/2014,WAS,15,21,23,34,0,93,BOS,24,29,24,24,0,101
12/8/2014,BOS,29,16,31,34,11,132,WAS,30,28,34,18,11,133
12/10/2014,WAS,26,19,22,24,0,91,ORL,21,23,31,14,0,89
12/12/2014,LAC,21,21,25,29,0,96,WAS,30,27,23,24,0,104
12/14/2014,UTA,24,18,16,26,0,84,WAS,22,15,30,26,0,93
12/16/2014,MIN,16,20,33,26,0,95,WAS,27,19,28,35,0,109
12/19/2014,WAS,29,25,22,29,0,105,MIA,25,30,24,24,0,103
12/21/2014,PHO,22,28,29,25,0,104,WAS,23,27,21,21,0,92
12/23/2014,CHI,21,25,24,29,0,99,WAS,20,20,25,26,0,91
12/25/2014,WAS,34,26,24,18,0,102,NYK,23,21,26,21,0,91
12/27/2014,BOS,12,27,24,25,0,88,WAS,30,26,24,21,0,101
12/29/2014,WAS,24,22,32,26,0,104,HOU,27,18,22,36,0,103
12/30/2014,WAS,24,21,19,23,0,87,DAL,27,36,26,25,0,114
1/2/2015,WAS,29,28,25,20,0,102,OKC,28,27,27,27,0,109
1/3/2015,WAS,35,23,19,15,0,92,SAS,31,27,20,23,0,101
1/5/2015,WAS,27,25,17,23,0,92,NOP,23,21,20,21,0,85
1/7/2015,NYK,21,20,26,24,0,91,WAS,30,23,24,24,0,101
1/9/2015,CHI,13,29,26,18,0,86,WAS,30,30,20,22,0,102
1/11/2015,WAS,22,28,27,12,0,89,ATL,34,21,32,33,0,120
1/13/2015,SAS,24,24,24,21,0,93,WAS,31,20,24,26,0,101
1/14/2015,WAS,26,18,32,29,0,105,CHI,32,18,19,30,0,99
1/16/2015,BRK,18,25,28,31,0,102,WAS,24,16,18,22,0,80
1/17/2015,WAS,23,27,27,22,0,99,BRK,26,25,19,20,0,90
1/19/2015,PHI,14,18,26,18,0,76,WAS,27,28,30,26,0,111
1/21/2015,OKC,26,12,28,26,13,105,WAS,31,19,20,22,11,103
1/24/2015,WAS,32,23,15,26,0,96,POR,20,25,24,34,0,103
1/25/2015,WAS,28,31,24,22,12,117,DEN,26,33,25,21,10,115
1/27/2015,WAS,24,22,29,23,0,98,LAL,31,26,19,16,0,92
1/28/2015,WAS,17,22,27,32,0,98,PHO,29,27,24,26,0,106
1/31/2015,TOR,33,32,29,15,11,120,WAS,30,20,28,31,7,116
2/2/2015,CHO,28,25,17,22,0,92,WAS,24,27,15,22,0,88
2/4/2015,WAS,18,28,28,22,0,96,ATL,29,30,18,28,0,105
2/5/2015,WAS,30,24,20,13,0,87,CHO,34,15,20,25,0,94
2/7/2015,BRK,19,19,23,16,0,77,WAS,28,30,31,25,0,114
2/9/2015,ORL,16,19,19,26,0,80,WAS,24,19,31,22,0,96
2/11/2015,WAS,25,22,29,17,0,93,TOR,27,22,26,20,0,95
2/20/2015,CLE,35,30,29,33,0,127,WAS,26,25,20,18,0,89
2/22/2015,WAS,22,30,19,18,0,89,DET,27,20,35,24,0,106
2/24/2015,GSW,30,24,32,28,0,114,WAS,28,23,32,24,0,107
2/25/2015,WAS,20,22,18,17,0,77,MIN,11,31,32,23,0,97
2/27/2015,WAS,25,17,19,20,0,81,PHI,28,19,16,26,0,89
2/28/2015,DET,27,17,26,25,0,95,WAS,37,23,20,19,0,99
3/3/2015,WAS,22,22,23,25,0,92,CHI,24,27,23,23,0,97
3/6/2015,MIA,18,21,34,24,0,97,WAS,40,27,21,11,0,99
3/7/2015,WAS,19,20,24,22,0,85,MIL,30,21,14,26,0,91
3/9/2015,WAS,36,20,21,18,0,95,CHO,21,25,14,9,0,69
3/12/2015,MEM,33,14,24,16,0,87,WAS,26,34,29,18,0,107
3/14/2015,SAC,25,39,21,12,0,97,WAS,21,25,38,29,0,113
3/16/2015,POR,20,20,34,23,0,97,WAS,27,33,21,24,0,105
3/18/2015,WAS,26,16,25,21,0,88,UTA,21,19,21,23,0,84
3/20/2015,WAS,21,33,23,22,0,99,LAC,35,31,24,23,0,113
3/22/2015,WAS,29,21,20,16,0,86,SAC,34,23,33,19,0,109
3/23/2015,WAS,24,25,8,19,0,76,GSW,27,25,29,26,0,107
3/25/2015,IND,14,28,28,33,0,103,WAS,20,24,32,25,0,101
3/27/2015,CHO,19,35,25,17,5,107,WAS,28,31,16,21,5,110
3/29/2015,HOU,28,31,17,23,0,99,WAS,20,26,21,24,0,91
4/1/2015,PHI,21,21,20,31,0,93,WAS,31,34,28,13,0,106
4/3/2015,NYK,10,36,21,20,0,87,WAS,30,24,29,18,0,101
4/4/2015,WAS,29,20,22,21,0,92,MEM,18,20,21,24,0,83
4/8/2015,WAS,35,35,25,24,0,119,PHI,24,30,23,13,0,90
4/10/2015,WAS,14,24,24,18,0,80,BRK,31,23,21,42,0,117
4/12/2015,ATL,22,23,30,24,0,99,WAS,38,28,24,18,0,108
4/14/2015,WAS,16,25,18,22,4,95,IND,16,17,23,25,4,99
4/15/2015,WAS,28,28,23,22,7,108,CLE,20,33,21,27,12,113
10/29/2014,MIL,24,33,26,17,6,106,CHO,25,21,22,32,8,108
11/1/2014,MEM,23,13,15,20,0,71,CHO,15,15,16,23,0,69
11/2/2014,CHO,21,29,30,13,0,93,NYK,29,23,27,17,0,96
11/4/2014,CHO,21,27,17,26,0,91,NOP,26,21,26,27,0,100
11/5/2014,MIA,17,27,18,27,0,89,CHO,24,22,26,24,0,96
11/7/2014,ATL,29,21,28,19,13,119,CHO,22,25,23,27,13,122
11/9/2014,CHO,25,26,13,28,0,92,LAL,18,24,34,31,0,107
11/11/2014,CHO,35,29,21,15,0,100,POR,21,30,24,27,0,102
11/14/2014,CHO,14,33,27,29,0,103,PHO,28,19,28,20,0,95
11/15/2014,CHO,23,23,22,19,0,87,GSW,28,39,29,16,0,112
11/17/2014,DAL,32,35,21,19,0,107,CHO,24,19,18,19,0,80
11/19/2014,CHO,28,21,17,20,0,86,IND,20,23,22,23,0,88
11/21/2014,ORL,26,14,24,41,0,105,CHO,27,24,28,21,0,100
11/23/2014,CHO,22,22,28,21,0,93,MIA,23,30,14,27,0,94
11/24/2014,LAC,31,25,22,35,0,113,CHO,23,30,17,22,0,92
11/26/2014,POR,28,17,34,26,0,105,CHO,26,30,20,21,0,97
11/28/2014,GSW,28,21,25,32,0,106,CHO,24,31,25,21,0,101
11/29/2014,CHO,17,11,23,24,0,75,ATL,28,36,20,21,0,105
12/3/2014,CHI,26,19,27,30,0,102,CHO,24,16,31,24,0,95
12/5/2014,NYK,21,24,24,33,0,102,CHO,31,26,28,18,0,103
12/10/2014,BOS,16,29,21,21,0,87,CHO,22,18,33,23,0,96
12/12/2014,CHO,21,24,27,20,10,107,MEM,26,21,22,23,10,113
12/13/2014,BRK,32,20,33,29,0,114,CHO,17,25,17,28,0,87
12/15/2014,CHO,17,28,23,20,0,88,CLE,34,20,26,17,0,97
12/17/2014,PHO,27,27,29,28,0,111,CHO,31,30,26,19,0,106
12/19/2014,CHO,37,29,19,24,0,109,PHI,26,20,26,19,0,91
12/20/2014,UTA,23,16,24,23,0,86,CHO,31,21,32,20,0,104
12/22/2014,DEN,18,22,17,25,0,82,CHO,28,30,26,26,0,110
12/23/2014,CHO,28,26,34,20,0,108,MIL,30,26,24,21,0,101
12/26/2014,CHO,24,16,16,19,0,75,OKC,33,26,22,17,0,98
12/27/2014,ORL,22,30,29,21,0,102,CHO,18,24,26,26,0,94
12/29/2014,MIL,25,24,19,15,21,104,CHO,18,14,29,22,11,94
12/31/2014,CHO,25,20,23,15,0,83,HOU,23,24,29,26,0,102
1/2/2015,CLE,16,24,32,19,0,91,CHO,25,21,18,23,0,87
1/3/2015,CHO,22,30,18,28,0,98,ORL,20,9,25,36,0,90
1/5/2015,CHO,24,26,29,25,0,104,BOS,16,20,26,33,0,95
1/7/2015,NOP,27,21,22,24,0,94,CHO,20,21,26,31,0,98
1/8/2015,CHO,31,19,25,28,0,103,TOR,23,29,14,29,0,95
1/10/2015,CHO,21,41,27,21,0,110,NYK,18,13,13,38,0,82
1/14/2015,SAS,22,35,19,22,0,98,CHO,18,27,23,25,0,93
1/17/2015,IND,21,19,11,17,3,71,CHO,17,20,13,18,12,80
1/19/2015,MIN,20,13,19,28,0,80,CHO,23,27,33,22,0,105
1/21/2015,MIA,17,22,16,21,0,76,CHO,25,20,20,13,0,78
1/23/2015,CHO,13,27,23,27,0,90,CLE,33,42,28,26,0,129
1/24/2015,NYK,23,14,17,17,0,71,CHO,16,20,21,19,0,76
1/28/2015,CHO,19,19,26,22,0,86,SAS,27,28,14,26,0,95
1/31/2015,CHO,30,32,18,24,0,104,DEN,15,15,22,34,0,86
2/2/2015,CHO,28,25,17,22,0,92,WAS,24,27,15,22,0,88
2/5/2015,WAS,30,24,20,13,0,87,CHO,34,15,20,25,0,94
2/7/2015,CHO,24,24,13,20,0,81,PHI,23,19,28,19,0,89
2/8/2015,IND,20,19,36,28,0,103,CHO,32,24,27,19,0,102
2/10/2015,DET,26,28,29,23,0,106,CHO,27,19,14,18,0,78
2/21/2015,OKC,28,31,27,24,0,110,CHO,30,26,27,20,0,103
2/22/2015,CHO,16,19,21,25,0,81,DAL,28,17,22,25,0,92
2/25/2015,CHO,20,24,23,31,0,98,CHI,20,24,21,21,0,86
2/27/2015,CHO,21,28,26,23,0,98,BOS,27,18,24,37,0,106
3/1/2015,CHO,28,15,28,27,0,98,ORL,22,20,18,23,0,83
3/3/2015,LAL,30,20,20,33,0,103,CHO,27,23,24,30,0,104
3/4/2015,CHO,35,21,32,27,0,115,BRK,15,29,22,25,0,91
3/6/2015,TOR,24,18,29,23,0,94,CHO,25,28,24,26,0,103
3/8/2015,CHO,27,27,24,30,0,108,DET,33,29,22,17,0,101
3/9/2015,WAS,36,20,21,18,0,95,CHO,21,25,14,9,0,69
3/11/2015,SAC,24,27,27,35,0,113,CHO,21,25,32,28,0,106
3/13/2015,CHI,35,25,10,21,0,91,CHO,19,33,25,24,0,101
3/16/2015,CHO,16,14,16,20,0,66,UTA,30,31,24,9,0,94
3/17/2015,CHO,20,21,33,18,0,92,LAC,28,31,18,22,0,99
3/20/2015,CHO,22,24,23,22,0,91,SAC,29,28,23,21,0,101
3/22/2015,CHO,18,36,28,27,0,109,MIN,27,32,19,20,0,98
3/23/2015,CHO,26,23,20,17,0,86,CHI,28,20,26,24,0,98
3/25/2015,BRK,23,19,26,23,0,91,CHO,26,20,18,24,0,88
3/27/2015,CHO,19,35,25,17,5,107,WAS,28,31,16,21,5,110
3/28/2015,ATL,23,29,24,24,0,100,CHO,27,30,33,25,0,115
3/30/2015,BOS,26,30,29,31,0,116,CHO,24,20,25,35,0,104
4/1/2015,DET,25,20,17,16,0,78,CHO,33,23,17,29,0,102
4/3/2015,CHO,25,13,9,27,0,74,IND,22,27,21,23,0,93
4/4/2015,PHI,16,35,18,22,0,91,CHO,19,30,23,20,0,92
4/7/2015,CHO,25,30,20,25,0,100,MIA,28,27,27,23,0,105
4/8/2015,TOR,20,27,22,23,0,92,CHO,15,16,14,29,0,74
4/10/2015,CHO,15,33,12,20,0,80,ATL,15,32,23,34,0,104
4/12/2015,CHO,10,24,20,23,0,77,DET,30,29,23,34,0,116
4/13/2015,HOU,24,28,31,17,0,100,CHO,23,29,23,15,0,90
4/15/2015,CHO,20,24,23,20,0,87,TOR,25,30,23,14,0,92
10/29/2014,MIN,27,20,27,27,0,101,MEM,25,28,28,24,0,105
10/30/2014,DET,21,23,21,26,0,91,MIN,21,24,30,22,0,97
11/1/2014,CHI,27,36,22,21,0,106,MIN,25,24,32,24,0,105
11/5/2014,MIN,24,23,25,26,0,98,BRK,21,27,18,25,0,91
11/7/2014,MIN,27,25,25,17,9,103,ORL,26,21,27,20,18,112
11/8/2014,MIN,13,28,28,23,0,92,MIA,29,24,27,22,0,102
11/12/2014,HOU,28,25,31,29,0,113,MIN,26,23,21,31,0,101
11/14/2014,MIN,19,25,28,19,0,91,NOP,43,37,38,21,0,139
11/15/2014,MIN,22,22,38,35,0,117,DAL,28,35,38,30,0,131
11/19/2014,NYK,25,26,22,26,0,99,MIN,27,37,29,22,0,115
11/21/2014,SAS,29,30,32,30,0,121,MIN,26,22,14,30,0,92
11/22/2014,SAC,21,27,36,29,0,113,MIN,24,28,25,24,0,101
11/26/2014,MIL,26,25,21,31,0,103,MIN,24,23,23,16,0,86
11/28/2014,MIN,23,31,39,27,0,120,LAL,30,28,38,23,0,119
11/30/2014,MIN,26,14,21,32,0,93,POR,22,26,27,32,0,107
12/1/2014,MIN,34,16,18,33,0,101,LAC,31,34,36,26,0,127
12/3/2014,PHI,23,9,25,28,0,85,MIN,13,21,22,21,0,77
12/5/2014,HOU,33,22,28,22,9,114,MIN,24,33,17,31,7,112
12/6/2014,MIN,23,28,25,25,0,101,SAS,31,37,28,27,0,123
12/8/2014,GSW,25,23,31,23,0,102,MIN,20,19,24,23,0,86
12/10/2014,POR,16,20,15,31,0,82,MIN,20,24,22,24,0,90
12/12/2014,OKC,39,31,23,18,0,111,MIN,21,28,28,15,0,92
12/14/2014,LAL,22,27,22,29,0,100,MIN,19,25,25,25,0,94
12/16/2014,MIN,16,20,33,26,0,95,WAS,27,19,28,35,0,109
12/19/2014,MIN,24,24,29,21,0,98,BOS,27,26,30,31,0,114
12/21/2014,IND,20,32,23,25,0,100,MIN,17,21,30,28,0,96
12/23/2014,MIN,26,30,23,25,0,104,CLE,27,37,32,29,0,125
12/26/2014,MIN,27,20,27,28,0,102,DEN,26,27,26,27,0,106
12/27/2014,MIN,23,25,19,30,0,97,GSW,31,27,30,22,0,110
12/30/2014,MIN,27,17,28,22,0,94,UTA,21,24,27,28,0,100
1/1/2015,SAC,37,23,24,26,0,110,MIN,29,29,22,27,0,107
1/3/2015,UTA,20,27,30,24,0,101,MIN,21,20,20,28,0,89
1/5/2015,DEN,35,27,25,23,0,110,MIN,21,20,28,32,0,101
1/7/2015,PHO,20,25,26,42,0,113,MIN,25,23,30,33,0,111
1/9/2015,MIN,22,16,20,26,0,84,MIL,19,34,19,26,0,98
1/10/2015,SAS,27,31,26,24,0,108,MIN,18,25,21,29,0,93
1/13/2015,MIN,25,21,23,41,0,110,IND,21,31,23,26,0,101
1/16/2015,MIN,27,29,19,24,0,99,PHO,32,27,27,24,0,110
1/17/2015,MIN,37,19,29,28,0,113,DEN,25,34,24,22,0,105
1/19/2015,MIN,20,13,19,28,0,80,CHO,23,27,33,22,0,105
1/21/2015,DAL,24,35,16,23,0,98,MIN,21,17,19,18,0,75
1/23/2015,NOP,24,21,24,23,0,92,MIN,20,24,19,21,0,84
1/25/2015,MIN,24,23,30,23,0,100,ATL,25,36,25,26,0,112
1/26/2015,MIN,19,21,16,28,0,84,OKC,25,23,17,27,0,92
1/28/2015,BOS,22,27,25,24,0,98,MIN,26,22,33,29,0,110
1/30/2015,MIN,28,31,18,17,0,94,PHI,26,35,17,25,0,103
1/31/2015,CLE,30,22,24,30,0,106,MIN,21,28,30,11,0,90
2/2/2015,MIN,20,27,26,21,0,94,DAL,30,24,27,19,0,100
2/4/2015,MIA,24,27,32,18,0,101,MIN,27,26,23,26,0,102
2/6/2015,MEM,23,20,26,20,0,89,MIN,24,19,22,25,0,90
2/8/2015,MIN,32,29,20,31,0,112,DET,24,27,22,28,0,101
2/9/2015,ATL,32,25,29,31,0,117,MIN,30,23,19,33,0,105
2/11/2015,GSW,28,28,17,21,0,94,MIN,25,21,21,24,0,91
2/20/2015,PHO,24,18,35,32,0,109,MIN,26,26,28,31,0,111
2/23/2015,MIN,25,31,19,27,0,102,HOU,26,30,28,29,0,113
2/25/2015,WAS,20,22,18,17,0,77,MIN,11,31,32,23,0,97
2/27/2015,MIN,23,21,23,22,0,89,CHI,27,24,22,23,0,96
2/28/2015,MEM,18,30,24,29,0,101,MIN,24,22,24,27,0,97
3/2/2015,LAC,36,22,28,24,0,110,MIN,23,37,27,18,0,105
3/4/2015,DEN,26,34,17,23,0,100,MIN,27,16,22,20,0,85
3/7/2015,POR,30,25,22,36,0,113,MIN,29,22,30,40,0,121
3/9/2015,MIN,25,14,23,14,0,76,LAC,25,23,26,15,0,89
3/11/2015,MIN,18,26,25,28,0,97,PHO,25,25,28,28,0,106
3/13/2015,MIN,26,23,23,27,0,99,OKC,31,24,24,34,0,113
3/15/2015,MIN,23,27,13,34,0,97,SAS,29,31,33,30,0,123
3/16/2015,BRK,33,34,31,24,0,122,MIN,29,26,24,27,0,106
3/18/2015,MIN,32,22,21,25,0,100,TOR,31,23,28,23,0,105
3/19/2015,MIN,29,25,15,16,10,95,NYK,26,20,23,16,7,92
3/22/2015,CHO,18,36,28,27,0,109,MIN,27,32,19,20,0,98
3/23/2015,MIN,20,22,18,36,10,106,UTA,22,26,15,33,8,104
3/25/2015,LAL,24,25,24,17,11,101,MIN,15,28,23,24,9,99
3/27/2015,MIN,22,28,30,30,0,110,HOU,31,29,30,30,0,120
3/29/2015,MIN,11,30,29,18,0,88,NOP,25,25,27,33,0,110
3/30/2015,UTA,25,25,31,23,0,104,MIN,18,22,17,27,0,84
4/1/2015,TOR,31,29,26,27,0,113,MIN,27,19,23,30,0,99
4/3/2015,ORL,29,23,20,25,0,97,MIN,23,19,23,19,0,84
4/7/2015,MIN,31,18,25,37,0,111,SAC,23,31,36,26,0,116
4/8/2015,MIN,19,17,26,29,0,91,POR,29,26,29,32,0,116
4/10/2015,MIN,21,26,24,27,0,98,LAL,30,22,28,26,0,106
4/11/2015,MIN,31,24,14,32,0,101,GSW,28,32,26,24,0,110
4/13/2015,NOP,22,28,23,27,0,100,MIN,20,15,27,26,0,88
4/15/2015,OKC,47,29,30,32,0,138,MIN,29,25,31,28,0,113
10/28/2014,DAL,24,29,20,27,0,100,SAS,26,19,31,25,0,101
10/30/2014,UTA,20,24,29,29,0,102,DAL,36,33,24,27,0,120
11/1/2014,DAL,32,34,20,23,0,109,NOP,26,26,37,15,0,104
11/3/2014,BOS,19,22,38,34,0,113,DAL,40,27,24,27,0,118
11/6/2014,DAL,24,26,18,19,0,87,POR,20,26,35,27,0,108
11/7/2014,DAL,24,28,26,27,0,105,UTA,17,27,18,20,0,82
11/9/2014,MIA,29,26,28,22,0,105,DAL,20,24,23,29,0,96
11/11/2014,SAC,32,25,15,26,0,98,DAL,14,34,30,28,0,106
11/13/2014,PHI,10,19,24,17,0,70,DAL,38,35,22,28,0,123
11/15/2014,MIN,22,22,38,35,0,117,DAL,28,35,38,30,0,131
11/17/2014,DAL,32,35,21,19,0,107,CHO,24,19,18,19,0,80
11/19/2014,DAL,23,31,22,29,0,105,WAS,29,24,20,29,0,102
11/21/2014,LAL,27,32,24,23,0,106,DAL,38,30,42,30,0,140
11/22/2014,DAL,29,22,17,24,0,92,HOU,29,31,17,18,0,95
11/24/2014,IND,25,30,30,26,0,111,DAL,24,26,28,22,0,100
11/26/2014,NYK,24,18,31,22,7,102,DAL,19,27,25,24,14,109
11/28/2014,DAL,26,22,23,35,0,106,TOR,21,22,21,38,0,102
11/29/2014,DAL,28,30,32,20,0,110,PHI,26,25,35,17,0,103
12/2/2014,DAL,25,34,21,28,13,132,CHI,26,21,27,34,13,129
12/3/2014,DAL,29,28,23,27,0,107,MIL,31,33,14,27,0,105
12/5/2014,PHO,40,29,24,25,0,118,DAL,27,30,29,20,0,106
12/7/2014,MIL,21,25,25,31,0,102,DAL,32,27,31,35,0,125
12/9/2014,DAL,37,25,17,26,0,105,MEM,34,22,36,22,0,114
12/10/2014,NOP,15,36,27,29,0,107,DAL,25,22,30,35,0,112
12/13/2014,GSW,39,27,21,18,0,105,DAL,18,26,24,30,0,98
12/16/2014,DAL,36,18,27,26,0,107,NYK,24,20,24,19,0,87
12/17/2014,DAL,32,21,30,34,0,117,DET,30,21,22,33,0,106
12/20/2014,SAS,25,22,30,16,0,93,DAL,21,21,33,24,0,99
12/22/2014,ATL,25,27,30,23,0,105,DAL,18,20,25,39,0,102
12/23/2014,DAL,26,19,29,41,0,115,PHO,25,28,36,35,0,124
12/26/2014,LAL,19,23,20,36,0,98,DAL,26,22,24,30,0,102
12/28/2014,OKC,26,32,30,19,0,107,DAL,33,31,17,31,0,112
12/30/2014,WAS,24,21,19,23,0,87,DAL,27,36,26,25,0,114
1/2/2015,DAL,31,28,33,27,0,119,BOS,17,29,18,37,0,101
1/4/2015,DAL,28,29,32,20,0,109,CLE,25,22,24,19,0,90
1/5/2015,DAL,21,22,22,17,14,96,BRK,35,14,16,17,6,88
1/7/2015,DET,31,23,20,34,0,108,DAL,26,23,19,27,0,95
1/10/2015,DAL,24,24,24,28,0,100,LAC,30,26,32,32,0,120
1/13/2015,DAL,29,31,20,19,9,108,SAC,33,30,20,16,5,104
1/14/2015,DAL,24,26,28,29,0,107,DEN,28,31,31,24,0,114
1/16/2015,DEN,24,18,23,24,0,89,DAL,29,20,24,24,0,97
1/19/2015,DAL,25,28,29,21,0,103,MEM,16,30,29,20,0,95
1/21/2015,DAL,24,35,16,23,0,98,MIN,21,17,19,18,0,75
1/23/2015,CHI,30,24,26,22,0,102,DAL,21,30,24,23,0,98
1/25/2015,DAL,22,34,28,22,0,106,NOP,25,36,28,20,0,109
1/27/2015,MEM,24,30,32,23,0,109,DAL,24,20,28,18,0,90
1/28/2015,DAL,25,28,25,16,0,94,HOU,24,30,27,18,0,99
1/30/2015,DAL,13,20,27,33,0,93,MIA,15,30,15,12,0,72
1/31/2015,DAL,34,32,22,20,0,108,ORL,17,24,29,23,0,93
2/2/2015,MIN,20,27,26,21,0,94,DAL,30,24,27,19,0,100
2/4/2015,DAL,42,20,36,16,0,114,GSW,25,33,43,27,0,128
2/5/2015,DAL,23,37,23,18,0,101,SAC,23,20,17,18,0,78
2/7/2015,POR,25,30,28,13,5,101,DAL,24,26,20,26,15,111
2/9/2015,LAC,32,34,28,21,0,115,DAL,31,22,27,18,0,98
2/11/2015,UTA,9,28,20,25,0,82,DAL,22,17,25,23,0,87
2/19/2015,DAL,19,17,29,24,0,89,OKC,25,27,31,21,0,104
2/20/2015,HOU,20,23,24,33,0,100,DAL,24,30,33,24,0,111
2/22/2015,CHO,16,19,21,25,0,81,DAL,28,17,22,25,0,92
2/24/2015,TOR,29,26,22,15,0,92,DAL,25,24,25,25,0,99
2/25/2015,DAL,34,19,15,19,0,87,ATL,22,25,30,27,0,104
2/28/2015,BRK,23,24,35,22,0,104,DAL,26,25,21,22,0,94
3/2/2015,NOP,31,27,13,22,0,93,DAL,32,23,25,22,0,102
3/5/2015,DAL,23,13,21,18,0,75,POR,17,23,31,23,0,94
3/6/2015,DAL,24,16,24,25,0,89,GSW,29,23,30,22,0,104
3/8/2015,DAL,25,19,31,25,0,100,LAL,24,20,33,16,0,93
3/10/2015,CLE,26,41,32,28,0,127,DAL,31,22,23,18,0,94
3/13/2015,LAC,24,27,27,21,0,99,DAL,21,38,32,38,0,129
3/16/2015,OKC,29,34,29,23,0,115,DAL,27,26,39,27,0,119
3/18/2015,ORL,23,25,22,32,0,102,DAL,31,34,21,21,0,107
3/20/2015,MEM,25,19,39,29,0,112,DAL,18,19,31,33,0,101
3/22/2015,DAL,27,15,33,17,0,92,PHO,33,24,19,22,0,98
3/24/2015,SAS,29,17,20,28,0,94,DAL,17,26,33,25,0,101
3/27/2015,DAL,18,23,20,15,0,76,SAS,28,26,15,25,0,94
3/29/2015,DAL,27,34,18,20,0,99,IND,33,22,23,26,0,104
4/1/2015,DAL,28,38,35,34,0,135,OKC,25,38,38,30,0,131
4/2/2015,HOU,28,19,30,31,0,108,DAL,25,30,28,18,0,101
4/4/2015,GSW,26,33,31,33,0,123,DAL,24,24,28,34,0,110
4/8/2015,PHO,30,33,22,19,0,104,DAL,27,32,26,22,0,107
4/10/2015,DAL,35,38,20,28,13,144,DEN,27,25,37,32,13,143
4/12/2015,DAL,33,29,27,31,0,120,LAL,27,30,25,24,0,106
4/13/2015,DAL,26,31,12,23,0,92,UTA,29,28,30,22,0,109
4/15/2015,POR,19,32,21,26,0,98,DAL,29,27,35,23,0,114
10/29/2014,MIL,24,33,26,17,6,106,CHO,25,21,22,32,8,108
10/31/2014,PHI,24,23,27,7,0,81,MIL,24,22,27,20,0,93
11/1/2014,MIL,17,27,24,29,0,97,WAS,29,20,34,25,0,108
11/4/2014,MIL,22,21,26,18,0,87,IND,19,19,23,20,0,81
11/5/2014,CHI,23,26,23,23,0,95,MIL,21,32,17,16,0,86
11/7/2014,MIL,21,23,28,23,0,95,DET,27,24,25,22,0,98
11/8/2014,MEM,23,28,21,20,0,92,MIL,21,23,22,27,0,93
11/11/2014,OKC,22,16,26,14,0,78,MIL,15,26,28,16,0,85
11/14/2014,MIL,30,19,19,17,0,85,ORL,25,27,28,21,0,101
11/16/2014,MIL,19,19,26,27,0,91,MIA,23,23,13,25,0,84
11/18/2014,NYK,30,19,31,33,0,113,MIL,30,36,29,22,0,117
11/19/2014,MIL,22,19,28,26,10,122,BRK,24,25,23,23,10,118
11/21/2014,MIL,27,18,12,25,0,82,TOR,37,34,30,23,0,124
11/22/2014,WAS,21,26,27,37,0,111,MIL,28,24,18,30,0,100
11/25/2014,DET,31,17,19,19,0,86,MIL,26,23,30,19,0,98
11/26/2014,MIL,26,25,21,31,0,103,MIN,24,23,23,16,0,86
11/28/2014,MIL,25,28,21,30,0,104,DET,29,16,24,19,0,88
11/29/2014,HOU,28,25,32,32,0,117,MIL,23,23,26,31,0,103
12/2/2014,MIL,23,31,25,29,0,108,CLE,30,22,27,32,0,111
12/3/2014,DAL,29,28,23,27,0,107,MIL,31,33,14,27,0,105
12/5/2014,MIA,30,20,21,14,0,85,MIL,25,29,26,29,0,109
12/7/2014,MIL,21,25,25,31,0,102,DAL,32,27,31,35,0,125
12/9/2014,MIL,31,21,26,23,0,101,OKC,26,35,26,27,0,114
12/13/2014,LAC,28,14,29,35,0,106,MIL,26,25,21,39,0,111
12/15/2014,MIL,14,30,23,29,0,96,PHO,26,27,19,22,0,94
12/17/2014,MIL,25,16,29,27,0,97,POR,18,25,25,36,0,104
12/18/2014,MIL,25,32,24,27,0,108,SAC,29,25,27,26,0,107
12/20/2014,MIL,24,28,31,19,0,102,LAC,28,22,32,24,0,106
12/23/2014,CHO,28,26,34,20,0,108,MIL,30,26,24,21,0,101
12/26/2014,MIL,24,34,23,26,0,107,ATL,22,20,16,19,0,77
12/27/2014,ATL,21,18,27,24,0,90,MIL,10,27,26,22,0,85
12/29/2014,MIL,25,24,19,15,21,104,CHO,18,14,29,22,11,94
12/31/2014,MIL,31,21,19,25,0,96,CLE,18,29,7,26,0,80
1/2/2015,IND,23,23,20,28,0,94,MIL,21,32,15,23,0,91
1/4/2015,MIL,22,23,31,19,0,95,NYK,21,17,26,18,0,82
1/6/2015,PHO,15,28,28,31,0,102,MIL,21,23,28,24,0,96
1/7/2015,MIL,27,26,24,20,0,97,PHI,11,28,21,17,0,77
1/9/2015,MIN,22,16,20,26,0,84,MIL,19,34,19,26,0,98
1/10/2015,MIL,19,20,23,25,0,87,CHI,29,19,20,27,0,95
1/15/2015,NYK,13,24,19,23,0,79,MIL,31,25,26,13,0,95
1/19/2015,TOR,22,31,15,24,0,92,MIL,25,19,18,27,0,89
1/22/2015,UTA,26,27,23,25,0,101,MIL,16,31,32,20,0,99
1/24/2015,DET,28,21,18,19,0,86,MIL,23,40,28,10,0,101
1/25/2015,MIL,24,31,12,28,0,95,SAS,21,26,22,32,0,101
1/27/2015,MIL,30,24,28,27,0,109,MIA,29,21,32,20,0,102
1/29/2015,MIL,28,31,37,19,0,115,ORL,18,26,27,29,0,100
1/31/2015,POR,15,27,23,23,0,88,MIL,27,18,31,19,0,95
2/2/2015,MIL,23,24,26,9,0,82,TOR,14,27,19,15,0,75
2/4/2015,LAL,24,30,14,26,11,105,MIL,26,20,28,20,19,113
2/6/2015,MIL,23,33,26,29,0,111,HOU,36,32,28,21,0,117
2/7/2015,BOS,23,23,29,18,0,93,MIL,23,30,27,16,0,96
2/9/2015,BRK,30,22,16,29,0,97,MIL,24,23,32,24,0,103
2/11/2015,SAC,29,22,18,34,0,103,MIL,29,31,27,24,0,111
2/20/2015,DEN,21,23,21,16,0,81,MIL,19,23,28,19,0,89
2/22/2015,ATL,22,26,18,31,0,97,MIL,13,22,29,22,0,86
2/23/2015,MIL,15,18,16,22,0,71,CHI,21,27,16,23,0,87
2/25/2015,PHI,12,20,28,28,0,88,MIL,29,32,21,22,0,104
2/27/2015,MIL,18,29,25,21,0,93,LAL,24,21,20,36,0,101
2/28/2015,MIL,18,22,15,20,0,75,UTA,26,21,11,24,0,82
3/3/2015,MIL,29,22,19,25,0,95,DEN,29,26,21,30,0,106
3/4/2015,MIL,19,34,18,22,0,93,GSW,25,28,19,30,0,102
3/7/2015,WAS,19,20,24,22,0,85,MIL,30,21,14,26,0,91
3/9/2015,NOP,29,31,27,27,0,114,MIL,26,24,34,19,0,103
3/11/2015,ORL,31,26,15,19,0,91,MIL,29,25,18,25,0,97
3/12/2015,MIL,31,22,21,22,7,103,IND,19,32,31,14,13,109
3/14/2015,MIL,20,22,19,22,0,83,MEM,22,27,29,18,0,96
3/17/2015,MIL,21,23,18,22,0,84,NOP,32,10,28,15,0,85
3/18/2015,SAS,27,36,28,23,0,114,MIL,28,26,26,23,0,103
3/20/2015,MIL,30,38,16,17,10,127,BRK,31,27,21,22,10,129
3/22/2015,CLE,25,19,31,33,0,108,MIL,26,27,20,17,0,90
3/24/2015,MIA,27,24,28,9,0,88,MIL,22,27,16,24,0,89
3/26/2015,IND,15,32,27,33,0,107,MIL,34,25,26,26,0,111
3/28/2015,GSW,24,24,34,26,0,108,MIL,23,15,25,32,0,95
3/30/2015,MIL,20,19,25,24,0,88,ATL,25,21,26,29,0,101
4/1/2015,CHI,25,23,26,17,0,91,MIL,20,28,22,25,0,95
4/3/2015,MIL,21,29,36,24,0,110,BOS,25,27,23,26,0,101
4/4/2015,ORL,22,29,21,25,0,97,MIL,31,22,20,17,0,90
4/8/2015,CLE,26,26,22,30,0,104,MIL,22,22,28,27,0,99
4/10/2015,MIL,28,24,29,18,0,99,NYK,21,28,16,26,0,91
4/12/2015,BRK,24,17,18,14,0,73,MIL,26,17,30,23,0,96
4/13/2015,MIL,24,28,28,27,0,107,PHI,31,27,20,19,0,97
4/15/2015,BOS,22,27,24,32,0,105,MIL,25,20,27,28,0,100
10/29/2014,PHI,24,27,22,18,0,91,IND,26,22,30,25,0,103
10/31/2014,PHI,24,23,27,7,0,81,MIL,24,22,27,20,0,93
11/1/2014,MIA,32,28,27,27,0,114,PHI,30,24,29,13,0,96
11/3/2014,HOU,32,23,24,25,0,104,PHI,19,35,20,19,0,93
11/5/2014,ORL,26,26,23,16,0,91,PHI,28,24,23,14,0,89
11/7/2014,CHI,33,24,35,26,0,118,PHI,28,29,19,39,0,115
11/9/2014,PHI,20,25,18,25,0,88,TOR,33,27,28,32,0,120
11/13/2014,PHI,10,19,24,17,0,70,DAL,38,35,22,28,0,123
11/14/2014,PHI,28,19,21,19,0,87,HOU,19,28,16,25,0,88
11/17/2014,PHI,13,21,23,18,0,75,SAS,30,16,27,27,0,100
11/19/2014,BOS,22,24,27,28,0,101,PHI,27,19,22,22,0,90
11/21/2014,PHO,26,41,25,30,0,122,PHI,27,17,23,29,0,96
11/22/2014,PHI,13,26,15,29,0,83,NYK,25,21,25,20,0,91
11/24/2014,POR,24,26,39,25,0,114,PHI,20,32,28,24,0,104
11/26/2014,BRK,32,17,23,27,0,99,PHI,19,22,26,24,0,91
11/29/2014,DAL,28,30,32,20,0,110,PHI,26,25,35,17,0,103
12/1/2014,SAS,27,34,23,25,0,109,PHI,20,26,27,30,0,103
12/3/2014,PHI,23,9,25,28,0,85,MIN,13,21,22,21,0,77
12/5/2014,OKC,31,26,25,21,0,103,PHI,24,23,20,24,0,91
12/6/2014,PHI,30,24,23,23,8,108,DET,28,23,31,18,1,101
12/10/2014,PHI,21,17,20,21,0,79,ATL,25,22,21,27,0,95
12/12/2014,PHI,18,27,15,10,0,70,BRK,22,22,19,25,0,88
12/13/2014,MEM,21,22,25,41,11,120,PHI,28,22,30,29,6,115
12/15/2014,BOS,30,27,31,17,0,105,PHI,25,13,26,23,0,87
12/19/2014,CHO,37,29,19,24,0,109,PHI,26,20,26,19,0,91
12/21/2014,PHI,23,14,27,32,0,96,ORL,20,22,18,28,0,88
12/23/2014,PHI,19,23,31,18,0,91,MIA,32,25,21,9,0,87
12/26/2014,PHI,24,27,23,19,0,93,POR,27,34,27,26,0,114
12/27/2014,PHI,12,20,23,16,0,71,UTA,25,19,15,29,0,88
12/30/2014,PHI,17,17,29,23,0,86,GSW,32,29,35,30,0,126
1/2/2015,PHI,29,30,20,17,0,96,PHO,34,23,27,28,0,112
1/3/2015,PHI,21,32,21,17,0,91,LAC,34,28,26,39,0,127
1/5/2015,CLE,20,30,18,24,0,92,PHI,19,18,23,35,0,95
1/7/2015,MIL,27,26,24,20,0,97,PHI,11,28,21,17,0,77
1/9/2015,PHI,23,22,19,26,0,90,BRK,32,14,25,17,0,88
1/10/2015,IND,21,28,21,22,0,92,PHI,19,24,29,21,0,93
1/13/2015,ATL,25,24,25,31,0,105,PHI,20,17,18,32,0,87
1/14/2015,PHI,19,27,15,23,0,84,TOR,34,16,21,29,0,100
1/16/2015,NOP,22,25,12,22,0,81,PHI,33,17,23,23,0,96
1/17/2015,PHI,21,16,25,27,0,89,DET,31,25,25,26,0,107
1/19/2015,PHI,14,18,26,18,0,76,WAS,27,28,30,26,0,111
1/21/2015,NYK,18,31,25,24,0,98,PHI,18,24,20,29,0,91
1/23/2015,TOR,22,26,15,28,0,91,PHI,30,11,21,24,0,86
1/24/2015,PHI,21,20,20,22,0,83,MEM,27,33,21,20,0,101
1/26/2015,PHI,19,24,19,12,0,74,NOP,30,22,33,14,0,99
1/28/2015,DET,16,21,18,14,0,69,PHI,28,20,20,21,0,89
1/30/2015,MIN,28,31,18,17,0,94,PHI,26,35,17,25,0,103
1/31/2015,PHI,10,24,32,19,0,85,ATL,22,27,22,20,0,91
2/2/2015,PHI,15,20,30,19,0,84,CLE,24,23,22,28,0,97
2/3/2015,DEN,28,12,28,30,0,98,PHI,34,27,24,20,0,105
2/6/2015,PHI,15,27,27,27,0,96,BOS,29,31,15,32,0,107
2/7/2015,CHO,24,24,13,20,0,81,PHI,23,19,28,19,0,89
2/9/2015,GSW,20,26,21,22,0,89,PHI,24,20,17,23,0,84
2/20/2015,IND,23,35,29,19,0,106,PHI,16,24,28,27,0,95
2/22/2015,PHI,23,24,22,29,0,98,ORL,29,26,21,27,0,103
2/23/2015,PHI,31,29,19,29,0,108,MIA,32,29,30,28,0,119
2/25/2015,PHI,12,20,28,28,0,88,MIL,29,32,21,22,0,104
2/27/2015,WAS,25,17,19,20,0,81,PHI,28,19,16,26,0,89
3/1/2015,PHI,24,22,18,10,0,74,IND,27,32,14,21,0,94
3/2/2015,TOR,26,29,28,31,0,114,PHI,22,27,27,27,0,103
3/4/2015,PHI,34,25,31,20,8,118,OKC,37,19,28,26,13,123
3/6/2015,UTA,21,20,23,25,0,89,PHI,24,18,13,28,0,83
3/7/2015,ATL,31,22,16,15,0,84,PHI,20,27,25,20,0,92
3/11/2015,CHI,22,29,21,20,12,104,PHI,22,29,12,29,3,95
3/13/2015,SAC,22,42,18,25,0,107,PHI,29,22,37,26,0,114
3/14/2015,BRK,27,24,23,20,0,94,PHI,29,27,10,21,0,87
3/16/2015,PHI,18,16,34,21,0,89,BOS,38,19,32,19,0,108
3/18/2015,DET,21,18,26,18,0,83,PHI,24,25,19,26,0,94
3/20/2015,NYK,23,25,18,15,0,81,PHI,29,25,26,17,0,97
3/22/2015,PHI,20,27,28,12,0,87,LAL,18,23,33,27,0,101
3/24/2015,PHI,31,39,14,22,0,106,SAC,27,36,24,20,0,107
3/25/2015,PHI,22,27,23,27,0,99,DEN,21,25,30,9,0,85
3/27/2015,LAC,34,28,32,25,0,119,PHI,19,35,14,30,0,98
3/29/2015,PHI,20,25,24,17,0,86,CLE,26,27,19,15,0,87
3/30/2015,LAL,17,34,25,26,11,113,PHI,28,22,21,31,9,111
4/1/2015,PHI,21,21,20,31,0,93,WAS,31,34,28,13,0,106
4/4/2015,PHI,16,35,18,22,0,91,CHO,19,30,23,20,0,92
4/5/2015,PHI,20,31,21,19,0,91,NYK,26,28,25,22,0,101
4/8/2015,WAS,35,35,25,24,0,119,PHI,24,30,23,13,0,90
4/11/2015,PHI,26,27,25,29,0,107,CHI,28,24,29,33,0,114
4/13/2015,MIL,24,28,28,27,0,107,PHI,31,27,20,19,0,97
4/15/2015,MIA,29,35,11,30,0,105,PHI,23,23,25,30,0,101
10/29/2014,LAL,19,31,23,26,0,99,PHO,33,26,39,21,0,119
10/31/2014,SAS,24,21,26,18,0,89,PHO,11,25,31,27,0,94
11/1/2014,PHO,22,33,20,16,0,91,UTA,33,26,30,29,0,118
11/4/2014,PHO,26,32,21,33,0,112,LAL,24,22,29,31,0,106
11/5/2014,MEM,26,20,30,26,0,102,PHO,27,25,19,20,0,91
11/7/2014,SAC,25,30,22,22,7,114,PHO,36,22,30,11,7,112
11/9/2014,GSW,30,28,21,16,0,95,PHO,28,19,24,36,0,107
11/12/2014,BRK,29,34,21,20,0,104,PHO,17,32,29,34,0,112
11/14/2014,CHO,14,33,27,29,0,103,PHO,28,19,28,20,0,95
11/15/2014,PHO,23,31,20,33,0,107,LAC,27,27,42,24,0,120
11/17/2014,PHO,33,27,29,29,0,118,BOS,31,23,34,26,0,114
11/19/2014,PHO,21,23,21,23,0,88,DET,19,24,21,22,0,86
11/21/2014,PHO,26,41,25,30,0,122,PHI,27,17,23,29,0,96
11/22/2014,PHO,30,25,25,26,0,106,IND,27,21,16,19,0,83
11/24/2014,PHO,26,22,18,34,0,100,TOR,29,25,27,23,0,104
11/26/2014,DEN,30,34,22,26,0,112,PHO,34,30,29,27,0,120
11/28/2014,PHO,22,25,23,27,0,97,DEN,33,33,33,23,0,122
11/30/2014,ORL,27,25,17,24,0,93,PHO,23,16,19,32,0,90
12/2/2014,IND,28,28,23,20,0,99,PHO,26,28,29,33,0,116
12/5/2014,PHO,40,29,24,25,0,118,DAL,27,30,29,20,0,106
12/6/2014,PHO,18,23,26,28,0,95,HOU,35,25,20,20,0,100
12/8/2014,PHO,28,29,23,32,8,120,LAC,28,32,29,23,9,121
12/9/2014,MIA,28,18,27,30,0,103,PHO,25,26,21,25,0,97
12/12/2014,DET,28,27,20,30,0,105,PHO,28,24,24,27,0,103
12/14/2014,PHO,29,19,16,24,0,88,OKC,41,29,19,23,0,112
12/15/2014,MIL,14,30,23,29,0,96,PHO,26,27,19,22,0,94
12/17/2014,PHO,27,27,29,28,0,111,CHO,31,30,26,19,0,106
12/20/2014,PHO,24,20,23,32,0,99,NYK,21,26,21,22,0,90
12/21/2014,PHO,22,28,29,25,0,104,WAS,23,27,21,21,0,92
12/23/2014,DAL,26,19,29,41,0,115,PHO,25,28,36,35,0,124
12/26/2014,PHO,28,31,35,21,0,115,SAC,21,35,34,16,0,106
12/28/2014,PHO,26,29,33,28,0,116,LAL,28,28,25,26,0,107
12/30/2014,PHO,25,28,26,27,0,106,NOP,31,24,26,29,0,110
12/31/2014,PHO,29,33,32,34,6,134,OKC,30,34,36,28,9,137
1/2/2015,PHI,29,30,20,17,0,96,PHO,34,23,27,28,0,112
1/4/2015,TOR,19,34,23,33,0,109,PHO,27,43,28,27,0,125
1/6/2015,PHO,15,28,28,31,0,102,MIL,21,23,28,24,0,96
1/7/2015,PHO,20,25,26,42,0,113,MIN,25,23,30,33,0,111
1/9/2015,PHO,18,25,26,26,0,95,SAS,29,20,10,41,0,100
1/11/2015,PHO,15,26,25,35,7,110,MEM,22,29,24,26,7,122
1/13/2015,CLE,24,27,28,21,0,100,PHO,31,28,26,22,0,107
1/16/2015,MIN,27,29,19,24,0,99,PHO,32,27,27,24,0,110
1/19/2015,LAL,26,25,26,23,0,100,PHO,26,25,36,28,0,115
1/21/2015,POR,29,23,24,37,0,113,PHO,40,26,25,27,0,118
1/23/2015,HOU,32,28,27,26,0,113,PHO,24,28,25,34,0,111
1/25/2015,LAC,23,32,34,31,0,120,PHO,16,41,20,23,0,100
1/28/2015,WAS,17,22,27,32,0,98,PHO,29,27,24,26,0,106
1/30/2015,CHI,23,19,25,26,0,93,PHO,26,29,13,31,0,99
1/31/2015,PHO,28,23,19,17,0,87,GSW,23,29,26,28,0,106
2/2/2015,MEM,25,24,28,25,0,102,PHO,23,21,28,29,0,101
2/5/2015,PHO,15,20,30,22,0,87,POR,27,19,20,42,0,108
2/6/2015,UTA,24,18,29,22,0,93,PHO,25,29,22,24,0,100
2/8/2015,PHO,18,24,17,24,0,83,SAC,26,22,25,12,0,85
2/10/2015,HOU,41,29,18,39,0,127,PHO,23,38,28,29,0,118
2/20/2015,PHO,24,18,35,32,0,109,MIN,26,26,28,31,0,111
2/21/2015,PHO,28,28,27,24,0,107,CHI,33,19,29,31,0,112
2/23/2015,BOS,26,41,22,26,0,115,PHO,21,29,29,31,0,110
2/25/2015,PHO,35,23,25,27,0,110,DEN,26,25,22,23,0,96
2/26/2015,OKC,15,33,36,25,4,113,PHO,25,28,33,23,8,117
2/28/2015,SAS,24,27,24,26,0,101,PHO,13,11,17,33,0,74
3/2/2015,PHO,24,24,26,24,0,98,MIA,23,39,23,30,0,115
3/4/2015,PHO,22,21,34,28,0,105,ORL,25,27,17,31,0,100
3/6/2015,PHO,21,29,19,23,16,108,BRK,21,25,34,12,8,100
3/7/2015,PHO,24,13,15,27,0,79,CLE,30,23,27,9,0,89
3/9/2015,GSW,25,21,30,22,0,98,PHO,19,27,15,19,0,80
3/11/2015,MIN,18,26,25,28,0,97,PHO,25,25,28,28,0,106
3/13/2015,ATL,28,20,17,31,0,96,PHO,23,27,23,14,0,87
3/15/2015,NYK,29,19,18,23,0,89,PHO,23,24,28,27,0,102
3/19/2015,NOP,15,19,19,19,0,72,PHO,21,22,12,19,0,74
3/21/2015,PHO,33,29,37,18,0,117,HOU,37,24,25,16,0,102
3/22/2015,DAL,27,15,33,17,0,92,PHO,33,24,19,22,0,98
3/25/2015,SAC,31,27,25,25,0,108,PHO,26,27,17,29,0,99
3/27/2015,POR,29,18,13,27,0,87,PHO,21,26,19,15,0,81
3/29/2015,OKC,24,30,22,33,0,109,PHO,35,27,17,18,0,97
3/30/2015,PHO,22,27,16,21,0,86,POR,31,24,37,17,0,109
4/2/2015,PHO,22,22,27,35,0,106,GSW,27,28,22,30,0,107
4/4/2015,UTA,18,19,31,17,0,85,PHO,13,34,18,22,0,87
4/7/2015,PHO,17,26,13,13,0,69,ATL,24,28,17,27,0,96
4/8/2015,PHO,30,33,22,19,0,104,DAL,27,32,26,22,0,107
4/10/2015,PHO,21,20,19,15,0,75,NOP,27,20,23,20,0,90
4/12/2015,PHO,18,21,26,26,0,91,SAS,20,31,25,31,0,107
4/14/2015,LAC,32,37,22,21,0,112,PHO,26,17,27,31,0,101
10/28/2014,HOU,31,31,23,23,0,108,LAL,19,26,24,21,0,90
10/29/2014,LAL,19,31,23,26,0,99,PHO,33,26,39,21,0,119
10/31/2014,LAC,31,31,24,32,0,118,LAL,22,34,34,21,0,111
11/1/2014,LAL,35,20,31,18,0,104,GSW,29,32,32,34,0,127
11/4/2014,PHO,26,32,21,33,0,112,LAL,24,22,29,31,0,106
11/9/2014,CHO,25,26,13,28,0,92,LAL,18,24,34,31,0,107
11/11/2014,LAL,21,31,23,27,0,102,MEM,25,31,27,24,0,107
11/12/2014,LAL,25,23,24,30,0,102,NOP,23,28,34,24,0,109
11/14/2014,SAS,29,18,21,25,0,93,LAL,22,13,22,23,0,80
11/16/2014,GSW,34,40,41,21,0,136,LAL,23,32,24,36,0,115
11/18/2014,LAL,31,36,24,23,0,114,ATL,20,32,31,26,0,109
11/19/2014,LAL,21,28,21,28,0,98,HOU,23,28,24,17,0,92
11/21/2014,LAL,27,32,24,23,0,106,DAL,38,30,42,30,0,140
11/23/2014,DEN,21,20,31,14,15,101,LAL,19,20,36,11,8,94
11/26/2014,MEM,21,25,34,19,0,99,LAL,26,25,23,19,0,93
11/28/2014,MIN,23,31,39,27,0,120,LAL,30,28,38,23,0,119
11/30/2014,TOR,24,25,31,29,13,122,LAL,27,31,23,28,20,129
12/2/2014,LAL,19,27,35,25,0,106,DET,19,26,20,31,0,96
12/3/2014,LAL,33,19,17,26,0,95,WAS,27,27,24,33,0,111
12/5/2014,LAL,20,28,22,26,0,96,BOS,30,23,33,27,0,113
12/7/2014,NOP,22,28,29,25,0,104,LAL,16,24,19,28,0,87
12/9/2014,SAC,29,26,26,14,0,95,LAL,24,22,32,20,0,98
12/12/2014,LAL,25,29,32,15,11,112,SAS,25,25,25,26,9,110
12/14/2014,LAL,22,27,22,29,0,100,MIN,19,25,25,25,0,94
12/15/2014,LAL,15,12,31,33,0,91,IND,34,26,29,21,0,110
12/19/2014,OKC,20,32,30,22,0,104,LAL,26,24,23,30,0,103
12/21/2014,LAL,23,37,20,21,0,101,SAC,26,26,29,27,0,108
12/23/2014,GSW,24,24,25,32,0,105,LAL,34,29,32,20,0,115
12/25/2014,LAL,24,23,30,16,0,93,CHI,27,31,25,30,0,113
12/26/2014,LAL,19,23,20,36,0,98,DAL,26,22,24,30,0,102
12/28/2014,PHO,26,29,33,28,0,116,LAL,28,28,25,26,0,107
12/30/2014,LAL,33,29,21,28,0,111,DEN,29,17,25,32,0,103
1/2/2015,MEM,22,25,33,29,0,109,LAL,25,27,25,29,0,106
1/4/2015,IND,28,20,21,18,0,87,LAL,15,26,22,25,0,88
1/5/2015,LAL,23,22,28,21,0,94,POR,24,23,23,28,0,98
1/7/2015,LAL,24,24,15,26,0,89,LAC,34,36,29,15,0,114
1/9/2015,ORL,20,25,22,17,0,84,LAL,29,25,19,28,0,101
1/11/2015,POR,23,27,22,34,0,106,LAL,20,25,24,25,0,94
1/13/2015,MIA,22,22,17,17,0,78,LAL,12,22,19,22,0,75
1/15/2015,CLE,30,27,22,30,0,109,LAL,30,31,14,27,0,102
1/16/2015,LAL,23,20,20,22,0,85,UTA,28,16,26,24,0,94
1/19/2015,LAL,26,25,26,23,0,100,PHO,26,25,36,28,0,115
1/21/2015,LAL,20,24,24,12,0,80,NOP,22,21,26,27,0,96
1/23/2015,LAL,15,23,23,24,0,85,SAS,31,25,20,23,0,99
1/25/2015,HOU,30,22,28,19,0,99,LAL,15,21,24,27,0,87
1/27/2015,WAS,24,22,29,23,0,98,LAL,31,26,19,16,0,92
1/29/2015,CHI,19,29,28,22,8,118,LAL,28,31,21,18,8,123
2/1/2015,LAL,19,20,18,23,0,80,NYK,32,15,25,20,0,92
2/4/2015,LAL,24,30,14,26,11,105,MIL,26,20,28,20,19,113
2/6/2015,LAL,23,29,26,13,6,97,ORL,26,12,31,22,12,103
2/8/2015,LAL,28,21,30,26,0,105,CLE,32,32,32,24,0,120
2/10/2015,DEN,24,21,26,35,0,106,LAL,29,19,23,25,0,96
2/11/2015,LAL,24,22,19,21,0,86,POR,32,22,34,14,0,102
2/20/2015,BRK,34,22,40,18,0,114,LAL,32,25,20,28,0,105
2/22/2015,BOS,32,26,20,28,5,111,LAL,26,30,17,33,12,118
2/25/2015,LAL,21,24,24,31,0,100,UTA,29,22,27,19,0,97
2/27/2015,MIL,18,29,25,21,0,93,LAL,24,21,20,36,0,101
3/1/2015,OKC,28,28,28,24,0,108,LAL,19,29,24,29,0,101
3/3/2015,LAL,30,20,20,33,0,103,CHO,27,23,24,30,0,104
3/4/2015,LAL,25,26,22,21,0,94,MIA,28,18,30,24,0,100
3/6/2015,LAL,16,30,25,19,0,90,MEM,24,19,24,30,0,97
3/8/2015,DAL,25,19,31,25,0,100,LAL,24,20,33,16,0,93
3/10/2015,DET,20,30,11,24,0,85,LAL,25,24,18,26,0,93
3/12/2015,NYK,25,35,20,21,0,101,LAL,28,26,20,20,0,94
3/15/2015,ATL,23,18,27,23,0,91,LAL,14,24,20,28,0,86
3/16/2015,LAL,30,24,24,27,0,105,GSW,30,28,24,26,0,108
3/19/2015,UTA,18,15,25,22,0,80,LAL,16,20,19,18,0,73
3/22/2015,PHI,20,27,28,12,0,87,LAL,18,23,33,27,0,101
3/24/2015,LAL,27,26,35,29,0,117,OKC,37,31,32,27,0,127
3/25/2015,LAL,24,25,24,17,11,101,MIN,15,28,23,24,9,99
3/27/2015,LAL,24,24,18,17,0,83,TOR,17,29,25,23,0,94
3/29/2015,LAL,19,31,24,25,0,99,BRK,30,31,24,22,0,107
3/30/2015,LAL,17,34,25,26,11,113,PHI,28,22,21,31,9,111
4/1/2015,NOP,29,31,30,23,0,113,LAL,31,18,21,22,0,92
4/3/2015,POR,26,26,22,33,0,107,LAL,12,27,24,14,0,77
4/5/2015,LAC,23,26,34,23,0,106,LAL,16,20,18,24,0,78
4/7/2015,LAL,21,18,30,31,0,100,LAC,23,27,26,29,0,105
4/8/2015,LAL,33,21,17,30,0,101,DEN,35,23,35,26,0,119
4/10/2015,MIN,21,26,24,27,0,98,LAL,30,22,28,26,0,106
4/12/2015,DAL,33,29,27,31,0,120,LAL,27,30,25,24,0,106
4/13/2015,LAL,24,27,23,18,0,92,SAC,24,27,24,27,0,102
4/15/2015,SAC,33,34,29,26,0,122,LAL,23,30,24,22,0,99
10/29/2014,HOU,27,31,17,29,0,104,UTA,27,23,22,21,0,93
10/30/2014,UTA,20,24,29,29,0,102,DAL,36,33,24,27,0,120
11/1/2014,PHO,22,33,20,16,0,91,UTA,33,26,30,29,0,118
11/3/2014,UTA,20,23,27,31,0,101,LAC,26,30,17,34,0,107
11/5/2014,CLE,23,25,27,25,0,100,UTA,32,27,17,26,0,102
11/7/2014,DAL,24,28,26,27,0,105,UTA,17,27,18,20,0,82
11/9/2014,UTA,27,25,22,23,0,97,DET,21,31,27,17,0,96
11/10/2014,UTA,20,21,28,17,0,86,IND,17,30,25,25,0,97
11/12/2014,UTA,32,22,34,9,0,97,ATL,32,25,25,18,0,100
11/14/2014,UTA,31,17,27,27,0,102,NYK,23,24,25,28,0,100
11/15/2014,UTA,25,24,23,21,0,93,TOR,23,23,30,35,0,111
11/18/2014,OKC,23,19,17,22,0,81,UTA,14,26,32,26,0,98
11/21/2014,UTA,13,19,25,31,0,88,GSW,28,26,31,16,0,101
11/22/2014,NOP,25,32,20,29,0,106,UTA,23,17,32,22,0,94
11/24/2014,CHI,30,26,22,19,0,97,UTA,14,27,36,18,0,95
11/26/2014,UTA,29,19,14,20,0,82,OKC,31,25,18,23,0,97
11/29/2014,LAC,35,27,28,22,0,112,UTA,18,32,26,20,0,96
12/1/2014,DEN,26,36,21,20,0,103,UTA,23,20,34,24,0,101
12/3/2014,TOR,31,38,28,26,0,123,UTA,24,29,29,22,0,104
12/5/2014,ORL,24,29,18,27,0,98,UTA,21,20,23,29,0,93
12/8/2014,UTA,31,18,19,24,0,92,SAC,23,32,13,33,0,101
12/9/2014,SAS,22,21,29,24,0,96,UTA,21,23,34,22,0,100
12/12/2014,MIA,29,33,16,22,0,100,UTA,24,23,27,21,0,95
12/14/2014,UTA,24,18,16,26,0,84,WAS,22,15,30,26,0,93
12/16/2014,UTA,26,30,33,22,0,111,NOP,20,33,25,41,0,119
12/17/2014,UTA,33,22,22,28,0,105,MIA,16,25,18,28,0,87
12/19/2014,UTA,29,20,32,20,0,101,ORL,17,26,23,28,0,94
12/20/2014,UTA,23,16,24,23,0,86,CHO,31,21,32,20,0,104
12/22/2014,UTA,19,25,26,27,0,97,MEM,22,21,25,23,0,91
12/27/2014,PHI,12,20,23,16,0,71,UTA,25,19,15,29,0,88
12/29/2014,UTA,18,26,33,20,0,97,LAC,25,23,29,24,0,101
12/30/2014,MIN,27,17,28,22,0,94,UTA,21,24,27,28,0,100
1/2/2015,ATL,31,26,25,16,0,98,UTA,21,24,23,24,0,92
1/3/2015,UTA,20,27,30,24,0,101,MIN,21,20,20,28,0,89
1/5/2015,IND,31,22,21,31,0,105,UTA,16,23,23,39,0,101
1/7/2015,UTA,22,14,27,34,0,97,CHI,16,16,19,26,0,77
1/9/2015,UTA,27,23,26,18,0,94,OKC,27,17,30,25,0,99
1/10/2015,UTA,23,14,20,25,0,82,HOU,23,23,32,19,0,97
1/13/2015,GSW,25,28,44,19,0,116,UTA,26,27,27,25,0,105
1/16/2015,LAL,23,20,20,22,0,85,UTA,28,16,26,24,0,94
1/18/2015,UTA,15,12,20,22,0,69,SAS,23,20,23,23,0,89
1/21/2015,UTA,20,20,22,30,0,92,CLE,31,22,29,24,0,106
1/22/2015,UTA,26,27,23,25,0,101,MIL,16,31,32,20,0,99
1/24/2015,BRK,21,16,22,14,0,73,UTA,25,33,23,27,0,108
1/26/2015,BOS,17,38,16,28,0,99,UTA,17,14,35,24,0,90
1/28/2015,LAC,24,25,19,26,0,94,UTA,26,24,22,17,0,89
1/30/2015,GSW,19,26,23,32,0,100,UTA,23,33,25,29,0,110
2/3/2015,UTA,23,24,23,32,0,102,POR,27,17,28,31,0,103
2/4/2015,MEM,30,28,19,23,0,100,UTA,23,28,20,19,0,90
2/6/2015,UTA,24,18,29,22,0,93,PHO,25,29,22,24,0,100
2/7/2015,SAC,15,24,22,29,0,90,UTA,25,24,26,27,0,102
2/9/2015,UTA,27,15,29,29,0,100,NOP,25,27,15,29,0,96
2/11/2015,UTA,9,28,20,25,0,82,DAL,22,17,25,23,0,87
2/20/2015,POR,24,19,16,17,0,76,UTA,18,21,26,27,0,92
2/23/2015,SAS,22,18,24,17,0,81,UTA,28,19,26,17,0,90
2/25/2015,LAL,21,24,24,31,0,100,UTA,29,22,27,19,0,97
2/27/2015,UTA,28,22,30,24,0,104,DEN,17,17,19,29,0,82
2/28/2015,MIL,18,22,15,20,0,75,UTA,26,21,11,24,0,82
3/3/2015,UTA,19,18,27,29,0,93,MEM,20,18,23,21,0,82
3/4/2015,UTA,19,14,22,29,0,84,BOS,18,16,27,24,0,85
3/6/2015,UTA,21,20,23,25,0,89,PHI,24,18,13,28,0,83
3/8/2015,UTA,21,21,24,29,0,95,BRK,24,19,20,25,0,88
3/10/2015,NYK,20,15,30,17,0,82,UTA,24,19,22,22,0,87
3/12/2015,HOU,23,20,22,26,0,91,UTA,28,25,29,27,0,109
3/14/2015,DET,18,25,12,30,0,85,UTA,18,31,13,26,0,88
3/16/2015,CHO,16,14,16,20,0,66,UTA,30,31,24,9,0,94
3/18/2015,WAS,26,16,25,21,0,88,UTA,21,19,21,23,0,84
3/19/2015,UTA,18,15,25,22,0,80,LAL,16,20,19,18,0,73
3/21/2015,UTA,15,25,33,18,0,91,GSW,19,30,36,21,0,106
3/23/2015,MIN,20,22,18,36,10,106,UTA,22,26,15,33,8,104
3/25/2015,POR,12,25,18,37,0,92,UTA,21,18,26,24,0,89
3/27/2015,UTA,20,19,24,28,0,91,DEN,22,30,23,32,0,107
3/28/2015,OKC,32,17,17,23,0,89,UTA,21,26,29,18,0,94
3/30/2015,UTA,25,25,31,23,0,104,MIN,18,22,17,27,0,84
4/1/2015,DEN,29,13,17,25,0,84,UTA,22,32,27,17,0,98
4/4/2015,UTA,18,19,31,17,0,85,PHO,13,34,18,22,0,87
4/5/2015,UTA,31,18,27,25,0,101,SAC,27,22,24,22,0,95
4/8/2015,SAC,22,27,24,18,0,91,UTA,21,22,32,28,0,103
4/10/2015,MEM,29,20,24,16,0,89,UTA,23,26,23,16,0,88
4/11/2015,UTA,32,24,21,34,0,111,POR,19,27,34,25,0,105
4/13/2015,DAL,26,31,12,23,0,92,UTA,29,28,30,22,0,109
4/15/2015,UTA,20,15,25,31,0,91,HOU,31,34,28,24,0,117
10/29/2014,GSW,25,22,26,22,0,95,SAC,23,26,14,14,0,77
10/31/2014,POR,24,24,23,23,0,94,SAC,26,22,23,32,0,103
11/2/2014,SAC,25,20,25,28,0,98,LAC,19,32,23,18,0,92
11/3/2014,SAC,19,32,28,31,0,110,DEN,22,24,31,28,0,105
11/5/2014,DEN,19,35,18,37,0,109,SAC,40,28,37,26,0,131
11/7/2014,SAC,25,30,22,22,7,114,PHO,36,22,30,11,7,112
11/9/2014,SAC,17,22,26,28,0,93,OKC,24,28,15,34,0,101
11/11/2014,SAC,32,25,15,26,0,98,DAL,14,34,30,28,0,106
11/13/2014,SAC,38,24,29,19,0,110,MEM,16,30,30,35,0,111
11/15/2014,SAS,24,14,28,25,0,91,SAC,23,22,25,24,0,94
11/18/2014,NOP,20,25,31,30,0,106,SAC,27,27,15,31,0,100
11/20/2014,CHI,29,18,21,20,0,88,SAC,22,30,28,23,0,103
11/22/2014,SAC,21,27,36,29,0,113,MIN,24,28,25,24,0,101
11/25/2014,SAC,27,22,26,24,0,99,NOP,16,33,21,19,0,89
11/26/2014,SAC,19,31,23,16,0,89,HOU,37,20,20,25,0,102
11/28/2014,SAC,22,29,29,24,0,104,SAS,26,35,27,24,0,112
11/30/2014,MEM,28,30,16,23,0,97,SAC,20,22,23,20,0,85
12/2/2014,TOR,31,26,35,25,0,117,SAC,22,33,28,26,0,109
12/5/2014,IND,20,25,27,24,5,101,SAC,34,22,24,16,6,102
12/6/2014,ORL,27,25,25,28,0,105,SAC,27,22,17,30,0,96
12/8/2014,UTA,31,18,19,24,0,92,SAC,23,32,13,33,0,101
12/9/2014,SAC,29,26,26,14,0,95,LAL,24,22,32,20,0,98
12/11/2014,HOU,16,20,25,34,18,113,SAC,26,20,23,26,14,109
12/13/2014,DET,23,20,24,28,0,95,SAC,24,22,14,30,0,90
12/16/2014,OKC,34,27,20,23,0,104,SAC,20,34,17,21,0,92
12/18/2014,MIL,25,32,24,27,0,108,SAC,29,25,27,26,0,107
12/21/2014,LAL,23,37,20,21,0,101,SAC,26,26,29,27,0,108
12/22/2014,SAC,20,30,26,32,0,108,GSW,36,28,29,35,0,128
12/26/2014,PHO,28,31,35,21,0,115,SAC,21,35,34,16,0,106
12/27/2014,NYK,27,31,22,37,12,129,SAC,38,29,22,28,18,135
12/29/2014,SAC,28,16,25,30,0,99,BRK,27,30,25,25,0,107
12/31/2014,SAC,19,20,22,23,0,84,BOS,23,26,28,29,0,106
1/1/2015,SAC,37,23,24,26,0,110,MIN,29,29,22,27,0,107
1/4/2015,SAC,22,24,32,17,0,95,DET,24,31,29,30,0,114
1/7/2015,OKC,16,27,14,26,0,83,SAC,28,25,25,26,0,104
1/9/2015,DEN,30,24,36,28,0,118,SAC,27,33,15,33,0,108
1/11/2015,CLE,29,15,20,20,0,84,SAC,30,29,26,18,0,103
1/13/2015,DAL,29,31,20,19,9,108,SAC,33,30,20,16,5,104
1/16/2015,MIA,26,26,23,20,0,95,SAC,22,22,17,22,0,83
1/17/2015,LAC,28,24,31,34,0,117,SAC,28,24,26,30,0,108
1/19/2015,SAC,31,25,19,19,0,94,POR,23,28,16,31,0,98
1/21/2015,BRK,36,26,20,21,0,103,SAC,24,22,23,31,0,100
1/23/2015,SAC,25,26,22,28,0,101,GSW,34,22,41,29,0,126
1/28/2015,SAC,22,32,22,26,0,102,TOR,26,28,39,26,0,119
1/30/2015,SAC,20,24,21,25,0,90,CLE,30,25,31,15,0,101
1/31/2015,SAC,34,30,15,20,0,99,IND,21,29,17,27,0,94
2/3/2015,GSW,29,34,31,27,0,121,SAC,22,20,38,16,0,96
2/5/2015,DAL,23,37,23,18,0,101,SAC,23,20,17,18,0,78
2/7/2015,SAC,15,24,22,29,0,90,UTA,25,24,26,27,0,102
2/8/2015,PHO,18,24,17,24,0,83,SAC,26,22,25,12,0,85
2/10/2015,SAC,26,23,15,22,0,86,CHI,30,27,27,20,0,104
2/11/2015,SAC,29,22,18,34,0,103,MIL,29,31,27,24,0,111
2/20/2015,BOS,27,24,23,27,0,101,SAC,28,28,26,27,0,109
2/21/2015,SAC,29,18,18,34,0,99,LAC,24,42,31,29,0,126
2/25/2015,MEM,25,27,25,13,0,90,SAC,32,30,14,26,0,102
2/27/2015,SAS,20,29,31,27,0,107,SAC,25,21,32,18,0,96
3/1/2015,POR,34,30,21,25,0,110,SAC,23,27,25,24,0,99
3/3/2015,SAC,35,30,35,24,0,124,NYK,19,20,29,18,0,86
3/4/2015,SAC,27,11,23,24,0,85,SAS,26,28,31,27,0,112
3/6/2015,SAC,26,31,29,28,0,114,ORL,35,33,24,27,0,119
3/7/2015,SAC,30,31,17,18,13,109,MIA,26,21,21,28,18,114
3/9/2015,SAC,20,34,28,23,0,105,ATL,33,43,29,25,0,130
3/11/2015,SAC,24,27,27,35,0,113,CHO,21,25,32,28,0,106
3/13/2015,SAC,22,42,18,25,0,107,PHI,29,22,37,26,0,114
3/14/2015,SAC,25,39,21,12,0,97,WAS,21,25,38,29,0,113
3/16/2015,ATL,28,26,28,28,0,110,SAC,29,18,29,27,0,103
3/18/2015,LAC,28,23,29,36,0,116,SAC,24,25,24,32,0,105
3/20/2015,CHO,22,24,23,22,0,91,SAC,29,28,23,21,0,101
3/22/2015,WAS,29,21,20,16,0,86,SAC,34,23,33,19,0,109
3/24/2015,PHI,31,39,14,22,0,106,SAC,27,36,24,20,0,107
3/25/2015,SAC,31,27,25,25,0,108,PHO,26,27,17,29,0,99
3/27/2015,SAC,20,22,24,22,0,88,NOP,18,28,28,28,0,102
3/30/2015,SAC,20,23,21,19,0,83,MEM,24,32,19,22,0,97
4/1/2015,SAC,25,30,31,25,0,111,HOU,35,23,39,18,0,115
4/3/2015,NOP,31,25,18,27,0,101,SAC,23,19,29,24,0,95
4/5/2015,UTA,31,18,27,25,0,101,SAC,27,22,24,22,0,95
4/7/2015,MIN,31,18,25,37,0,111,SAC,23,31,36,26,0,116
4/8/2015,SAC,22,27,24,18,0,91,UTA,21,22,32,28,0,103
4/10/2015,SAC,24,25,27,27,0,103,OKC,34,23,25,34,0,116
4/12/2015,SAC,28,31,25,27,0,111,DEN,37,23,34,28,0,122
4/13/2015,LAL,24,27,23,18,0,92,SAC,24,27,24,27,0,102
4/15/2015,SAC,33,34,29,26,0,122,LAL,23,30,24,22,0,99
10/29/2014,CHI,24,29,31,20,0,104,NYK,20,23,17,20,0,80
10/30/2014,NYK,18,24,25,28,0,95,CLE,25,19,20,26,0,90
11/2/2014,CHO,21,29,30,13,0,93,NYK,29,23,27,17,0,96
11/4/2014,WAS,17,23,32,26,0,98,NYK,23,22,15,23,0,83
11/5/2014,NYK,20,17,22,36,0,95,DET,25,24,26,23,0,98
11/7/2014,NYK,20,22,26,31,0,99,BRK,30,25,31,24,0,110
11/8/2014,NYK,32,29,13,22,0,96,ATL,20,28,27,28,0,103
11/10/2014,ATL,17,21,26,27,0,91,NYK,16,22,21,26,0,85
11/12/2014,ORL,31,25,18,23,0,97,NYK,27,23,26,19,0,95
11/14/2014,UTA,31,17,27,27,0,102,NYK,23,24,25,28,0,100
11/16/2014,DEN,31,8,35,19,0,93,NYK,31,31,24,23,0,109
11/18/2014,NYK,30,19,31,33,0,113,MIL,30,36,29,22,0,117
11/19/2014,NYK,25,26,22,26,0,99,MIN,27,37,29,22,0,115
11/22/2014,PHI,13,26,15,29,0,83,NYK,25,21,25,20,0,91
11/24/2014,NYK,26,20,23,17,0,86,HOU,27,24,18,22,0,91
11/26/2014,NYK,24,18,31,22,7,102,DAL,19,27,25,24,14,109
11/28/2014,NYK,13,20,17,28,0,78,OKC,30,29,23,23,0,105
11/30/2014,MIA,21,21,21,23,0,86,NYK,17,17,25,20,0,79
12/2/2014,BRK,27,22,28,21,0,98,NYK,18,27,19,29,0,93
12/4/2014,CLE,25,25,18,22,0,90,NYK,24,29,20,14,0,87
12/5/2014,NYK,21,24,24,33,0,102,CHO,31,26,28,18,0,103
12/7/2014,POR,25,28,30,20,0,103,NYK,20,30,25,24,0,99
12/9/2014,NYK,27,25,21,20,0,93,NOP,28,26,23,27,0,104
12/10/2014,NYK,26,26,21,22,0,95,SAS,29,27,38,15,0,109
12/12/2014,NYK,26,25,24,26,0,101,BOS,19,27,23,26,0,95
12/14/2014,TOR,27,18,27,14,9,95,NYK,27,19,21,19,4,90
12/16/2014,DAL,36,18,27,26,0,107,NYK,24,20,24,19,0,87
12/18/2014,NYK,20,25,29,23,0,97,CHI,30,22,21,30,0,103
12/20/2014,PHO,24,20,23,32,0,99,NYK,21,26,21,22,0,90
12/21/2014,NYK,25,26,24,33,0,108,TOR,33,25,33,27,0,118
12/25/2014,WAS,34,26,24,18,0,102,NYK,23,21,26,21,0,91
12/27/2014,NYK,27,31,22,37,12,129,SAC,38,29,22,28,18,135
12/28/2014,NYK,22,19,17,21,0,79,POR,31,24,21,25,0,101
12/31/2014,NYK,21,19,18,20,0,78,LAC,29,21,24,25,0,99
1/2/2015,DET,24,33,25,15,0,97,NYK,20,18,14,29,0,81
1/4/2015,MIL,22,23,31,19,0,95,NYK,21,17,26,18,0,82
1/5/2015,NYK,14,22,26,21,0,83,MEM,21,26,37,21,0,105
1/7/2015,NYK,21,20,26,24,0,91,WAS,30,23,24,24,0,101
1/8/2015,HOU,27,29,37,27,0,120,NYK,22,20,27,27,0,96
1/10/2015,CHO,21,41,27,21,0,110,NYK,18,13,13,38,0,82
1/15/2015,NYK,13,24,19,23,0,79,MIL,31,25,26,13,0,95
1/19/2015,NOP,16,25,24,27,0,92,NYK,22,31,25,21,0,99
1/21/2015,NYK,18,31,25,24,0,98,PHI,18,24,20,29,0,91
1/23/2015,ORL,26,24,28,28,0,106,NYK,20,31,31,31,0,113
1/24/2015,NYK,23,14,17,17,0,71,CHO,16,20,21,19,0,76
1/28/2015,OKC,19,26,22,25,0,92,NYK,20,23,25,32,0,100
1/29/2015,NYK,29,20,12,21,0,82,IND,22,32,35,14,0,103
2/1/2015,LAL,19,20,18,23,0,80,NYK,32,15,25,20,0,92
2/3/2015,BOS,26,31,23,28,0,108,NYK,19,25,28,25,0,97
2/6/2015,NYK,21,24,25,18,0,88,BRK,29,24,15,24,0,92
2/7/2015,GSW,32,32,27,15,0,106,NYK,19,29,26,18,0,92
2/9/2015,NYK,32,24,18,21,0,95,MIA,23,29,25,32,0,109
2/11/2015,NYK,24,23,13,23,0,83,ORL,27,17,20,25,0,89
2/20/2015,MIA,25,33,29,24,0,111,NYK,26,22,20,19,0,87
2/22/2015,CLE,36,26,19,20,0,101,NYK,17,21,17,28,0,83
2/25/2015,NYK,25,24,23,22,0,94,BOS,23,25,32,35,0,115
2/27/2015,NYK,23,18,25,29,10,121,DET,28,25,16,26,10,115
2/28/2015,TOR,15,32,24,27,0,98,NYK,22,28,25,28,0,103
3/3/2015,SAC,35,30,35,24,0,124,NYK,19,20,29,18,0,86
3/4/2015,NYK,19,22,23,18,0,82,IND,30,35,23,17,0,105
3/7/2015,IND,22,16,22,32,0,92,NYK,18,25,20,23,0,86
3/9/2015,NYK,25,15,19,19,0,78,DEN,25,30,36,15,0,106
3/10/2015,NYK,20,15,30,17,0,82,UTA,24,19,22,22,0,87
3/12/2015,NYK,25,35,20,21,0,101,LAL,28,26,20,20,0,94
3/14/2015,NYK,27,25,21,21,0,94,GSW,26,47,38,14,0,125
3/15/2015,NYK,29,19,18,23,0,89,PHO,23,24,28,27,0,102
3/17/2015,SAS,29,23,23,21,4,100,NYK,25,17,26,28,8,104
3/19/2015,MIN,29,25,15,16,10,95,NYK,26,20,23,16,7,92
3/20/2015,NYK,23,25,18,15,0,81,PHI,29,25,26,17,0,97
3/22/2015,NYK,23,18,25,23,0,89,TOR,27,29,18,32,0,106
3/23/2015,MEM,30,20,24,29,0,103,NYK,20,28,13,21,0,82
3/25/2015,LAC,28,35,27,21,0,111,NYK,17,16,21,26,0,80
3/27/2015,BOS,21,26,23,26,0,96,NYK,22,17,24,29,0,92
3/28/2015,NYK,17,17,19,27,0,80,CHI,28,26,30,27,0,111
4/1/2015,BRK,30,28,27,15,0,100,NYK,21,32,18,27,0,98
4/3/2015,NYK,10,36,21,20,0,87,WAS,30,24,29,18,0,101
4/5/2015,PHI,20,31,21,19,0,91,NYK,26,28,25,22,0,101
4/8/2015,IND,26,28,29,19,0,102,NYK,14,24,17,31,0,86
4/10/2015,MIL,28,24,29,18,0,99,NYK,21,28,16,26,0,91
4/11/2015,NYK,30,8,23,19,0,80,ORL,24,7,19,29,0,79
4/13/2015,NYK,32,30,21,29,0,112,ATL,28,21,29,30,0,108
4/15/2015,DET,34,21,29,28,0,112,NYK,25,21,24,20,0,90
10/28/2014,ORL,25,16,23,20,0,84,NOP,24,24,30,23,0,101
11/1/2014,DAL,32,34,20,23,0,109,NOP,26,26,37,15,0,104
11/3/2014,NOP,13,20,23,25,0,81,MEM,20,20,24,29,0,93
11/4/2014,CHO,21,27,17,26,0,91,NOP,26,21,26,27,0,100
11/8/2014,NOP,30,25,26,19,0,100,SAS,23,30,18,28,0,99
11/10/2014,NOP,28,28,23,32,0,111,CLE,24,27,34,33,0,118
11/12/2014,LAL,25,23,24,30,0,102,NOP,23,28,34,24,0,109
11/14/2014,MIN,19,25,28,19,0,91,NOP,43,37,38,21,0,139
11/17/2014,NOP,21,28,31,13,0,93,POR,22,20,26,34,0,102
11/18/2014,NOP,20,25,31,30,0,106,SAC,27,27,15,31,0,100
11/21/2014,NOP,26,23,24,24,0,97,DEN,31,28,27,31,0,117
11/22/2014,NOP,25,32,20,29,0,106,UTA,23,17,32,22,0,94
11/25/2014,SAC,27,22,26,24,0,99,NOP,16,33,21,19,0,89
11/28/2014,NOP,15,13,23,40,0,91,ATL,19,22,21,38,0,100
11/29/2014,NOP,18,18,21,23,0,80,WAS,23,17,25,18,0,83
12/2/2014,OKC,26,26,22,30,0,104,NOP,29,40,16,27,0,112
12/4/2014,NOP,28,12,26,19,0,85,GSW,22,31,27,32,0,112
12/6/2014,NOP,18,36,24,22,0,100,LAC,34,20,39,27,0,120
12/7/2014,NOP,22,28,29,25,0,104,LAL,16,24,19,28,0,87
12/9/2014,NYK,27,25,21,20,0,93,NOP,28,26,23,27,0,104
12/10/2014,NOP,15,36,27,29,0,107,DAL,25,22,30,35,0,112
12/12/2014,CLE,33,26,17,38,0,114,NOP,33,31,25,30,0,119
12/14/2014,GSW,28,32,29,22,17,128,NOP,31,20,38,22,11,122
12/16/2014,UTA,26,30,33,22,0,111,NOP,20,33,25,41,0,119
12/18/2014,NOP,21,25,19,34,0,99,HOU,22,17,29,22,0,90
12/20/2014,POR,32,30,32,20,0,114,NOP,17,27,18,26,0,88
12/21/2014,NOP,25,28,23,25,0,101,OKC,28,20,33,18,0,99
12/23/2014,NOP,26,14,21,23,0,84,IND,24,20,26,26,0,96
12/26/2014,SAS,24,20,20,26,0,90,NOP,20,28,22,27,0,97
12/27/2014,NOP,25,20,26,29,0,100,CHI,23,26,31,27,0,107
12/30/2014,PHO,25,28,26,27,0,106,NOP,31,24,26,29,0,110
12/31/2014,NOP,14,14,32,24,9,93,SAS,17,21,24,22,11,95
1/2/2015,HOU,20,22,18,23,0,83,NOP,29,30,30,22,0,111
1/5/2015,WAS,27,25,17,23,0,92,NOP,23,21,20,21,0,85
1/7/2015,NOP,27,21,22,24,0,94,CHO,20,21,26,31,0,98
1/9/2015,MEM,19,20,32,24,0,95,NOP,31,21,30,24,0,106
1/12/2015,NOP,22,27,27,24,0,100,BOS,22,27,23,36,0,108
1/14/2015,NOP,22,36,25,22,0,105,DET,18,18,30,28,0,94
1/16/2015,NOP,22,25,12,22,0,81,PHI,33,17,23,23,0,96
1/18/2015,NOP,21,29,14,31,0,95,TOR,14,22,35,22,0,93
1/19/2015,NOP,16,25,24,27,0,92,NYK,22,31,25,21,0,99
1/21/2015,LAL,20,24,24,12,0,80,NOP,22,21,26,27,0,96
1/23/2015,NOP,24,21,24,23,0,92,MIN,20,24,19,21,0,84
1/25/2015,DAL,22,34,28,22,0,106,NOP,25,36,28,20,0,109
1/26/2015,PHI,19,24,19,12,0,74,NOP,30,22,33,14,0,99
1/28/2015,DEN,28,21,21,23,0,93,NOP,17,22,31,15,0,85
1/30/2015,LAC,26,28,22,27,0,103,NOP,28,25,35,20,0,108
2/2/2015,ATL,22,20,32,26,0,100,NOP,32,23,33,27,0,115
2/4/2015,OKC,31,20,26,25,0,102,NOP,29,28,19,15,0,91
2/6/2015,NOP,29,24,30,33,0,116,OKC,33,23,25,32,0,113
2/7/2015,CHI,18,30,33,26,0,107,NOP,20,19,17,16,0,72
2/9/2015,UTA,27,15,29,29,0,100,NOP,25,27,15,29,0,96
2/11/2015,IND,32,25,32,17,0,106,NOP,18,17,25,33,0,93
2/20/2015,NOP,20,27,24,13,0,84,ORL,19,24,30,22,0,95
2/21/2015,NOP,25,27,33,20,0,105,MIA,14,28,23,26,0,91
2/23/2015,TOR,28,28,18,23,0,97,NOP,17,27,23,33,0,100
2/25/2015,BRK,21,29,23,23,0,96,NOP,27,26,23,26,0,102
2/27/2015,MIA,25,29,28,20,0,102,NOP,24,30,19,31,0,104
3/1/2015,NOP,21,16,28,34,0,99,DEN,16,21,28,27,0,92
3/2/2015,NOP,31,27,13,22,0,93,DAL,32,23,25,22,0,102
3/4/2015,DET,24,22,17,22,0,85,NOP,17,25,23,23,0,88
3/6/2015,BOS,27,20,24,33,0,104,NOP,25,22,21,30,0,98
3/7/2015,MEM,25,25,17,22,0,89,NOP,18,20,33,24,0,95
3/9/2015,NOP,29,31,27,27,0,114,MIL,26,24,34,19,0,103
3/10/2015,NOP,23,32,23,33,0,111,BRK,27,19,15,30,0,91
3/15/2015,DEN,21,29,21,30,8,118,NOP,26,21,30,24,8,111
3/17/2015,MIL,21,23,18,22,0,84,NOP,32,10,28,15,0,85
3/19/2015,NOP,15,19,19,19,0,72,PHO,21,22,12,19,0,74
3/20/2015,NOP,26,16,26,28,0,96,GSW,30,23,33,26,0,112
3/22/2015,NOP,28,25,24,23,0,100,LAC,27,23,31,26,0,107
3/25/2015,HOU,19,30,29,17,0,95,NOP,34,18,18,23,0,93
3/27/2015,SAC,20,22,24,22,0,88,NOP,18,28,28,28,0,102
3/29/2015,MIN,11,30,29,18,0,88,NOP,25,25,27,33,0,110
4/1/2015,NOP,29,31,30,23,0,113,LAL,31,18,21,22,0,92
4/3/2015,NOP,31,25,18,27,0,101,SAC,23,19,29,24,0,95
4/4/2015,NOP,24,20,28,18,0,90,POR,22,34,19,24,0,99
4/7/2015,GSW,27,28,23,22,0,100,NOP,19,24,36,24,0,103
4/8/2015,NOP,24,12,19,19,0,74,MEM,27,28,26,29,0,110
4/10/2015,PHO,21,20,19,15,0,75,NOP,27,20,23,20,0,90
4/12/2015,NOP,28,27,31,28,0,114,HOU,22,30,34,35,0,121
4/13/2015,NOP,22,28,23,27,0,100,MIN,20,15,27,26,0,88
4/15/2015,SAS,19,28,24,32,0,103,NOP,34,29,19,26,0,108
10/29/2014,DET,21,19,23,16,0,79,DEN,23,19,23,24,0,89
10/30/2014,DET,21,23,21,26,0,91,MIN,21,24,30,22,0,97
11/1/2014,BRK,33,26,22,21,0,102,DET,25,22,28,15,0,90
11/5/2014,NYK,20,17,22,36,0,95,DET,25,24,26,23,0,98
11/7/2014,MIL,21,23,28,23,0,95,DET,27,24,25,22,0,98
11/9/2014,UTA,27,25,22,23,0,97,DET,21,31,27,17,0,96
11/10/2014,DET,21,23,26,21,0,91,CHI,27,33,18,24,0,102
11/12/2014,DET,34,25,26,18,0,103,WAS,24,33,25,25,0,107
11/14/2014,DET,21,21,25,15,14,96,OKC,30,18,18,16,7,89
11/15/2014,DET,16,34,14,24,0,88,MEM,25,26,18,26,0,95
11/17/2014,ORL,28,21,29,29,0,107,DET,28,24,24,17,0,93
11/19/2014,PHO,21,23,21,23,0,88,DET,19,24,21,22,0,86
11/21/2014,DET,25,15,24,25,0,89,ATL,29,21,24,25,0,99
11/25/2014,DET,31,17,19,19,0,86,MIL,26,23,30,19,0,98
11/26/2014,LAC,25,23,24,32,0,104,DET,27,24,22,25,0,98
11/28/2014,MIL,25,28,21,30,0,104,DET,29,16,24,19,0,88
11/30/2014,GSW,21,32,29,22,0,104,DET,24,16,31,22,0,93
12/2/2014,LAL,19,27,35,25,0,106,DET,19,26,20,31,0,96
12/3/2014,DET,23,20,15,30,14,102,BOS,21,21,19,27,21,109
12/6/2014,PHI,30,24,23,23,8,108,DET,28,23,31,18,1,101
12/7/2014,OKC,25,23,29,19,0,96,DET,33,22,20,19,0,94
12/9/2014,POR,33,22,21,22,0,98,DET,22,24,16,24,0,86
12/12/2014,DET,28,27,20,30,0,105,PHO,28,24,24,27,0,103
12/13/2014,DET,23,20,24,28,0,95,SAC,24,22,14,30,0,90
12/15/2014,DET,27,17,19,28,0,91,LAC,29,26,31,27,0,113
12/17/2014,DAL,32,21,30,34,0,117,DET,30,21,22,33,0,106
12/19/2014,TOR,26,26,29,29,0,110,DET,31,21,18,30,0,100
12/21/2014,DET,18,33,27,27,0,105,BRK,28,25,30,27,0,110
12/26/2014,IND,26,27,29,27,0,109,DET,32,25,36,26,0,119
12/28/2014,DET,17,33,27,26,0,103,CLE,28,19,14,19,0,80
12/30/2014,DET,20,34,26,29,0,109,ORL,21,26,23,16,0,86
1/2/2015,DET,24,33,25,15,0,97,NYK,20,18,14,29,0,81
1/4/2015,SAC,22,24,32,17,0,95,DET,24,31,29,30,0,114
1/6/2015,DET,20,29,33,23,0,105,SAS,37,21,19,27,0,104
1/7/2015,DET,31,23,20,34,0,108,DAL,26,23,19,27,0,95
1/9/2015,ATL,31,33,26,16,0,106,DET,22,23,30,28,0,103
1/10/2015,BRK,21,26,22,24,0,93,DET,22,25,27,24,0,98
1/12/2015,DET,20,28,34,32,0,114,TOR,32,28,23,28,0,111
1/14/2015,NOP,22,36,25,22,0,105,DET,18,18,30,28,0,94
1/16/2015,DET,23,26,30,19,0,98,IND,19,32,25,20,0,96
1/17/2015,PHI,21,16,25,27,0,89,DET,31,25,25,26,0,107
1/19/2015,DET,12,29,20,21,0,82,ATL,16,28,24,25,0,93
1/21/2015,ORL,24,24,36,34,0,118,DET,35,30,31,32,0,128
1/24/2015,DET,28,21,18,19,0,86,MIL,23,40,28,10,0,101
1/25/2015,DET,25,28,26,31,0,110,TOR,26,32,31,25,0,114
1/27/2015,CLE,17,30,28,28,0,103,DET,19,20,25,31,0,95
1/28/2015,DET,16,21,18,14,0,69,PHI,28,20,20,21,0,89
1/31/2015,HOU,27,19,23,32,0,101,DET,32,27,27,28,0,114
2/3/2015,MIA,12,27,28,24,0,91,DET,33,20,32,23,0,108
2/4/2015,DET,26,23,27,33,0,109,IND,29,19,33,33,0,114
2/6/2015,DEN,21,21,20,26,0,88,DET,28,28,24,18,0,98
2/8/2015,MIN,32,29,20,31,0,112,DET,24,27,22,28,0,101
2/10/2015,DET,26,28,29,23,0,106,CHO,27,19,14,18,0,78
2/11/2015,SAS,20,28,34,22,0,104,DET,12,27,24,24,0,87
2/20/2015,CHI,23,30,15,23,0,91,DET,22,23,32,23,0,100
2/22/2015,WAS,22,30,19,18,0,89,DET,27,20,35,24,0,106
2/24/2015,CLE,30,23,24,25,0,102,DET,27,35,12,19,0,93
2/27/2015,NYK,23,18,25,29,10,121,DET,28,25,16,26,10,115
2/28/2015,DET,27,17,26,25,0,95,WAS,37,23,20,19,0,99
3/4/2015,DET,24,22,17,22,0,85,NOP,17,25,23,23,0,88
3/6/2015,DET,23,23,23,24,0,93,HOU,29,25,26,23,0,103
3/8/2015,CHO,27,27,24,30,0,108,DET,33,29,22,17,0,101
3/10/2015,DET,20,30,11,24,0,85,LAL,25,24,18,26,0,93
3/11/2015,DET,25,26,25,22,0,98,GSW,30,26,23,26,0,105
3/13/2015,DET,24,22,32,21,0,99,POR,35,29,31,23,0,118
3/14/2015,DET,18,25,12,30,0,85,UTA,18,31,13,26,0,88
3/17/2015,MEM,30,24,22,19,0,95,DET,18,21,36,30,0,105
3/18/2015,DET,21,18,26,18,0,83,PHI,24,25,19,26,0,94
3/21/2015,CHI,20,36,23,12,0,91,DET,30,14,36,27,0,107
3/22/2015,DET,26,15,22,25,17,105,BOS,23,24,22,19,9,97
3/24/2015,TOR,27,21,27,29,0,104,DET,37,23,25,23,0,108
3/27/2015,DET,30,24,33,24,0,111,ORL,27,26,23,21,0,97
3/29/2015,DET,27,17,21,37,0,102,MIA,25,24,22,38,0,109
3/31/2015,ATL,28,22,22,23,0,95,DET,33,19,24,29,0,105
4/1/2015,DET,25,20,17,16,0,78,CHO,33,23,17,29,0,102
4/3/2015,DET,26,9,24,23,0,82,CHI,25,22,12,29,0,88
4/4/2015,MIA,24,31,26,17,0,98,DET,29,21,22,27,0,99
4/8/2015,BOS,30,25,36,22,0,113,DET,16,31,27,29,0,103
4/10/2015,IND,23,28,28,28,0,107,DET,21,26,32,24,0,103
4/12/2015,CHO,10,24,20,23,0,77,DET,30,29,23,34,0,116
4/13/2015,DET,14,23,36,24,0,97,CLE,36,26,31,16,0,109
4/15/2015,DET,34,21,29,28,0,112,NYK,25,21,24,20,0,90
10/29/2014,ATL,22,30,19,31,0,102,TOR,24,36,26,23,0,109
11/1/2014,IND,18,26,19,29,0,92,ATL,27,24,19,32,0,102
11/5/2014,ATL,15,24,23,30,0,92,SAS,27,22,19,26,0,94
11/7/2014,ATL,29,21,28,19,13,119,CHO,22,25,23,27,13,122
11/8/2014,NYK,32,29,13,22,0,96,ATL,20,28,27,28,0,103
11/10/2014,ATL,17,21,26,27,0,91,NYK,16,22,21,26,0,85
11/12/2014,UTA,32,22,34,9,0,97,ATL,32,25,25,18,0,100
11/14/2014,MIA,23,29,27,24,0,103,ATL,35,27,24,28,0,114
11/15/2014,ATL,25,18,26,25,0,94,CLE,41,30,30,26,0,127
11/18/2014,LAL,31,36,24,23,0,114,ATL,20,32,31,26,0,109
11/21/2014,DET,25,15,24,25,0,89,ATL,29,21,24,25,0,99
11/25/2014,ATL,22,19,27,38,0,106,WAS,19,20,28,35,0,102
11/26/2014,TOR,34,30,27,35,0,126,ATL,24,37,27,27,0,115
11/28/2014,NOP,15,13,23,40,0,91,ATL,19,22,21,38,0,100
11/29/2014,CHO,17,11,23,24,0,75,ATL,28,36,20,21,0,105
12/2/2014,BOS,42,24,19,20,0,105,ATL,30,20,30,29,0,109
12/3/2014,ATL,27,28,33,24,0,112,MIA,18,29,25,30,0,102
12/5/2014,ATL,16,36,26,20,0,98,BRK,18,13,24,20,0,75
12/7/2014,DEN,21,15,30,18,0,84,ATL,32,25,20,19,0,96
12/8/2014,ATL,28,32,25,23,0,108,IND,18,25,21,28,0,92
12/10/2014,PHI,21,17,20,21,0,79,ATL,25,22,21,27,0,95
12/12/2014,ORL,26,14,24,17,0,81,ATL,29,11,24,23,0,87
12/13/2014,ATL,23,25,24,27,0,99,ORL,18,29,25,28,0,100
12/15/2014,CHI,22,22,20,22,0,86,ATL,28,22,23,20,0,93
12/17/2014,ATL,26,39,30,32,0,127,CLE,34,26,15,23,0,98
12/20/2014,ATL,32,20,22,30,0,104,HOU,26,14,34,23,0,97
12/22/2014,ATL,25,27,30,23,0,105,DAL,18,20,25,39,0,102
12/23/2014,LAC,25,32,26,21,0,104,ATL,31,19,31,26,0,107
12/26/2014,MIL,24,34,23,26,0,107,ATL,22,20,16,19,0,77
12/27/2014,ATL,21,18,27,24,0,90,MIL,10,27,26,22,0,85
12/30/2014,CLE,25,16,32,28,0,101,ATL,26,25,27,31,0,109
1/2/2015,ATL,31,26,25,16,0,98,UTA,21,24,23,24,0,92
1/3/2015,ATL,29,23,31,32,0,115,POR,20,29,26,32,0,107
1/5/2015,ATL,21,23,33,30,0,107,LAC,26,20,23,29,0,98
1/7/2015,MEM,19,25,15,27,0,86,ATL,23,26,21,26,0,96
1/9/2015,ATL,31,33,26,16,0,106,DET,22,23,30,28,0,103
1/11/2015,WAS,22,28,27,12,0,89,ATL,34,21,32,33,0,120
1/13/2015,ATL,25,24,25,31,0,105,PHI,20,17,18,32,0,87
1/14/2015,ATL,24,33,32,16,0,105,BOS,24,21,29,17,0,91
1/16/2015,ATL,24,28,33,25,0,110,TOR,19,19,30,21,0,89
1/17/2015,ATL,24,24,28,31,0,107,CHI,16,23,28,32,0,99
1/19/2015,DET,12,29,20,21,0,82,ATL,16,28,24,25,0,93
1/21/2015,IND,21,20,23,27,0,91,ATL,25,27,36,22,0,110
1/23/2015,OKC,30,17,28,18,0,93,ATL,23,25,31,24,0,103
1/25/2015,MIN,24,23,30,23,0,100,ATL,25,36,25,26,0,112
1/28/2015,BRK,27,26,28,21,0,102,ATL,30,34,25,24,0,113
1/30/2015,POR,29,22,23,25,0,99,ATL,27,23,19,36,0,105
1/31/2015,PHI,10,24,32,19,0,85,ATL,22,27,22,20,0,91
2/2/2015,ATL,22,20,32,26,0,100,NOP,32,23,33,27,0,115
2/4/2015,WAS,18,28,28,22,0,96,ATL,29,30,18,28,0,105
2/6/2015,GSW,25,27,33,31,0,116,ATL,21,31,37,35,0,124
2/8/2015,ATL,16,27,23,22,0,88,MEM,20,22,27,25,0,94
2/9/2015,ATL,32,25,29,31,0,117,MIN,30,23,19,33,0,105
2/11/2015,ATL,23,26,23,16,0,88,BOS,13,21,27,28,0,89
2/20/2015,TOR,26,23,28,28,0,105,ATL,26,19,13,22,0,80
2/22/2015,ATL,22,26,18,31,0,97,MIL,13,22,29,22,0,86
2/25/2015,DAL,34,19,15,19,0,87,ATL,22,25,30,27,0,104
2/27/2015,ORL,16,29,22,21,0,88,ATL,28,14,34,19,0,95
2/28/2015,ATL,17,26,21,29,0,93,MIA,12,21,20,38,0,91
3/3/2015,HOU,31,28,22,15,0,96,ATL,22,23,27,32,0,104
3/6/2015,CLE,19,24,36,18,0,97,ATL,36,17,28,25,0,106
3/7/2015,ATL,31,22,16,15,0,84,PHI,20,27,25,20,0,92
3/9/2015,SAC,20,34,28,23,0,105,ATL,33,43,29,25,0,130
3/11/2015,ATL,22,20,26,34,0,102,DEN,31,29,38,17,0,115
3/13/2015,ATL,28,20,17,31,0,96,PHO,23,27,23,14,0,87
3/15/2015,ATL,23,18,27,23,0,91,LAL,14,24,20,28,0,86
3/16/2015,ATL,28,26,28,28,0,110,SAC,29,18,29,27,0,103
3/18/2015,ATL,24,23,17,31,0,95,GSW,28,31,24,31,0,114
3/20/2015,ATL,35,33,27,20,0,115,OKC,34,27,29,33,0,123
3/22/2015,SAS,26,33,24,31,0,114,ATL,13,28,24,30,0,95
3/25/2015,ATL,23,24,21,27,0,95,ORL,31,21,19,12,0,83
3/27/2015,MIA,20,17,30,19,0,86,ATL,27,28,34,10,0,99
3/28/2015,ATL,23,29,24,24,0,100,CHO,27,30,33,25,0,115
3/30/2015,MIL,20,19,25,24,0,88,ATL,25,21,26,29,0,101
3/31/2015,ATL,28,22,22,23,0,95,DET,33,19,24,29,0,105
4/4/2015,BRK,22,26,23,28,0,99,ATL,31,35,42,23,0,131
4/7/2015,PHO,17,26,13,13,0,69,ATL,24,28,17,27,0,96
4/8/2015,ATL,33,32,29,20,0,114,BRK,26,30,26,29,0,111
4/10/2015,CHO,15,33,12,20,0,80,ATL,15,32,23,34,0,104
4/12/2015,ATL,22,23,30,24,0,99,WAS,38,28,24,18,0,108
4/13/2015,NYK,32,30,21,29,0,112,ATL,28,21,29,30,0,108
4/15/2015,ATL,22,27,23,13,0,85,CHI,17,25,28,21,0,91
10/29/2014,CHI,24,29,31,20,0,104,NYK,20,23,17,20,0,80
10/31/2014,CLE,28,30,20,20,16,114,CHI,27,25,17,29,10,108
11/1/2014,CHI,27,36,22,21,0,106,MIN,25,24,32,24,0,105
11/4/2014,ORL,28,24,17,21,0,90,CHI,24,30,15,29,0,98
11/5/2014,CHI,23,26,23,23,0,95,MIL,21,32,17,16,0,86
11/7/2014,CHI,33,24,35,26,0,118,PHI,28,29,19,39,0,115
11/8/2014,BOS,20,36,27,23,0,106,CHI,25,16,26,34,0,101
11/10/2014,DET,21,23,26,21,0,91,CHI,27,33,18,24,0,102
11/13/2014,CHI,25,20,35,20,0,100,TOR,24,28,14,27,0,93
11/15/2014,IND,23,23,23,30,0,99,CHI,20,22,23,25,0,90
11/17/2014,CHI,21,27,31,26,0,105,LAC,18,32,14,25,0,89
11/20/2014,CHI,29,18,21,20,0,88,SAC,22,30,28,23,0,103
11/21/2014,CHI,21,22,22,22,0,87,POR,32,29,28,16,0,105
11/24/2014,CHI,30,26,22,19,0,97,UTA,14,27,36,18,0,95
11/25/2014,CHI,21,28,27,33,0,109,DEN,31,25,30,28,0,114
11/28/2014,CHI,24,30,31,24,0,109,BOS,35,25,31,11,0,102
11/30/2014,CHI,25,22,29,26,0,102,BRK,22,20,21,21,0,84
12/2/2014,DAL,25,34,21,28,13,132,CHI,26,21,27,34,13,129
12/3/2014,CHI,26,19,27,30,0,102,CHO,24,16,31,24,0,95
12/6/2014,GSW,28,33,18,33,0,112,CHI,22,27,31,22,0,102
12/10/2014,BRK,25,26,17,12,0,80,CHI,20,31,26,28,0,105
12/12/2014,POR,28,23,27,28,0,106,CHI,24,35,23,33,0,115
12/14/2014,CHI,14,25,33,21,0,93,MIA,18,14,16,27,0,75
12/15/2014,CHI,22,22,20,22,0,86,ATL,28,22,23,20,0,93
12/18/2014,NYK,20,25,29,23,0,97,CHI,30,22,21,30,0,103
12/19/2014,CHI,20,31,22,30,0,103,MEM,22,21,23,31,0,97
12/22/2014,TOR,33,33,17,37,0,120,CHI,33,27,20,49,0,129
12/23/2014,CHI,21,25,24,29,0,99,WAS,20,20,25,26,0,91
12/25/2014,LAL,24,23,30,16,0,93,CHI,27,31,25,30,0,113
12/27/2014,NOP,25,20,26,29,0,100,CHI,23,26,31,27,0,107
12/29/2014,CHI,22,25,34,11,0,92,IND,17,18,30,25,0,90
12/30/2014,BRK,24,31,29,12,0,96,CHI,31,14,24,13,0,82
1/1/2015,DEN,23,30,21,27,0,101,CHI,22,20,35,29,0,106
1/3/2015,BOS,23,17,29,30,5,104,CHI,17,29,23,30,10,109
1/5/2015,HOU,33,29,27,16,0,105,CHI,34,28,21,31,0,114
1/7/2015,UTA,22,14,27,34,0,97,CHI,16,16,19,26,0,77
1/9/2015,CHI,13,29,26,18,0,86,WAS,30,30,20,22,0,102
1/10/2015,MIL,19,20,23,25,0,87,CHI,29,19,20,27,0,95
1/12/2015,ORL,29,34,30,28,0,121,CHI,21,34,23,36,0,114
1/14/2015,WAS,26,18,32,29,0,105,CHI,32,18,19,30,0,99
1/16/2015,CHI,22,33,33,31,0,119,BOS,24,34,28,17,0,103
1/17/2015,ATL,24,24,28,31,0,107,CHI,16,23,28,32,0,99
1/19/2015,CHI,19,20,23,32,0,94,CLE,24,30,30,24,0,108
1/22/2015,SAS,22,18,20,21,0,81,CHI,21,25,31,27,0,104
1/23/2015,CHI,30,24,26,22,0,102,DAL,21,30,24,23,0,98
1/25/2015,MIA,26,22,26,22,0,96,CHI,20,18,24,22,0,84
1/27/2015,CHI,29,22,28,28,6,113,GSW,35,21,25,26,4,111
1/29/2015,CHI,19,29,28,22,8,118,LAL,28,31,21,18,8,123
1/30/2015,CHI,23,19,25,26,0,93,PHO,26,29,13,31,0,99
2/4/2015,CHI,27,21,22,20,0,90,HOU,27,30,18,26,0,101
2/7/2015,CHI,18,30,33,26,0,107,NOP,20,19,17,16,0,72
2/8/2015,CHI,32,18,24,24,0,98,ORL,16,29,29,23,0,97
2/10/2015,SAC,26,23,15,22,0,86,CHI,30,27,27,20,0,104
2/12/2015,CLE,26,22,29,21,0,98,CHI,30,25,32,26,0,113
2/20/2015,CHI,23,30,15,23,0,91,DET,22,23,32,23,0,100
2/21/2015,PHO,28,28,27,24,0,107,CHI,33,19,29,31,0,112
2/23/2015,MIL,15,18,16,22,0,71,CHI,21,27,16,23,0,87
2/25/2015,CHO,20,24,23,31,0,98,CHI,20,24,21,21,0,86
2/27/2015,MIN,23,21,23,22,0,89,CHI,27,24,22,23,0,96
3/1/2015,LAC,26,17,26,27,0,96,CHI,18,23,28,17,0,86
3/3/2015,WAS,22,22,23,25,0,92,CHI,24,27,23,23,0,97
3/5/2015,OKC,30,20,29,26,0,105,CHI,18,30,24,36,0,108
3/6/2015,CHI,20,22,24,18,0,84,IND,23,22,21,32,0,98
3/8/2015,CHI,19,20,38,28,0,105,SAS,25,32,30,29,0,116
3/9/2015,MEM,22,19,32,28,0,101,CHI,22,17,26,26,0,91
3/11/2015,CHI,22,29,21,20,12,104,PHI,22,29,12,29,3,95
3/13/2015,CHI,35,25,10,21,0,91,CHO,19,33,25,24,0,101
3/15/2015,CHI,15,32,23,30,0,100,OKC,17,30,28,34,0,109
3/18/2015,IND,22,19,27,18,0,86,CHI,24,27,25,27,0,103
3/20/2015,TOR,24,24,20,24,0,92,CHI,32,28,26,22,0,108
3/21/2015,CHI,20,36,23,12,0,91,DET,30,14,36,27,0,107
3/23/2015,CHO,26,23,20,17,0,86,CHI,28,20,26,24,0,98
3/25/2015,CHI,20,30,27,39,0,116,TOR,29,25,28,21,0,103
3/28/2015,NYK,17,17,19,27,0,80,CHI,28,26,30,27,0,111
4/1/2015,CHI,25,23,26,17,0,91,MIL,20,28,22,25,0,95
4/3/2015,DET,26,9,24,23,0,82,CHI,25,22,12,29,0,88
4/5/2015,CHI,23,22,26,23,0,94,CLE,27,27,25,20,0,99
4/8/2015,CHI,29,30,28,16,0,103,ORL,21,31,27,26,0,105
4/9/2015,CHI,20,12,33,24,0,89,MIA,18,33,8,19,0,78
4/11/2015,PHI,26,27,25,29,0,107,CHI,28,24,29,33,0,114
4/13/2015,CHI,26,31,30,26,0,113,BRK,21,29,15,21,0,86
4/15/2015,ATL,22,27,23,13,0,85,CHI,17,25,28,21,0,91
10/29/2014,WAS,28,24,18,25,0,95,MIA,22,31,19,35,0,107
11/1/2014,MIA,32,28,27,27,0,114,PHI,30,24,29,13,0,96
11/2/2014,TOR,26,28,23,25,0,102,MIA,31,33,23,20,0,107
11/4/2014,HOU,30,27,26,25,0,108,MIA,31,24,22,14,0,91
11/5/2014,MIA,17,27,18,27,0,89,CHO,24,22,26,24,0,96
11/8/2014,MIN,13,28,28,23,0,92,MIA,29,24,27,22,0,102
11/9/2014,MIA,29,26,28,22,0,105,DAL,20,24,23,29,0,96
11/12/2014,IND,24,17,22,18,0,81,MIA,26,16,16,17,0,75
11/14/2014,MIA,23,29,27,24,0,103,ATL,35,27,24,28,0,114
11/16/2014,MIL,19,19,26,27,0,91,MIA,23,23,13,25,0,84
11/17/2014,MIA,19,19,32,25,0,95,BRK,21,22,21,19,0,83
11/20/2014,LAC,39,19,30,22,0,110,MIA,15,25,26,27,0,93
11/22/2014,MIA,22,27,19,31,0,99,ORL,18,28,21,25,0,92
11/23/2014,CHO,22,22,28,21,0,93,MIA,23,30,14,27,0,94
11/25/2014,GSW,30,31,30,23,0,114,MIA,36,26,24,11,0,97
11/30/2014,MIA,21,21,21,23,0,86,NYK,17,17,25,20,0,79
12/1/2014,MIA,22,27,17,20,0,86,WAS,30,34,17,26,0,107
12/3/2014,ATL,27,28,33,24,0,112,MIA,18,29,25,30,0,102
12/5/2014,MIA,30,20,21,14,0,85,MIL,25,29,26,29,0,109
12/7/2014,MIA,26,22,27,12,0,87,MEM,28,27,27,21,0,103
12/9/2014,MIA,28,18,27,30,0,103,PHO,25,26,21,25,0,97
12/10/2014,MIA,21,27,14,20,0,82,DEN,22,26,31,23,0,102
12/12/2014,MIA,29,33,16,22,0,100,UTA,24,23,27,21,0,95
12/14/2014,CHI,14,25,33,21,0,93,MIA,18,14,16,27,0,75
12/16/2014,MIA,33,22,21,19,0,95,BRK,25,20,21,25,0,91
12/17/2014,UTA,33,22,22,28,0,105,MIA,16,25,18,28,0,87
12/19/2014,WAS,29,25,22,29,0,105,MIA,25,30,24,24,0,103
12/21/2014,BOS,21,21,19,23,0,84,MIA,28,24,20,28,0,100
12/23/2014,PHI,19,23,31,18,0,91,MIA,32,25,21,9,0,87
12/25/2014,CLE,27,22,25,17,0,91,MIA,30,32,15,24,0,101
12/27/2014,MEM,27,30,15,31,0,103,MIA,16,25,28,26,0,95
12/29/2014,ORL,26,24,27,25,0,102,MIA,25,28,24,24,0,101
12/31/2014,MIA,24,27,19,25,0,95,IND,20,22,36,28,0,106
1/3/2015,MIA,27,22,11,19,0,79,HOU,23,38,33,21,0,115
1/4/2015,BRK,21,19,19,25,0,84,MIA,30,19,15,24,0,88
1/8/2015,MIA,23,25,16,19,0,83,POR,18,25,33,23,0,99
1/11/2015,MIA,30,32,24,18,0,104,LAC,29,24,23,14,0,90
1/13/2015,MIA,22,22,17,17,0,78,LAL,12,22,19,22,0,75
1/14/2015,MIA,18,20,25,26,0,89,GSW,26,29,26,23,0,104
1/16/2015,MIA,26,26,23,20,0,95,SAC,22,22,17,22,0,83
1/20/2015,OKC,24,25,23,22,0,94,MIA,27,23,17,19,0,86
1/21/2015,MIA,17,22,16,21,0,76,CHO,25,20,20,13,0,78
1/23/2015,IND,18,19,27,23,0,87,MIA,26,28,21,14,0,89
1/25/2015,MIA,26,22,26,22,0,96,CHI,20,18,24,22,0,84
1/27/2015,MIL,30,24,28,27,0,109,MIA,29,21,32,20,0,102
1/30/2015,DAL,13,20,27,33,0,93,MIA,15,30,15,12,0,72
2/1/2015,MIA,25,19,17,22,0,83,BOS,15,16,28,16,0,75
2/3/2015,MIA,12,27,28,24,0,91,DET,33,20,32,23,0,108
2/4/2015,MIA,24,27,32,18,0,101,MIN,27,26,23,26,0,102
2/6/2015,MIA,19,22,20,24,0,85,SAS,30,22,25,21,0,98
2/9/2015,NYK,32,24,18,21,0,95,MIA,23,29,25,32,0,109
2/11/2015,MIA,23,25,21,24,0,93,CLE,38,21,26,28,0,113
2/20/2015,MIA,25,33,29,24,0,111,NYK,26,22,20,19,0,87
2/21/2015,NOP,25,27,33,20,0,105,MIA,14,28,23,26,0,91
2/23/2015,PHI,31,29,19,29,0,108,MIA,32,29,30,28,0,119
2/25/2015,MIA,17,19,25,24,8,93,ORL,17,23,21,24,5,90
2/27/2015,MIA,25,29,28,20,0,102,NOP,24,30,19,31,0,104
2/28/2015,ATL,17,26,21,29,0,93,MIA,12,21,20,38,0,91
3/2/2015,PHO,24,24,26,24,0,98,MIA,23,39,23,30,0,115
3/4/2015,LAL,25,26,22,21,0,94,MIA,28,18,30,24,0,100
3/6/2015,MIA,18,21,34,24,0,97,WAS,40,27,21,11,0,99
3/7/2015,SAC,30,31,17,18,13,109,MIA,26,21,21,28,18,114
3/9/2015,BOS,24,19,30,27,0,100,MIA,19,21,24,26,0,90
3/11/2015,BRK,23,28,16,31,0,98,MIA,34,28,20,22,0,104
3/13/2015,MIA,18,23,22,29,0,92,TOR,21,29,28,24,0,102
3/16/2015,CLE,22,16,25,29,0,92,MIA,27,29,27,23,0,106
3/18/2015,POR,32,25,24,23,0,104,MIA,27,21,31,29,0,108
3/20/2015,DEN,23,23,32,13,0,91,MIA,22,37,28,21,0,108
3/22/2015,MIA,21,17,20,17,0,75,OKC,25,23,18,27,0,93
3/24/2015,MIA,27,24,28,9,0,88,MIL,22,27,16,24,0,89
3/25/2015,MIA,27,30,25,11,0,93,BOS,20,20,22,24,0,86
3/27/2015,MIA,20,17,30,19,0,86,ATL,27,28,34,10,0,99
3/29/2015,DET,27,17,21,37,0,102,MIA,25,24,22,38,0,109
3/31/2015,SAS,19,28,24,24,0,95,MIA,20,22,18,21,0,81
4/2/2015,MIA,27,23,22,16,0,88,CLE,34,27,30,23,0,114
4/4/2015,MIA,24,31,26,17,0,98,DET,29,21,22,27,0,99
4/5/2015,MIA,19,28,19,23,0,89,IND,22,29,26,35,0,112
4/7/2015,CHO,25,30,20,25,0,100,MIA,28,27,27,23,0,105
4/9/2015,CHI,20,12,33,24,0,89,MIA,18,33,8,19,0,78
4/11/2015,TOR,27,31,21,28,0,107,MIA,29,29,23,23,0,104
4/13/2015,ORL,22,17,27,27,0,93,MIA,33,24,27,16,0,100
4/15/2015,MIA,29,35,11,30,0,105,PHI,23,23,25,30,0,101
10/29/2014,MIN,27,20,27,27,0,101,MEM,25,28,28,24,0,105
10/31/2014,MEM,23,22,33,19,0,97,IND,19,34,14,22,0,89
11/1/2014,MEM,23,13,15,20,0,71,CHO,15,15,16,23,0,69
11/3/2014,NOP,13,20,23,25,0,81,MEM,20,20,24,29,0,93
11/5/2014,MEM,26,20,30,26,0,102,PHO,27,25,19,20,0,91
11/7/2014,MEM,22,27,17,25,0,91,OKC,19,21,22,27,0,89
11/8/2014,MEM,23,28,21,20,0,92,MIL,21,23,22,27,0,93
11/11/2014,LAL,21,31,23,27,0,102,MEM,25,31,27,24,0,107
11/13/2014,SAC,38,24,29,19,0,110,MEM,16,30,30,35,0,111
11/15/2014,DET,16,34,14,24,0,88,MEM,25,26,18,26,0,95
11/17/2014,HOU,18,24,24,27,0,93,MEM,34,31,32,22,0,119
11/19/2014,MEM,20,28,27,17,0,92,TOR,22,20,27,27,0,96
11/21/2014,BOS,16,25,29,30,0,100,MEM,25,30,27,35,0,117
11/23/2014,LAC,21,19,32,19,0,91,MEM,26,27,35,19,0,107
11/26/2014,MEM,21,25,34,19,0,99,LAL,26,25,23,19,0,93
11/28/2014,MEM,23,29,31,29,0,112,POR,25,18,27,29,0,99
11/30/2014,MEM,28,30,16,23,0,97,SAC,20,22,23,20,0,85
12/3/2014,MEM,28,18,22,28,0,96,HOU,34,24,36,11,0,105
12/5/2014,SAS,25,33,20,29,0,107,MEM,14,32,22,33,0,101
12/7/2014,MIA,26,22,27,12,0,87,MEM,28,27,27,21,0,103
12/9/2014,DAL,37,25,17,26,0,105,MEM,34,22,36,22,0,114
12/12/2014,CHO,21,24,27,20,10,107,MEM,26,21,22,23,10,113
12/13/2014,MEM,21,22,25,41,11,120,PHI,28,22,30,29,6,115
12/16/2014,GSW,30,19,20,29,0,98,MEM,24,33,23,25,0,105
12/17/2014,MEM,34,18,21,19,10,117,SAS,19,26,23,24,10,116
12/19/2014,CHI,20,31,22,30,0,103,MEM,22,21,23,31,0,97
12/21/2014,MEM,19,22,29,21,0,91,CLE,22,30,25,28,0,105
12/22/2014,UTA,19,25,26,27,0,97,MEM,22,21,25,23,0,91
12/26/2014,HOU,24,26,29,25,13,117,MEM,31,26,24,23,7,111
12/27/2014,MEM,27,30,15,31,0,103,MIA,16,25,28,26,0,95
12/30/2014,SAS,20,18,25,24,0,87,MEM,30,22,22,21,0,95
1/2/2015,MEM,22,25,33,29,0,109,LAL,25,27,25,29,0,106
1/3/2015,MEM,22,16,22,25,0,85,DEN,32,17,34,31,0,114
1/5/2015,NYK,14,22,26,21,0,83,MEM,21,26,37,21,0,105
1/7/2015,MEM,19,25,15,27,0,86,ATL,23,26,21,26,0,96
1/9/2015,MEM,19,20,32,24,0,95,NOP,31,21,30,24,0,106
1/11/2015,PHO,15,26,25,35,7,110,MEM,22,29,24,26,7,122
1/14/2015,MEM,32,19,31,21,0,103,BRK,23,22,20,27,0,92
1/16/2015,MEM,27,21,33,25,0,106,ORL,28,21,25,22,0,96
1/17/2015,POR,23,19,28,28,0,98,MEM,30,30,18,24,0,102
1/19/2015,DAL,25,28,29,21,0,103,MEM,16,30,29,20,0,95
1/21/2015,TOR,16,22,23,25,0,86,MEM,16,25,19,32,0,92
1/24/2015,PHI,21,20,20,22,0,83,MEM,27,33,21,20,0,101
1/26/2015,ORL,29,19,25,21,0,94,MEM,34,33,22,14,0,103
1/27/2015,MEM,24,30,32,23,0,109,DAL,24,20,28,18,0,90
1/29/2015,DEN,11,24,14,20,0,69,MEM,26,24,24,25,0,99
1/31/2015,OKC,20,20,22,12,0,74,MEM,25,20,23,17,0,85
2/2/2015,MEM,25,24,28,25,0,102,PHO,23,21,28,29,0,101
2/4/2015,MEM,30,28,19,23,0,100,UTA,23,28,20,19,0,90
2/6/2015,MEM,23,20,26,20,0,89,MIN,24,19,22,25,0,90
2/8/2015,ATL,16,27,23,22,0,88,MEM,20,22,27,25,0,94
2/10/2015,BRK,15,25,22,24,0,86,MEM,32,20,23,20,0,95
2/11/2015,MEM,26,22,21,20,0,89,OKC,35,31,19,20,0,105
2/22/2015,MEM,19,19,26,34,0,98,POR,21,17,39,15,0,92
2/23/2015,MEM,21,17,28,24,0,90,LAC,22,22,24,19,0,87
2/25/2015,MEM,25,27,25,13,0,90,SAC,32,30,14,26,0,102
2/27/2015,LAC,17,24,28,28,0,97,MEM,16,25,21,17,0,79
2/28/2015,MEM,18,30,24,29,0,101,MIN,24,22,24,27,0,97
3/3/2015,UTA,19,18,27,29,0,93,MEM,20,18,23,21,0,82
3/4/2015,MEM,24,30,25,23,0,102,HOU,31,28,20,21,0,100
3/6/2015,LAL,16,30,25,19,0,90,MEM,24,19,24,30,0,97
3/7/2015,MEM,25,25,17,22,0,89,NOP,18,20,33,24,0,95
3/9/2015,MEM,22,19,32,28,0,101,CHI,22,17,26,26,0,91
3/11/2015,MEM,18,21,24,29,0,92,BOS,23,16,25,31,0,95
3/12/2015,MEM,33,14,24,16,0,87,WAS,26,34,29,18,0,107
3/14/2015,MIL,20,22,19,22,0,83,MEM,22,27,29,18,0,96
3/16/2015,DEN,18,19,26,18,0,81,MEM,24,23,18,27,0,92
3/17/2015,MEM,30,24,22,19,0,95,DET,18,21,36,30,0,105
3/20/2015,MEM,25,19,39,29,0,112,DAL,18,19,31,33,0,101
3/21/2015,POR,27,17,18,24,0,86,MEM,35,18,24,20,0,97
3/23/2015,MEM,30,20,24,29,0,103,NYK,20,28,13,21,0,82
3/25/2015,CLE,22,33,36,20,0,111,MEM,19,23,24,23,0,89
3/27/2015,GSW,31,23,31,22,0,107,MEM,24,25,16,19,0,84
3/29/2015,MEM,21,21,24,23,0,89,SAS,28,23,19,33,0,103
3/30/2015,SAC,20,23,21,19,0,83,MEM,24,32,19,22,0,97
4/3/2015,OKC,26,23,20,23,0,92,MEM,24,31,22,23,0,100
4/4/2015,WAS,29,20,22,21,0,92,MEM,18,20,21,24,0,83
4/8/2015,NOP,24,12,19,19,0,74,MEM,27,28,26,29,0,110
4/10/2015,MEM,29,20,24,16,0,89,UTA,23,26,23,16,0,88
4/11/2015,MEM,21,28,19,18,0,86,LAC,26,26,17,25,0,94
4/13/2015,MEM,21,25,20,41,0,107,GSW,36,32,25,18,0,111
4/15/2015,IND,24,17,20,22,0,83,MEM,22,32,19,22,0,95
10/29/2014,GSW,25,22,26,22,0,95,SAC,23,26,14,14,0,77
11/1/2014,LAL,35,20,31,18,0,104,GSW,29,32,32,34,0,127
11/2/2014,GSW,30,21,17,27,0,95,POR,22,26,20,22,0,90
11/5/2014,LAC,20,22,33,29,0,104,GSW,30,35,37,19,0,121
11/8/2014,GSW,25,23,28,22,0,98,HOU,29,27,13,18,0,87
11/9/2014,GSW,30,28,21,16,0,95,PHO,28,19,24,36,0,107
11/11/2014,SAS,29,21,32,31,0,113,GSW,26,18,26,30,0,100
11/13/2014,BRK,36,19,20,24,0,99,GSW,32,34,21,20,0,107
11/15/2014,CHO,23,23,22,19,0,87,GSW,28,39,29,16,0,112
11/16/2014,GSW,34,40,41,21,0,136,LAL,23,32,24,36,0,115
11/21/2014,UTA,13,19,25,31,0,88,GSW,28,26,31,16,0,101
11/23/2014,GSW,28,24,18,21,0,91,OKC,20,27,19,20,0,86
11/25/2014,GSW,30,31,30,23,0,114,MIA,36,26,24,11,0,97
11/26/2014,GSW,31,34,27,19,0,111,ORL,27,25,13,31,0,96
11/28/2014,GSW,28,21,25,32,0,106,CHO,24,31,25,21,0,101
11/30/2014,GSW,21,32,29,22,0,104,DET,24,16,31,22,0,93
12/2/2014,ORL,25,21,29,22,0,97,GSW,24,32,17,25,0,98
12/4/2014,NOP,28,12,26,19,0,85,GSW,22,31,27,32,0,112
12/6/2014,GSW,28,33,18,33,0,112,CHI,22,27,31,22,0,102
12/8/2014,GSW,25,23,31,23,0,102,MIN,20,19,24,23,0,86
12/10/2014,HOU,30,16,30,17,0,93,GSW,23,23,27,32,0,105
12/13/2014,GSW,39,27,21,18,0,105,DAL,18,26,24,30,0,98
12/14/2014,GSW,28,32,29,22,17,128,NOP,31,20,38,22,11,122
12/16/2014,GSW,30,19,20,29,0,98,MEM,24,33,23,25,0,105
12/18/2014,OKC,40,23,26,20,0,109,GSW,32,33,29,20,0,114
12/22/2014,SAC,20,30,26,32,0,108,GSW,36,28,29,35,0,128
12/23/2014,GSW,24,24,25,32,0,105,LAL,34,29,32,20,0,115
12/25/2014,GSW,20,22,28,16,0,86,LAC,18,23,32,27,0,100
12/27/2014,MIN,23,25,19,30,0,97,GSW,31,27,30,22,0,110
12/30/2014,PHI,17,17,29,23,0,86,GSW,32,29,35,30,0,126
1/2/2015,TOR,31,30,23,21,0,105,GSW,40,26,31,29,0,126
1/5/2015,OKC,25,20,20,26,0,91,GSW,34,31,19,33,0,117
1/7/2015,IND,28,22,26,26,0,102,GSW,23,27,34,33,0,117
1/9/2015,CLE,32,22,22,18,0,94,GSW,30,30,24,28,0,112
1/13/2015,GSW,25,28,44,19,0,116,UTA,26,27,27,25,0,105
1/14/2015,MIA,18,20,25,26,0,89,GSW,26,29,26,23,0,104
1/16/2015,GSW,35,25,31,24,0,115,OKC,33,36,29,29,0,127
1/17/2015,GSW,31,33,38,29,0,131,HOU,31,28,21,26,0,106
1/19/2015,DEN,15,13,32,19,0,79,GSW,25,30,34,33,0,122
1/21/2015,HOU,29,13,36,35,0,113,GSW,32,30,40,24,0,126
1/23/2015,SAC,25,26,22,28,0,101,GSW,34,22,41,29,0,126
1/25/2015,BOS,23,26,28,34,0,111,GSW,30,26,33,25,0,114
1/27/2015,CHI,29,22,28,28,6,113,GSW,35,21,25,26,4,111
1/30/2015,GSW,19,26,23,32,0,100,UTA,23,33,25,29,0,110
1/31/2015,PHO,28,23,19,17,0,87,GSW,23,29,26,28,0,106
2/3/2015,GSW,29,34,31,27,0,121,SAC,22,20,38,16,0,96
2/4/2015,DAL,42,20,36,16,0,114,GSW,25,33,43,27,0,128
2/6/2015,GSW,25,27,33,31,0,116,ATL,21,31,37,35,0,124
2/7/2015,GSW,32,32,27,15,0,106,NYK,19,29,26,18,0,92
2/9/2015,GSW,20,26,21,22,0,89,PHI,24,20,17,23,0,84
2/11/2015,GSW,28,28,17,21,0,94,MIN,25,21,21,24,0,91
2/20/2015,SAS,29,26,13,31,0,99,GSW,27,35,27,21,0,110
2/22/2015,GSW,38,19,21,20,0,98,IND,26,32,23,23,0,104
2/24/2015,GSW,30,24,32,28,0,114,WAS,28,23,32,24,0,107
2/26/2015,GSW,33,23,22,21,0,99,CLE,32,29,29,20,0,110
2/27/2015,GSW,27,27,44,15,0,113,TOR,11,20,26,32,0,89
3/1/2015,GSW,25,24,26,31,0,106,BOS,38,27,21,15,0,101
3/2/2015,GSW,23,28,29,28,0,108,BRK,33,24,29,24,0,110
3/4/2015,MIL,19,34,18,22,0,93,GSW,25,28,19,30,0,102
3/6/2015,DAL,24,16,24,25,0,89,GSW,29,23,30,22,0,104
3/8/2015,LAC,28,22,18,30,0,98,GSW,29,28,30,19,0,106
3/9/2015,GSW,25,21,30,22,0,98,PHO,19,27,15,19,0,80
3/11/2015,DET,25,26,25,22,0,98,GSW,30,26,23,26,0,105
3/13/2015,GSW,26,28,29,20,0,103,DEN,34,28,20,32,0,114
3/14/2015,NYK,27,25,21,21,0,94,GSW,26,47,38,14,0,125
3/16/2015,LAL,30,24,24,27,0,105,GSW,30,28,24,26,0,108
3/18/2015,ATL,24,23,17,31,0,95,GSW,28,31,24,31,0,114
3/20/2015,NOP,26,16,26,28,0,96,GSW,30,23,33,26,0,112
3/21/2015,UTA,15,25,33,18,0,91,GSW,19,30,36,21,0,106
3/23/2015,WAS,24,25,8,19,0,76,GSW,27,25,29,26,0,107
3/24/2015,GSW,26,31,36,29,0,122,POR,30,32,18,28,0,108
3/27/2015,GSW,31,23,31,22,0,107,MEM,24,25,16,19,0,84
3/28/2015,GSW,24,24,34,26,0,108,MIL,23,15,25,32,0,95
3/31/2015,GSW,18,28,36,28,0,110,LAC,30,23,35,18,0,106
4/2/2015,PHO,22,22,27,35,0,106,GSW,27,28,22,30,0,107
4/4/2015,GSW,26,33,31,33,0,123,DAL,24,24,28,34,0,110
4/5/2015,GSW,17,21,29,25,0,92,SAS,31,26,32,18,0,107
4/7/2015,GSW,27,28,23,22,0,100,NOP,19,24,36,24,0,103
4/9/2015,POR,27,27,30,21,0,105,GSW,30,27,27,32,0,116
4/11/2015,MIN,31,24,14,32,0,101,GSW,28,32,26,24,0,110
4/13/2015,MEM,21,25,20,41,0,107,GSW,36,32,25,18,0,111
4/15/2015,DEN,23,44,33,26,0,126,GSW,35,36,29,33,0,133
10/29/2014,DET,21,19,23,16,0,79,DEN,23,19,23,24,0,89
11/1/2014,DEN,17,16,23,35,0,91,OKC,29,26,21,26,0,102
11/3/2014,SAC,19,32,28,31,0,110,DEN,22,24,31,28,0,105
11/5/2014,DEN,19,35,18,37,0,109,SAC,40,28,37,26,0,131
11/7/2014,CLE,38,20,27,25,0,110,DEN,20,25,26,30,0,101
11/9/2014,DEN,27,29,17,27,0,100,POR,36,28,21,31,0,116
11/12/2014,POR,39,45,27,19,0,130,DEN,28,22,28,35,0,113
11/14/2014,DEN,30,34,28,16,0,108,IND,27,19,21,20,0,87
11/16/2014,DEN,31,8,35,19,0,93,NYK,31,31,24,23,0,109
11/17/2014,DEN,24,29,28,25,0,106,CLE,26,26,23,22,0,97
11/19/2014,OKC,26,23,25,26,0,100,DEN,27,27,34,19,0,107
11/21/2014,NOP,26,23,24,24,0,97,DEN,31,28,27,31,0,117
11/23/2014,DEN,21,20,31,14,15,101,LAL,19,20,36,11,8,94
11/25/2014,CHI,21,28,27,33,0,109,DEN,31,25,30,28,0,114
11/26/2014,DEN,30,34,22,26,0,112,PHO,34,30,29,27,0,120
11/28/2014,PHO,22,25,23,27,0,97,DEN,33,33,33,23,0,122
12/1/2014,DEN,26,36,21,20,0,103,UTA,23,20,34,24,0,101
12/2/2014,POR,23,27,28,27,0,105,DEN,31,25,29,18,0,103
12/5/2014,DEN,28,18,23,20,0,89,WAS,30,35,25,29,0,119
12/7/2014,DEN,21,15,30,18,0,84,ATL,32,25,20,19,0,96
12/8/2014,DEN,30,22,29,21,5,107,TOR,35,27,20,20,10,112
12/10/2014,MIA,21,27,14,20,0,82,DEN,22,26,31,23,0,102
12/13/2014,DEN,31,17,25,23,0,96,HOU,21,33,26,28,0,108
12/14/2014,SAS,20,25,26,28,0,99,DEN,22,12,27,30,0,91
12/17/2014,HOU,25,30,20,24,16,115,DEN,29,31,18,21,12,111
12/19/2014,LAC,20,23,31,32,0,106,DEN,29,30,12,38,0,109
12/20/2014,IND,21,12,22,18,0,73,DEN,15,17,23,21,0,76
12/22/2014,DEN,18,22,17,25,0,82,CHO,28,30,26,26,0,110
12/23/2014,DEN,27,27,23,19,0,96,BRK,30,28,18,26,0,102
12/26/2014,MIN,27,20,27,28,0,102,DEN,26,27,26,27,0,106
12/28/2014,TOR,27,33,28,28,0,116,DEN,24,30,33,15,0,102
12/30/2014,LAL,33,29,21,28,0,111,DEN,29,17,25,32,0,103
1/1/2015,DEN,23,30,21,27,0,101,CHI,22,20,35,29,0,106
1/3/2015,MEM,22,16,22,25,0,85,DEN,32,17,34,31,0,114
1/5/2015,DEN,35,27,25,23,0,110,MIN,21,20,28,32,0,101
1/7/2015,ORL,18,21,19,32,0,90,DEN,25,15,23,30,0,93
1/9/2015,DEN,30,24,36,28,0,118,SAC,27,33,15,33,0,108
1/14/2015,DAL,24,26,28,29,0,107,DEN,28,31,31,24,0,114
1/16/2015,DEN,24,18,23,24,0,89,DAL,29,20,24,24,0,97
1/17/2015,MIN,37,19,29,28,0,113,DEN,25,34,24,22,0,105
1/19/2015,DEN,15,13,32,19,0,79,GSW,25,30,34,33,0,122
1/20/2015,SAS,20,31,29,29,0,109,DEN,20,28,28,23,0,99
1/23/2015,BOS,20,22,33,25,0,100,DEN,28,20,26,25,0,99
1/25/2015,WAS,28,31,24,22,12,117,DEN,26,33,25,21,10,115
1/26/2015,DEN,31,16,30,21,0,98,LAC,20,30,19,33,0,102
1/28/2015,DEN,28,21,21,23,0,93,NOP,17,22,31,15,0,85
1/29/2015,DEN,11,24,14,20,0,69,MEM,26,24,24,25,0,99
1/31/2015,CHO,30,32,18,24,0,104,DEN,15,15,22,34,0,86
2/3/2015,DEN,28,12,28,30,0,98,PHI,34,27,24,20,0,105
2/4/2015,DEN,29,22,27,22,0,100,BOS,26,35,22,21,0,104
2/6/2015,DEN,21,21,20,26,0,88,DET,28,28,24,18,0,98
2/9/2015,OKC,38,35,33,18,0,124,DEN,18,41,33,22,0,114
2/10/2015,DEN,24,21,26,35,0,106,LAL,29,19,23,25,0,96
2/20/2015,DEN,21,23,21,16,0,81,MIL,19,23,28,19,0,89
2/22/2015,DEN,18,24,27,25,0,94,OKC,36,31,31,21,0,119
2/23/2015,BRK,26,28,31,25,0,110,DEN,23,22,24,13,0,82
2/25/2015,PHO,35,23,25,27,0,110,DEN,26,25,22,23,0,96
2/27/2015,UTA,28,22,30,24,0,104,DEN,17,17,19,29,0,82
3/1/2015,NOP,21,16,28,34,0,99,DEN,16,21,28,27,0,92
3/3/2015,MIL,29,22,19,25,0,95,DEN,29,26,21,30,0,106
3/4/2015,DEN,26,34,17,23,0,100,MIN,27,16,22,20,0,85
3/6/2015,DEN,29,31,23,28,0,111,SAS,32,33,25,30,0,120
3/7/2015,HOU,25,30,33,26,0,114,DEN,28,20,25,27,0,100
3/9/2015,NYK,25,15,19,19,0,78,DEN,25,30,36,15,0,106
3/11/2015,ATL,22,20,26,34,0,102,DEN,31,29,38,17,0,115
3/13/2015,GSW,26,28,29,20,0,103,DEN,34,28,20,32,0,114
3/15/2015,DEN,21,29,21,30,8,118,NOP,26,21,30,24,8,111
3/16/2015,DEN,18,19,26,18,0,81,MEM,24,23,18,27,0,92
3/19/2015,DEN,27,22,24,35,0,108,HOU,33,32,25,28,0,118
3/20/2015,DEN,23,23,32,13,0,91,MIA,22,37,28,21,0,108
3/22/2015,DEN,28,41,33,17,0,119,ORL,25,26,21,28,0,100
3/25/2015,PHI,22,27,23,27,0,99,DEN,21,25,30,9,0,85
3/27/2015,UTA,20,19,24,28,0,91,DEN,22,30,23,32,0,107
3/28/2015,DEN,25,28,25,36,0,114,POR,31,27,28,34,0,120
4/1/2015,DEN,29,13,17,25,0,84,UTA,22,32,27,17,0,98
4/3/2015,DEN,25,22,23,23,0,93,SAS,45,22,33,23,0,123
4/4/2015,LAC,29,26,27,25,0,107,DEN,15,24,31,22,0,92
4/8/2015,LAL,33,21,17,30,0,101,DEN,35,23,35,26,0,119
4/10/2015,DAL,35,38,20,28,13,144,DEN,27,25,37,32,13,143
4/12/2015,SAC,28,31,25,27,0,111,DEN,37,23,34,28,0,122
4/13/2015,DEN,31,26,21,25,0,103,LAC,31,23,29,27,0,110
4/15/2015,DEN,23,44,33,26,0,126,GSW,35,36,29,33,0,133
10/29/2014,BRK,23,18,31,33,0,105,BOS,32,35,34,20,0,121
11/1/2014,BRK,33,26,22,21,0,102,DET,25,22,28,15,0,90
11/3/2014,OKC,19,21,22,23,0,85,BRK,32,27,26,31,0,116
11/5/2014,MIN,24,23,25,26,0,98,BRK,21,27,18,25,0,91
11/7/2014,NYK,20,22,26,31,0,99,BRK,30,25,31,24,0,110
11/9/2014,ORL,23,29,25,19,0,96,BRK,24,26,31,23,0,104
11/12/2014,BRK,29,34,21,20,0,104,PHO,17,32,29,34,0,112
11/13/2014,BRK,36,19,20,24,0,99,GSW,32,34,21,20,0,107
11/15/2014,BRK,15,24,27,21,0,87,POR,24,26,30,17,0,97
11/17/2014,MIA,19,19,32,25,0,95,BRK,21,22,21,19,0,83
11/19/2014,MIL,22,19,28,26,10,122,BRK,24,25,23,23,10,118
11/21/2014,BRK,21,28,22,23,0,94,OKC,27,26,21,18,0,92
11/22/2014,BRK,18,18,28,23,0,87,SAS,25,26,28,20,0,99
11/26/2014,BRK,32,17,23,27,0,99,PHI,19,22,26,24,0,91
11/30/2014,CHI,25,22,29,26,0,102,BRK,22,20,21,21,0,84
12/2/2014,BRK,27,22,28,21,0,98,NYK,18,27,19,29,0,93
12/3/2014,SAS,19,23,16,30,5,93,BRK,19,21,28,20,7,95
12/5/2014,ATL,16,36,26,20,0,98,BRK,18,13,24,20,0,75
12/8/2014,CLE,22,28,35,25,0,110,BRK,25,24,18,21,0,88
12/10/2014,BRK,25,26,17,12,0,80,CHI,20,31,26,28,0,105
12/12/2014,PHI,18,27,15,10,0,70,BRK,22,22,19,25,0,88
12/13/2014,BRK,32,20,33,29,0,114,CHO,17,25,17,28,0,87
12/16/2014,MIA,33,22,21,19,0,95,BRK,25,20,21,25,0,91
12/17/2014,BRK,30,22,21,16,0,89,TOR,22,31,23,29,0,105
12/19/2014,BRK,33,16,22,20,0,91,CLE,26,28,20,21,0,95
12/21/2014,DET,18,33,27,27,0,105,BRK,28,25,30,27,0,110
12/23/2014,DEN,27,27,23,19,0,96,BRK,30,28,18,26,0,102
12/26/2014,BRK,28,28,23,30,0,109,BOS,29,27,30,21,0,107
12/27/2014,IND,22,28,29,31,0,110,BRK,23,24,18,20,0,85
12/29/2014,SAC,28,16,25,30,0,99,BRK,27,30,25,25,0,107
12/30/2014,BRK,24,31,29,12,0,96,CHI,31,14,24,13,0,82
1/2/2015,BRK,22,30,34,14,0,100,ORL,25,15,21,37,0,98
1/4/2015,BRK,21,19,19,25,0,84,MIA,30,19,15,24,0,88
1/5/2015,DAL,21,22,22,17,14,96,BRK,35,14,16,17,6,88
1/7/2015,BOS,19,21,29,20,0,89,BRK,25,14,23,19,0,81
1/9/2015,PHI,23,22,19,26,0,90,BRK,32,14,25,17,0,88
1/10/2015,BRK,21,26,22,24,0,93,DET,22,25,27,24,0,98
1/12/2015,HOU,37,23,26,27,0,113,BRK,28,24,18,29,0,99
1/14/2015,MEM,32,19,31,21,0,103,BRK,23,22,20,27,0,92
1/16/2015,BRK,18,25,28,31,0,102,WAS,24,16,18,22,0,80
1/17/2015,WAS,23,27,27,22,0,99,BRK,26,25,19,20,0,90
1/21/2015,BRK,36,26,20,21,0,103,SAC,24,22,23,31,0,100
1/22/2015,BRK,23,14,19,28,0,84,LAC,34,36,27,26,0,123
1/24/2015,BRK,21,16,22,14,0,73,UTA,25,33,23,27,0,108
1/28/2015,BRK,27,26,28,21,0,102,ATL,30,34,25,24,0,113
1/30/2015,TOR,29,37,25,22,14,127,BRK,23,31,28,31,9,122
2/2/2015,LAC,22,14,36,28,0,100,BRK,22,16,32,32,0,102
2/4/2015,BRK,22,27,27,33,0,109,TOR,28,23,21,21,0,93
2/6/2015,NYK,21,24,25,18,0,88,BRK,29,24,15,24,0,92
2/7/2015,BRK,19,19,23,16,0,77,WAS,28,30,31,25,0,114
2/9/2015,BRK,30,22,16,29,0,97,MIL,24,23,32,24,0,103
2/10/2015,BRK,15,25,22,24,0,86,MEM,32,20,23,20,0,95
2/20/2015,BRK,34,22,40,18,0,114,LAL,32,25,20,28,0,105
2/23/2015,BRK,26,28,31,25,0,110,DEN,23,22,24,13,0,82
2/25/2015,BRK,21,29,23,23,0,96,NOP,27,26,23,26,0,102
2/27/2015,BRK,36,21,16,25,0,98,HOU,25,28,21,28,0,102
2/28/2015,BRK,23,24,35,22,0,104,DAL,26,25,21,22,0,94
3/2/2015,GSW,23,28,29,28,0,108,BRK,33,24,29,24,0,110
3/4/2015,CHO,35,21,32,27,0,115,BRK,15,29,22,25,0,91
3/6/2015,PHO,21,29,19,23,16,108,BRK,21,25,34,12,8,100
3/8/2015,UTA,21,21,24,29,0,95,BRK,24,19,20,25,0,88
3/10/2015,NOP,23,32,23,33,0,111,BRK,27,19,15,30,0,91
3/11/2015,BRK,23,28,16,31,0,98,MIA,34,28,20,22,0,104
3/14/2015,BRK,27,24,23,20,0,94,PHI,29,27,10,21,0,87
3/16/2015,BRK,33,34,31,24,0,122,MIN,29,26,24,27,0,106
3/18/2015,BRK,26,21,26,19,0,92,CLE,23,36,35,23,0,117
3/20/2015,MIL,30,38,16,17,10,127,BRK,31,27,21,22,10,129
3/21/2015,BRK,31,32,25,35,0,123,IND,29,27,31,24,0,111
3/23/2015,BOS,23,31,29,27,0,110,BRK,28,21,25,17,0,91
3/25/2015,BRK,23,19,26,23,0,91,CHO,26,20,18,24,0,88
3/27/2015,CLE,27,29,23,19,0,98,BRK,29,28,22,27,0,106
3/29/2015,LAL,19,31,24,25,0,99,BRK,30,31,24,22,0,107
3/31/2015,IND,15,39,25,27,0,106,BRK,33,24,27,27,0,111
4/1/2015,BRK,30,28,27,15,0,100,NYK,21,32,18,27,0,98
4/3/2015,TOR,27,27,25,30,0,109,BRK,34,15,28,37,0,114
4/4/2015,BRK,22,26,23,28,0,99,ATL,31,35,42,23,0,131
4/6/2015,POR,25,13,26,32,0,96,BRK,22,32,23,29,0,106
4/8/2015,ATL,33,32,29,20,0,114,BRK,26,30,26,29,0,111
4/10/2015,WAS,14,24,24,18,0,80,BRK,31,23,21,42,0,117
4/12/2015,BRK,24,17,18,14,0,73,MIL,26,17,30,23,0,96
4/13/2015,CHI,26,31,30,26,0,113,BRK,21,29,15,21,0,86
4/15/2015,ORL,28,24,23,13,0,88,BRK,23,25,27,26,0,101
10/30/2014,OKC,28,13,21,28,0,90,LAC,22,24,24,23,0,93
10/31/2014,LAC,31,31,24,32,0,118,LAL,22,34,34,21,0,111
11/2/2014,SAC,25,20,25,28,0,98,LAC,19,32,23,18,0,92
11/3/2014,UTA,20,23,27,31,0,101,LAC,26,30,17,34,0,107
11/5/2014,LAC,20,22,33,29,0,104,GSW,30,35,37,19,0,121
11/8/2014,POR,38,24,17,23,0,102,LAC,33,20,26,27,0,106
11/10/2014,SAS,14,25,25,25,0,89,LAC,20,22,28,15,0,85
11/15/2014,PHO,23,31,20,33,0,107,LAC,27,27,42,24,0,120
11/17/2014,CHI,21,27,31,26,0,105,LAC,18,32,14,25,0,89
11/19/2014,LAC,26,30,28,30,0,114,ORL,23,25,20,22,0,90
11/20/2014,LAC,39,19,30,22,0,110,MIA,15,25,26,27,0,93
11/23/2014,LAC,21,19,32,19,0,91,MEM,26,27,35,19,0,107
11/24/2014,LAC,31,25,22,35,0,113,CHO,23,30,17,22,0,92
11/26/2014,LAC,25,23,24,32,0,104,DET,27,24,22,25,0,98
11/28/2014,LAC,26,30,29,17,0,102,HOU,24,20,28,13,0,85
11/29/2014,LAC,35,27,28,22,0,112,UTA,18,32,26,20,0,96
12/1/2014,MIN,34,16,18,33,0,101,LAC,31,34,36,26,0,127
12/3/2014,ORL,23,21,18,24,0,86,LAC,31,26,27,30,0,114
12/6/2014,NOP,18,36,24,22,0,100,LAC,34,20,39,27,0,120
12/8/2014,PHO,28,29,23,32,8,120,LAC,28,32,29,23,9,121
12/10/2014,LAC,33,21,28,21,0,103,IND,25,24,16,31,0,96
12/12/2014,LAC,21,21,25,29,0,96,WAS,30,27,23,24,0,104
12/13/2014,LAC,28,14,29,35,0,106,MIL,26,25,21,39,0,111
12/15/2014,DET,27,17,19,28,0,91,LAC,29,26,31,27,0,113
12/17/2014,IND,27,24,21,28,0,100,LAC,30,22,26,24,0,102
12/19/2014,LAC,20,23,31,32,0,106,DEN,29,30,12,38,0,109
12/20/2014,MIL,24,28,31,19,0,102,LAC,28,22,32,24,0,106
12/22/2014,LAC,33,27,30,28,0,118,SAS,35,37,23,30,0,125
12/23/2014,LAC,25,32,26,21,0,104,ATL,31,19,31,26,0,107
12/25/2014,GSW,20,22,28,16,0,86,LAC,18,23,32,27,0,100
12/27/2014,TOR,22,27,31,30,0,110,LAC,26,23,29,20,0,98
12/29/2014,UTA,18,26,33,20,0,97,LAC,25,23,29,24,0,101
12/31/2014,NYK,21,19,18,20,0,78,LAC,29,21,24,25,0,99
1/3/2015,PHI,21,32,21,17,0,91,LAC,34,28,26,39,0,127
1/5/2015,ATL,21,23,33,30,0,107,LAC,26,20,23,29,0,98
1/7/2015,LAL,24,24,15,26,0,89,LAC,34,36,29,15,0,114
1/10/2015,DAL,24,24,24,28,0,100,LAC,30,26,32,32,0,120
1/11/2015,MIA,30,32,24,18,0,104,LAC,29,24,23,14,0,90
1/14/2015,LAC,27,23,22,28,0,100,POR,21,28,23,22,0,94
1/16/2015,CLE,28,33,31,34,0,126,LAC,33,31,31,26,0,121
1/17/2015,LAC,28,24,31,34,0,117,SAC,28,24,26,30,0,108
1/19/2015,BOS,17,20,25,31,0,93,LAC,23,24,27,28,0,102
1/22/2015,BRK,23,14,19,28,0,84,LAC,34,36,27,26,0,123
1/25/2015,LAC,23,32,34,31,0,120,PHO,16,41,20,23,0,100
1/26/2015,DEN,31,16,30,21,0,98,LAC,20,30,19,33,0,102
1/28/2015,LAC,24,25,19,26,0,94,UTA,26,24,22,17,0,89
1/30/2015,LAC,26,28,22,27,0,103,NOP,28,25,35,20,0,108
1/31/2015,LAC,29,27,28,21,0,105,SAS,25,17,27,16,0,85
2/2/2015,LAC,22,14,36,28,0,100,BRK,22,16,32,32,0,102
2/5/2015,LAC,20,22,21,31,0,94,CLE,30,35,29,11,0,105
2/6/2015,LAC,34,25,20,28,0,107,TOR,19,38,38,28,0,123
2/8/2015,LAC,26,30,19,33,0,108,OKC,28,38,35,30,0,131
2/9/2015,LAC,32,34,28,21,0,115,DAL,31,22,27,18,0,98
2/11/2015,HOU,26,30,23,16,0,95,LAC,26,28,26,30,0,110
2/19/2015,SAS,24,31,33,27,0,115,LAC,27,25,38,29,0,119
2/21/2015,SAC,29,18,18,34,0,99,LAC,24,42,31,29,0,126
2/23/2015,MEM,21,17,28,24,0,90,LAC,22,22,24,19,0,87
2/25/2015,LAC,26,34,25,20,0,105,HOU,27,35,22,26,0,110
2/27/2015,LAC,17,24,28,28,0,97,MEM,16,25,21,17,0,79
3/1/2015,LAC,26,17,26,27,0,96,CHI,18,23,28,17,0,86
3/2/2015,LAC,36,22,28,24,0,110,MIN,23,37,27,18,0,105
3/4/2015,POR,28,18,20,21,11,98,LAC,24,24,20,19,6,93
3/8/2015,LAC,28,22,18,30,0,98,GSW,29,28,30,19,0,106
3/9/2015,MIN,25,14,23,14,0,76,LAC,25,23,26,15,0,89
3/11/2015,LAC,36,29,35,20,0,120,OKC,30,27,28,23,0,108
3/13/2015,LAC,24,27,27,21,0,99,DAL,21,38,32,38,0,129
3/15/2015,HOU,22,36,26,16,0,100,LAC,30,20,24,24,0,98
3/17/2015,CHO,20,21,33,18,0,92,LAC,28,31,18,22,0,99
3/18/2015,LAC,28,23,29,36,0,116,SAC,24,25,24,32,0,105
3/20/2015,WAS,21,33,23,22,0,99,LAC,35,31,24,23,0,113
3/22/2015,NOP,28,25,24,23,0,100,LAC,27,23,31,26,0,107
3/25/2015,LAC,28,35,27,21,0,111,NYK,17,16,21,26,0,80
3/27/2015,LAC,34,28,32,25,0,119,PHI,19,35,14,30,0,98
3/29/2015,LAC,34,34,37,14,0,119,BOS,20,27,32,27,0,106
3/31/2015,GSW,18,28,36,28,0,110,LAC,30,23,35,18,0,106
4/1/2015,LAC,26,29,30,41,0,126,POR,33,35,24,30,0,122
4/4/2015,LAC,29,26,27,25,0,107,DEN,15,24,31,22,0,92
4/5/2015,LAC,23,26,34,23,0,106,LAL,16,20,18,24,0,78
4/7/2015,LAL,21,18,30,31,0,100,LAC,23,27,26,29,0,105
4/11/2015,MEM,21,28,19,18,0,86,LAC,26,26,17,25,0,94
4/13/2015,DEN,31,26,21,25,0,103,LAC,31,23,29,27,0,110
4/14/2015,LAC,32,37,22,21,0,112,PHO,26,17,27,31,0,101
10/29/2014,OKC,34,20,23,12,0,89,POR,29,20,26,31,0,106
10/31/2014,POR,24,24,23,23,0,94,SAC,26,22,23,32,0,103
11/2/2014,GSW,30,21,17,27,0,95,POR,22,26,20,22,0,90
11/4/2014,CLE,34,16,19,13,0,82,POR,31,24,21,25,0,101
11/6/2014,DAL,24,26,18,19,0,87,POR,20,26,35,27,0,108
11/8/2014,POR,38,24,17,23,0,102,LAC,33,20,26,27,0,106
11/9/2014,DEN,27,29,17,27,0,100,POR,36,28,21,31,0,116
11/11/2014,CHO,35,29,21,15,0,100,POR,21,30,24,27,0,102
11/12/2014,POR,39,45,27,19,0,130,DEN,28,22,28,35,0,113
11/15/2014,BRK,15,24,27,21,0,87,POR,24,26,30,17,0,97
11/17/2014,NOP,21,28,31,13,0,93,POR,22,20,26,34,0,102
11/21/2014,CHI,21,22,22,22,0,87,POR,32,29,28,16,0,105
11/23/2014,POR,21,23,28,22,0,94,BOS,23,26,23,16,0,88
11/24/2014,POR,24,26,39,25,0,114,PHI,20,32,28,24,0,104
11/26/2014,POR,28,17,34,26,0,105,CHO,26,30,20,21,0,97
11/28/2014,MEM,23,29,31,29,0,112,POR,25,18,27,29,0,99
11/30/2014,MIN,26,14,21,32,0,93,POR,22,26,27,32,0,107
12/2/2014,POR,23,27,28,27,0,105,DEN,31,25,29,18,0,103
12/4/2014,IND,14,19,26,23,0,82,POR,16,22,24,26,0,88
12/7/2014,POR,25,28,30,20,0,103,NYK,20,30,25,24,0,99
12/9/2014,POR,33,22,21,22,0,98,DET,22,24,16,24,0,86
12/10/2014,POR,16,20,15,31,0,82,MIN,20,24,22,24,0,90
12/12/2014,POR,28,23,27,28,0,106,CHI,24,35,23,33,0,115
12/13/2014,POR,22,36,24,13,0,95,IND,23,15,28,19,0,85
12/15/2014,SAS,20,23,25,27,0,95,POR,23,25,28,32,0,108
12/17/2014,MIL,25,16,29,27,0,97,POR,18,25,25,36,0,104
12/19/2014,POR,17,27,25,28,7,129,SAS,20,26,28,23,7,119
12/20/2014,POR,32,30,32,20,0,114,NOP,17,27,18,26,0,88
12/22/2014,POR,33,20,23,19,0,95,HOU,37,36,23,14,0,110
12/23/2014,POR,19,35,19,25,17,115,OKC,26,17,30,25,13,111
12/26/2014,PHI,24,27,23,19,0,93,POR,27,34,27,26,0,114
12/28/2014,NYK,22,19,17,21,0,79,POR,31,24,21,25,0,101
12/30/2014,TOR,23,22,25,17,10,97,POR,23,15,25,24,15,102
1/3/2015,ATL,29,23,31,32,0,115,POR,20,29,26,32,0,107
1/5/2015,LAL,23,22,28,21,0,94,POR,24,23,23,28,0,98
1/8/2015,MIA,23,25,16,19,0,83,POR,18,25,33,23,0,99
1/10/2015,ORL,13,28,29,22,0,92,POR,26,20,26,31,0,103
1/11/2015,POR,23,27,22,34,0,106,LAL,20,25,24,25,0,94
1/14/2015,LAC,27,23,22,28,0,100,POR,21,28,23,22,0,94
1/16/2015,POR,28,24,27,17,0,96,SAS,35,25,31,19,0,110
1/17/2015,POR,23,19,28,28,0,98,MEM,30,30,18,24,0,102
1/19/2015,SAC,31,25,19,19,0,94,POR,23,28,16,31,0,98
1/21/2015,POR,29,23,24,37,0,113,PHO,40,26,25,27,0,118
1/22/2015,BOS,23,21,23,23,0,90,POR,19,23,30,17,0,89
1/24/2015,WAS,32,23,15,26,0,96,POR,20,25,24,34,0,103
1/28/2015,POR,21,23,30,20,0,94,CLE,31,23,25,20,0,99
1/30/2015,POR,29,22,23,25,0,99,ATL,27,23,19,36,0,105
1/31/2015,POR,15,27,23,23,0,88,MIL,27,18,31,19,0,95
2/3/2015,UTA,23,24,23,32,0,102,POR,27,17,28,31,0,103
2/5/2015,PHO,15,20,30,22,0,87,POR,27,19,20,42,0,108
2/7/2015,POR,25,30,28,13,5,101,DAL,24,26,20,26,15,111
2/8/2015,POR,26,35,20,28,0,109,HOU,27,21,32,18,0,98
2/11/2015,LAL,24,22,19,21,0,86,POR,32,22,34,14,0,102
2/20/2015,POR,24,19,16,17,0,76,UTA,18,21,26,27,0,92
2/22/2015,MEM,19,19,26,34,0,98,POR,21,17,39,15,0,92
2/25/2015,SAS,16,34,21,24,0,95,POR,32,19,30,30,0,111
2/27/2015,OKC,25,34,30,23,0,112,POR,28,19,31,37,0,115
3/1/2015,POR,34,30,21,25,0,110,SAC,23,27,25,24,0,99
3/4/2015,POR,28,18,20,21,11,98,LAC,24,24,20,19,6,93
3/5/2015,DAL,23,13,21,18,0,75,POR,17,23,31,23,0,94
3/7/2015,POR,30,25,22,36,0,113,MIN,29,22,30,40,0,121
3/11/2015,HOU,29,24,21,26,0,100,POR,26,28,26,25,0,105
3/13/2015,DET,24,22,32,21,0,99,POR,35,29,31,23,0,118
3/15/2015,POR,33,31,27,22,0,113,TOR,31,22,26,18,0,97
3/16/2015,POR,20,20,34,23,0,97,WAS,27,33,21,24,0,105
3/18/2015,POR,32,25,24,23,0,104,MIA,27,21,31,29,0,108
3/20/2015,POR,19,37,25,23,0,104,ORL,25,33,17,36,0,111
3/21/2015,POR,27,17,18,24,0,86,MEM,35,18,24,20,0,97
3/24/2015,GSW,26,31,36,29,0,122,POR,30,32,18,28,0,108
3/25/2015,POR,12,25,18,37,0,92,UTA,21,18,26,24,0,89
3/27/2015,POR,29,18,13,27,0,87,PHO,21,26,19,15,0,81
3/28/2015,DEN,25,28,25,36,0,114,POR,31,27,28,34,0,120
3/30/2015,PHO,22,27,16,21,0,86,POR,31,24,37,17,0,109
4/1/2015,LAC,26,29,30,41,0,126,POR,33,35,24,30,0,122
4/3/2015,POR,26,26,22,33,0,107,LAL,12,27,24,14,0,77
4/4/2015,NOP,24,20,28,18,0,90,POR,22,34,19,24,0,99
4/6/2015,POR,25,13,26,32,0,96,BRK,22,32,23,29,0,106
4/8/2015,MIN,19,17,26,29,0,91,POR,29,26,29,32,0,116
4/9/2015,POR,27,27,30,21,0,105,GSW,30,27,27,32,0,116
4/11/2015,UTA,32,24,21,34,0,111,POR,19,27,34,25,0,105
4/13/2015,POR,21,21,28,20,0,90,OKC,35,14,32,20,0,101
4/15/2015,POR,19,32,21,26,0,98,DAL,29,27,35,23,0,114
10/29/2014,PHI,24,27,22,18,0,91,IND,26,22,30,25,0,103
10/31/2014,MEM,23,22,33,19,0,97,IND,19,34,14,22,0,89
11/1/2014,IND,18,26,19,29,0,92,ATL,27,24,19,32,0,102
11/4/2014,MIL,22,21,26,18,0,87,IND,19,19,23,20,0,81
11/5/2014,IND,24,17,20,23,10,94,WAS,24,22,20,18,12,96
11/7/2014,IND,26,26,23,23,0,98,BOS,30,25,18,28,0,101
11/8/2014,WAS,32,22,19,24,0,97,IND,14,21,30,25,0,90
11/10/2014,UTA,20,21,28,17,0,86,IND,17,30,25,25,0,97
11/12/2014,IND,24,17,22,18,0,81,MIA,26,16,16,17,0,75
11/14/2014,DEN,30,34,28,16,0,108,IND,27,19,21,20,0,87
11/15/2014,IND,23,23,23,30,0,99,CHI,20,22,23,25,0,90
11/19/2014,CHO,28,21,17,20,0,86,IND,20,23,22,23,0,88
11/22/2014,PHO,30,25,25,26,0,106,IND,27,21,16,19,0,83
11/24/2014,IND,25,30,30,26,0,111,DAL,24,26,28,22,0,100
11/26/2014,IND,27,28,21,24,0,100,SAS,25,25,27,29,0,106
11/28/2014,ORL,20,25,14,24,0,83,IND,26,21,25,26,0,98
11/29/2014,IND,21,28,22,26,0,97,CLE,29,23,35,22,0,109
12/2/2014,IND,28,28,23,20,0,99,PHO,26,28,29,33,0,116
12/4/2014,IND,14,19,26,23,0,82,POR,16,22,24,26,0,88
12/5/2014,IND,20,25,27,24,5,101,SAC,34,22,24,16,6,102
12/8/2014,ATL,28,32,25,23,0,108,IND,18,25,21,28,0,92
12/10/2014,LAC,33,21,28,21,0,103,IND,25,24,16,31,0,96
12/12/2014,IND,20,22,30,22,0,94,TOR,28,25,27,26,0,106
12/13/2014,POR,22,36,24,13,0,95,IND,23,15,28,19,0,85
12/15/2014,LAL,15,12,31,33,0,91,IND,34,26,29,21,0,110
12/17/2014,IND,27,24,21,28,0,100,LAC,30,22,26,24,0,102
12/20/2014,IND,21,12,22,18,0,73,DEN,15,17,23,21,0,76
12/21/2014,IND,20,32,23,25,0,100,MIN,17,21,30,28,0,96
12/23/2014,NOP,26,14,21,23,0,84,IND,24,20,26,26,0,96
12/26/2014,IND,26,27,29,27,0,109,DET,32,25,36,26,0,119
12/27/2014,IND,22,28,29,31,0,110,BRK,23,24,18,20,0,85
12/29/2014,CHI,22,25,34,11,0,92,IND,17,18,30,25,0,90
12/31/2014,MIA,24,27,19,25,0,95,IND,20,22,36,28,0,106
1/2/2015,IND,23,23,20,28,0,94,MIL,21,32,15,23,0,91
1/4/2015,IND,28,20,21,18,0,87,LAL,15,26,22,25,0,88
1/5/2015,IND,31,22,21,31,0,105,UTA,16,23,23,39,0,101
1/7/2015,IND,28,22,26,26,0,102,GSW,23,27,34,33,0,117
1/9/2015,BOS,17,20,23,34,9,103,IND,25,21,19,29,13,107
1/10/2015,IND,21,28,21,22,0,92,PHI,19,24,29,21,0,93
1/13/2015,MIN,25,21,23,41,0,110,IND,21,31,23,26,0,101
1/16/2015,DET,23,26,30,19,0,98,IND,19,32,25,20,0,96
1/17/2015,IND,21,19,11,17,3,71,CHO,17,20,13,18,12,80
1/19/2015,IND,21,24,23,30,0,98,HOU,29,26,34,21,0,110
1/21/2015,IND,21,20,23,27,0,91,ATL,25,27,36,22,0,110
1/23/2015,IND,18,19,27,23,0,87,MIA,26,28,21,14,0,89
1/25/2015,IND,24,27,24,31,0,106,ORL,27,22,33,17,0,99
1/27/2015,TOR,21,29,27,27,0,104,IND,28,16,24,23,0,91
1/29/2015,NYK,29,20,12,21,0,82,IND,22,32,35,14,0,103
1/31/2015,SAC,34,30,15,20,0,99,IND,21,29,17,27,0,94
2/4/2015,DET,26,23,27,33,0,109,IND,29,19,33,33,0,114
2/6/2015,CLE,31,24,15,29,0,99,IND,27,20,20,36,0,103
2/8/2015,IND,20,19,36,28,0,103,CHO,32,24,27,19,0,102
2/9/2015,SAS,30,17,18,30,0,95,IND,28,17,34,14,0,93
2/11/2015,IND,32,25,32,17,0,106,NOP,18,17,25,33,0,93
2/20/2015,IND,23,35,29,19,0,106,PHI,16,24,28,27,0,95
2/22/2015,GSW,38,19,21,20,0,98,IND,26,32,23,23,0,104
2/24/2015,IND,20,22,27,23,0,92,OKC,30,18,32,25,0,105
2/27/2015,CLE,28,17,16,25,0,86,IND,19,32,23,19,0,93
3/1/2015,PHI,24,22,18,10,0,74,IND,27,32,14,21,0,94
3/4/2015,NYK,19,22,23,18,0,82,IND,30,35,23,17,0,105
3/6/2015,CHI,20,22,24,18,0,84,IND,23,22,21,32,0,98
3/7/2015,IND,22,16,22,32,0,92,NYK,18,25,20,23,0,86
3/10/2015,ORL,28,19,23,16,0,86,IND,26,33,27,32,0,118
3/12/2015,MIL,31,22,21,22,7,103,IND,19,32,31,14,13,109
3/14/2015,BOS,20,25,22,26,0,93,IND,18,19,23,29,0,89
3/16/2015,TOR,29,29,30,29,0,117,IND,24,30,27,17,0,98
3/18/2015,IND,22,19,27,18,0,86,CHI,24,27,25,27,0,103
3/20/2015,IND,20,21,31,20,0,92,CLE,25,20,27,23,0,95
3/21/2015,BRK,31,32,25,35,0,123,IND,29,27,31,24,0,111
3/23/2015,HOU,26,27,23,34,0,110,IND,15,24,29,32,0,100
3/25/2015,IND,14,28,28,33,0,103,WAS,20,24,32,25,0,101
3/26/2015,IND,15,32,27,33,0,107,MIL,34,25,26,26,0,111
3/29/2015,DAL,27,34,18,20,0,99,IND,33,22,23,26,0,104
3/31/2015,IND,15,39,25,27,0,106,BRK,33,24,27,27,0,111
4/1/2015,IND,16,23,23,25,0,87,BOS,22,28,18,32,0,100
4/3/2015,CHO,25,13,9,27,0,74,IND,22,27,21,23,0,93
4/5/2015,MIA,19,28,19,23,0,89,IND,22,29,26,35,0,112
4/8/2015,IND,26,28,29,19,0,102,NYK,14,24,17,31,0,86
4/10/2015,IND,23,28,28,28,0,107,DET,21,26,32,24,0,103
4/12/2015,OKC,32,19,25,28,0,104,IND,29,27,26,34,0,116
4/14/2015,WAS,16,25,18,22,4,95,IND,16,17,23,25,4,99
4/15/2015,IND,24,17,20,22,0,83,MEM,22,32,19,22,0,95
10/28/2014,DAL,24,29,20,27,0,100,SAS,26,19,31,25,0,101
10/31/2014,SAS,24,21,26,18,0,89,PHO,11,25,31,27,0,94
11/5/2014,ATL,15,24,23,30,0,92,SAS,27,22,19,26,0,94
11/6/2014,SAS,15,14,26,26,0,81,HOU,18,27,36,17,0,98
11/8/2014,NOP,30,25,26,19,0,100,SAS,23,30,18,28,0,99
11/10/2014,SAS,14,25,25,25,0,89,LAC,20,22,28,15,0,85
11/11/2014,SAS,29,21,32,31,0,113,GSW,26,18,26,30,0,100
11/14/2014,SAS,29,18,21,25,0,93,LAL,22,13,22,23,0,80
11/15/2014,SAS,24,14,28,25,0,91,SAC,23,22,25,24,0,94
11/17/2014,PHI,13,21,23,18,0,75,SAS,30,16,27,27,0,100
11/19/2014,SAS,23,21,28,20,0,92,CLE,20,27,22,21,0,90
11/21/2014,SAS,29,30,32,30,0,121,MIN,26,22,14,30,0,92
11/22/2014,BRK,18,18,28,23,0,87,SAS,25,26,28,20,0,99
11/26/2014,IND,27,28,21,24,0,100,SAS,25,25,27,29,0,106
11/28/2014,SAC,22,29,29,24,0,104,SAS,26,35,27,24,0,112
11/30/2014,SAS,25,20,33,33,0,111,BOS,22,27,24,16,0,89
12/1/2014,SAS,27,34,23,25,0,109,PHI,20,26,27,30,0,103
12/3/2014,SAS,19,23,16,30,5,93,BRK,19,21,28,20,7,95
12/5/2014,SAS,25,33,20,29,0,107,MEM,14,32,22,33,0,101
12/6/2014,MIN,23,28,25,25,0,101,SAS,31,37,28,27,0,123
12/9/2014,SAS,22,21,29,24,0,96,UTA,21,23,34,22,0,100
12/10/2014,NYK,26,26,21,22,0,95,SAS,29,27,38,15,0,109
12/12/2014,LAL,25,29,32,15,11,112,SAS,25,25,25,26,9,110
12/14/2014,SAS,20,25,26,28,0,99,DEN,22,12,27,30,0,91
12/15/2014,SAS,20,23,25,27,0,95,POR,23,25,28,32,0,108
12/17/2014,MEM,34,18,21,19,10,117,SAS,19,26,23,24,10,116
12/19/2014,POR,17,27,25,28,7,129,SAS,20,26,28,23,7,119
12/20/2014,SAS,25,22,30,16,0,93,DAL,21,21,33,24,0,99
12/22/2014,LAC,33,27,30,28,0,118,SAS,35,37,23,30,0,125
12/25/2014,OKC,29,21,26,38,0,114,SAS,27,20,30,29,0,106
12/26/2014,SAS,24,20,20,26,0,90,NOP,20,28,22,27,0,97
12/28/2014,HOU,33,22,29,22,0,106,SAS,28,28,29,25,0,110
12/30/2014,SAS,20,18,25,24,0,87,MEM,30,22,22,21,0,95
12/31/2014,NOP,14,14,32,24,9,93,SAS,17,21,24,22,11,95
1/3/2015,WAS,35,23,19,15,0,92,SAS,31,27,20,23,0,101
1/6/2015,DET,20,29,33,23,0,105,SAS,37,21,19,27,0,104
1/9/2015,PHO,18,25,26,26,0,95,SAS,29,20,10,41,0,100
1/10/2015,SAS,27,31,26,24,0,108,MIN,18,25,21,29,0,93
1/13/2015,SAS,24,24,24,21,0,93,WAS,31,20,24,26,0,101
1/14/2015,SAS,22,35,19,22,0,98,CHO,18,27,23,25,0,93
1/16/2015,POR,28,24,27,17,0,96,SAS,35,25,31,19,0,110
1/18/2015,UTA,15,12,20,22,0,69,SAS,23,20,23,23,0,89
1/20/2015,SAS,20,31,29,29,0,109,DEN,20,28,28,23,0,99
1/22/2015,SAS,22,18,20,21,0,81,CHI,21,25,31,27,0,104
1/23/2015,LAL,15,23,23,24,0,85,SAS,31,25,20,23,0,99
1/25/2015,MIL,24,31,12,28,0,95,SAS,21,26,22,32,0,101
1/28/2015,CHO,19,19,26,22,0,86,SAS,27,28,14,26,0,95
1/31/2015,LAC,29,27,28,21,0,105,SAS,25,17,27,16,0,85
2/4/2015,ORL,25,19,30,29,0,103,SAS,24,27,27,32,0,110
2/6/2015,MIA,19,22,20,24,0,85,SAS,30,22,25,21,0,98
2/8/2015,SAS,25,21,12,24,0,82,TOR,28,17,19,23,0,87
2/9/2015,SAS,30,17,18,30,0,95,IND,28,17,34,14,0,93
2/11/2015,SAS,20,28,34,22,0,104,DET,12,27,24,24,0,87
2/19/2015,SAS,24,31,33,27,0,115,LAC,27,25,38,29,0,119
2/20/2015,SAS,29,26,13,31,0,99,GSW,27,35,27,21,0,110
2/23/2015,SAS,22,18,24,17,0,81,UTA,28,19,26,17,0,90
2/25/2015,SAS,16,34,21,24,0,95,POR,32,19,30,30,0,111
2/27/2015,SAS,20,29,31,27,0,107,SAC,25,21,32,18,0,96
2/28/2015,SAS,24,27,24,26,0,101,PHO,13,11,17,33,0,74
3/4/2015,SAC,27,11,23,24,0,85,SAS,26,28,31,27,0,112
3/6/2015,DEN,29,31,23,28,0,111,SAS,32,33,25,30,0,120
3/8/2015,CHI,19,20,38,28,0,105,SAS,25,32,30,29,0,116
3/10/2015,TOR,17,24,30,36,0,107,SAS,28,33,24,32,0,117
3/12/2015,CLE,30,32,17,31,18,128,SAS,31,33,20,26,15,125
3/15/2015,MIN,23,27,13,34,0,97,SAS,29,31,33,30,0,123
3/17/2015,SAS,29,23,23,21,4,100,NYK,25,17,26,28,8,104
3/18/2015,SAS,27,36,28,23,0,114,MIL,28,26,26,23,0,103
3/20/2015,BOS,19,23,21,26,0,89,SAS,32,24,28,17,0,101
3/22/2015,SAS,26,33,24,31,0,114,ATL,13,28,24,30,0,95
3/24/2015,SAS,29,17,20,28,0,94,DAL,17,26,33,25,0,101
3/25/2015,OKC,28,22,24,17,0,91,SAS,32,39,29,30,0,130
3/27/2015,DAL,18,23,20,15,0,76,SAS,28,26,15,25,0,94
3/29/2015,MEM,21,21,24,23,0,89,SAS,28,23,19,33,0,103
3/31/2015,SAS,19,28,24,24,0,95,MIA,20,22,18,21,0,81
4/1/2015,SAS,23,29,30,21,0,103,ORL,19,21,20,31,0,91
4/3/2015,DEN,25,22,23,23,0,93,SAS,45,22,33,23,0,123
4/5/2015,GSW,17,21,29,25,0,92,SAS,31,26,32,18,0,107
4/7/2015,SAS,29,34,25,25,0,113,OKC,10,31,16,31,0,88
4/8/2015,HOU,33,20,18,27,0,98,SAS,32,25,28,25,0,110
4/10/2015,SAS,23,23,34,24,0,104,HOU,30,18,27,28,0,103
4/12/2015,PHO,18,21,26,26,0,91,SAS,20,31,25,31,0,107
4/15/2015,SAS,19,28,24,32,0,103,NOP,34,29,19,26,0,108
10/28/2014,HOU,31,31,23,23,0,108,LAL,19,26,24,21,0,90
10/29/2014,HOU,27,31,17,29,0,104,UTA,27,23,22,21,0,93
11/1/2014,BOS,22,16,24,28,0,90,HOU,37,20,24,23,0,104
11/3/2014,HOU,32,23,24,25,0,104,PHI,19,35,20,19,0,93
11/4/2014,HOU,30,27,26,25,0,108,MIA,31,24,22,14,0,91
11/6/2014,SAS,15,14,26,26,0,81,HOU,18,27,36,17,0,98
11/8/2014,GSW,25,23,28,22,0,98,HOU,29,27,13,18,0,87
11/12/2014,HOU,28,25,31,29,0,113,MIN,26,23,21,31,0,101
11/14/2014,PHI,28,19,21,19,0,87,HOU,19,28,16,25,0,88
11/16/2014,HOU,24,18,9,18,0,69,OKC,19,14,18,14,0,65
11/17/2014,HOU,18,24,24,27,0,93,MEM,34,31,32,22,0,119
11/19/2014,LAL,21,28,21,28,0,98,HOU,23,28,24,17,0,92
11/22/2014,DAL,29,22,17,24,0,92,HOU,29,31,17,18,0,95
11/24/2014,NYK,26,20,23,17,0,86,HOU,27,24,18,22,0,91
11/26/2014,SAC,19,31,23,16,0,89,HOU,37,20,20,25,0,102
11/28/2014,LAC,26,30,29,17,0,102,HOU,24,20,28,13,0,85
11/29/2014,HOU,28,25,32,32,0,117,MIL,23,23,26,31,0,103
12/3/2014,MEM,28,18,22,28,0,96,HOU,34,24,36,11,0,105
12/5/2014,HOU,33,22,28,22,9,114,MIN,24,33,17,31,7,112
12/6/2014,PHO,18,23,26,28,0,95,HOU,35,25,20,20,0,100
12/10/2014,HOU,30,16,30,17,0,93,GSW,23,23,27,32,0,105
12/11/2014,HOU,16,20,25,34,18,113,SAC,26,20,23,26,14,109
12/13/2014,DEN,31,17,25,23,0,96,HOU,21,33,26,28,0,108
12/17/2014,HOU,25,30,20,24,16,115,DEN,29,31,18,21,12,111
12/18/2014,NOP,21,25,19,34,0,99,HOU,22,17,29,22,0,90
12/20/2014,ATL,32,20,22,30,0,104,HOU,26,14,34,23,0,97
12/22/2014,POR,33,20,23,19,0,95,HOU,37,36,23,14,0,110
12/26/2014,HOU,24,26,29,25,13,117,MEM,31,26,24,23,7,111
12/28/2014,HOU,33,22,29,22,0,106,SAS,28,28,29,25,0,110
12/29/2014,WAS,24,22,32,26,0,104,HOU,27,18,22,36,0,103
12/31/2014,CHO,25,20,23,15,0,83,HOU,23,24,29,26,0,102
1/2/2015,HOU,20,22,18,23,0,83,NOP,29,30,30,22,0,111
1/3/2015,MIA,27,22,11,19,0,79,HOU,23,38,33,21,0,115
1/5/2015,HOU,33,29,27,16,0,105,CHI,34,28,21,31,0,114
1/7/2015,HOU,26,23,24,32,0,105,CLE,23,25,26,19,0,93
1/8/2015,HOU,27,29,37,27,0,120,NYK,22,20,27,27,0,96
1/10/2015,UTA,23,14,20,25,0,82,HOU,23,23,32,19,0,97
1/12/2015,HOU,37,23,26,27,0,113,BRK,28,24,18,29,0,99
1/14/2015,HOU,19,33,33,28,0,113,ORL,29,26,29,36,0,120
1/15/2015,OKC,18,35,22,26,0,101,HOU,40,24,24,24,0,112
1/17/2015,GSW,31,33,38,29,0,131,HOU,31,28,21,26,0,106
1/19/2015,IND,21,24,23,30,0,98,HOU,29,26,34,21,0,110
1/21/2015,HOU,29,13,36,35,0,113,GSW,32,30,40,24,0,126
1/23/2015,HOU,32,28,27,26,0,113,PHO,24,28,25,34,0,111
1/25/2015,HOU,30,22,28,19,0,99,LAL,15,21,24,27,0,87
1/28/2015,DAL,25,28,25,16,0,94,HOU,24,30,27,18,0,99
1/30/2015,HOU,29,31,9,24,0,93,BOS,21,21,22,23,0,87
1/31/2015,HOU,27,19,23,32,0,101,DET,32,27,27,28,0,114
2/4/2015,CHI,27,21,22,20,0,90,HOU,27,30,18,26,0,101
2/6/2015,MIL,23,33,26,29,0,111,HOU,36,32,28,21,0,117
2/8/2015,POR,26,35,20,28,0,109,HOU,27,21,32,18,0,98
2/10/2015,HOU,41,29,18,39,0,127,PHO,23,38,28,29,0,118
2/11/2015,HOU,26,30,23,16,0,95,LAC,26,28,26,30,0,110
2/20/2015,HOU,20,23,24,33,0,100,DAL,24,30,33,24,0,111
2/21/2015,TOR,18,18,17,23,0,76,HOU,20,20,28,30,0,98
2/23/2015,MIN,25,31,19,27,0,102,HOU,26,30,28,29,0,113
2/25/2015,LAC,26,34,25,20,0,105,HOU,27,35,22,26,0,110
2/27/2015,BRK,36,21,16,25,0,98,HOU,25,28,21,28,0,102
3/1/2015,CLE,26,21,27,24,5,103,HOU,29,21,32,16,7,105
3/3/2015,HOU,31,28,22,15,0,96,ATL,22,23,27,32,0,104
3/4/2015,MEM,24,30,25,23,0,102,HOU,31,28,20,21,0,100
3/6/2015,DET,23,23,23,24,0,93,HOU,29,25,26,23,0,103
3/7/2015,HOU,25,30,33,26,0,114,DEN,28,20,25,27,0,100
3/11/2015,HOU,29,24,21,26,0,100,POR,26,28,26,25,0,105
3/12/2015,HOU,23,20,22,26,0,91,UTA,28,25,29,27,0,109
3/15/2015,HOU,22,36,26,16,0,100,LAC,30,20,24,24,0,98
3/17/2015,ORL,24,26,28,16,0,94,HOU,28,23,26,30,0,107
3/19/2015,DEN,27,22,24,35,0,108,HOU,33,32,25,28,0,118
3/21/2015,PHO,33,29,37,18,0,117,HOU,37,24,25,16,0,102
3/23/2015,HOU,26,27,23,34,0,110,IND,15,24,29,32,0,100
3/25/2015,HOU,19,30,29,17,0,95,NOP,34,18,18,23,0,93
3/27/2015,MIN,22,28,30,30,0,110,HOU,31,29,30,30,0,120
3/29/2015,HOU,28,31,17,23,0,99,WAS,20,26,21,24,0,91
3/30/2015,HOU,27,25,24,20,0,96,TOR,27,21,26,25,0,99
4/1/2015,SAC,25,30,31,25,0,111,HOU,35,23,39,18,0,115
4/2/2015,HOU,28,19,30,31,0,108,DAL,25,30,28,18,0,101
4/5/2015,HOU,27,28,28,32,0,115,OKC,17,30,30,35,0,112
4/8/2015,HOU,33,20,18,27,0,98,SAS,32,25,28,25,0,110
4/10/2015,SAS,23,23,34,24,0,104,HOU,30,18,27,28,0,103
4/12/2015,NOP,28,27,31,28,0,114,HOU,22,30,34,35,0,121
4/13/2015,HOU,24,28,31,17,0,100,CHO,23,29,23,15,0,90
4/15/2015,UTA,20,15,25,31,0,91,HOU,31,34,28,24,0,117
10/29/2014,OKC,34,20,23,12,0,89,POR,29,20,26,31,0,106
10/30/2014,OKC,28,13,21,28,0,90,LAC,22,24,24,23,0,93
11/1/2014,DEN,17,16,23,35,0,91,OKC,29,26,21,26,0,102
11/3/2014,OKC,19,21,22,23,0,85,BRK,32,27,26,31,0,116
11/4/2014,OKC,30,22,18,18,0,88,TOR,23,28,22,27,0,100
11/7/2014,MEM,22,27,17,25,0,91,OKC,19,21,22,27,0,89
11/9/2014,SAC,17,22,26,28,0,93,OKC,24,28,15,34,0,101
11/11/2014,OKC,22,16,26,14,0,78,MIL,15,26,28,16,0,85
11/12/2014,OKC,15,27,34,33,0,109,BOS,24,27,21,22,0,94
11/14/2014,DET,21,21,25,15,14,96,OKC,30,18,18,16,7,89
11/16/2014,HOU,24,18,9,18,0,69,OKC,19,14,18,14,0,65
11/18/2014,OKC,23,19,17,22,0,81,UTA,14,26,32,26,0,98
11/19/2014,OKC,26,23,25,26,0,100,DEN,27,27,34,19,0,107
11/21/2014,BRK,21,28,22,23,0,94,OKC,27,26,21,18,0,92
11/23/2014,GSW,28,24,18,21,0,91,OKC,20,27,19,20,0,86
11/26/2014,UTA,29,19,14,20,0,82,OKC,31,25,18,23,0,97
11/28/2014,NYK,13,20,17,28,0,78,OKC,30,29,23,23,0,105
12/2/2014,OKC,26,26,22,30,0,104,NOP,29,40,16,27,0,112
12/5/2014,OKC,31,26,25,21,0,103,PHI,24,23,20,24,0,91
12/7/2014,OKC,25,23,29,19,0,96,DET,33,22,20,19,0,94
12/9/2014,MIL,31,21,26,23,0,101,OKC,26,35,26,27,0,114
12/11/2014,CLE,26,21,19,28,0,94,OKC,18,29,31,25,0,103
12/12/2014,OKC,39,31,23,18,0,111,MIN,21,28,28,15,0,92
12/14/2014,PHO,29,19,16,24,0,88,OKC,41,29,19,23,0,112
12/16/2014,OKC,34,27,20,23,0,104,SAC,20,34,17,21,0,92
12/18/2014,OKC,40,23,26,20,0,109,GSW,32,33,29,20,0,114
12/19/2014,OKC,20,32,30,22,0,104,LAL,26,24,23,30,0,103
12/21/2014,NOP,25,28,23,25,0,101,OKC,28,20,33,18,0,99
12/23/2014,POR,19,35,19,25,17,115,OKC,26,17,30,25,13,111
12/25/2014,OKC,29,21,26,38,0,114,SAS,27,20,30,29,0,106
12/26/2014,CHO,24,16,16,19,0,75,OKC,33,26,22,17,0,98
12/28/2014,OKC,26,32,30,19,0,107,DAL,33,31,17,31,0,112
12/31/2014,PHO,29,33,32,34,6,134,OKC,30,34,36,28,9,137
1/2/2015,WAS,29,28,25,20,0,102,OKC,28,27,27,27,0,109
1/5/2015,OKC,25,20,20,26,0,91,GSW,34,31,19,33,0,117
1/7/2015,OKC,16,27,14,26,0,83,SAC,28,25,25,26,0,104
1/9/2015,UTA,27,23,26,18,0,94,OKC,27,17,30,25,0,99
1/15/2015,OKC,18,35,22,26,0,101,HOU,40,24,24,24,0,112
1/16/2015,GSW,35,25,31,24,0,115,OKC,33,36,29,29,0,127
1/18/2015,OKC,37,42,24,24,0,127,ORL,20,25,31,23,0,99
1/20/2015,OKC,24,25,23,22,0,94,MIA,27,23,17,19,0,86
1/21/2015,OKC,26,12,28,26,13,105,WAS,31,19,20,22,11,103
1/23/2015,OKC,30,17,28,18,0,93,ATL,23,25,31,24,0,103
1/25/2015,OKC,26,23,29,20,0,98,CLE,20,37,26,25,0,108
1/26/2015,MIN,19,21,16,28,0,84,OKC,25,23,17,27,0,92
1/28/2015,OKC,19,26,22,25,0,92,NYK,20,23,25,32,0,100
1/31/2015,OKC,20,20,22,12,0,74,MEM,25,20,23,17,0,85
2/2/2015,ORL,22,28,17,30,0,97,OKC,29,32,21,22,0,104
2/4/2015,OKC,31,20,26,25,0,102,NOP,29,28,19,15,0,91
2/6/2015,NOP,29,24,30,33,0,116,OKC,33,23,25,32,0,113
2/8/2015,LAC,26,30,19,33,0,108,OKC,28,38,35,30,0,131
2/9/2015,OKC,38,35,33,18,0,124,DEN,18,41,33,22,0,114
2/11/2015,MEM,26,22,21,20,0,89,OKC,35,31,19,20,0,105
2/19/2015,DAL,19,17,29,24,0,89,OKC,25,27,31,21,0,104
2/21/2015,OKC,28,31,27,24,0,110,CHO,30,26,27,20,0,103
2/22/2015,DEN,18,24,27,25,0,94,OKC,36,31,31,21,0,119
2/24/2015,IND,20,22,27,23,0,92,OKC,30,18,32,25,0,105
2/26/2015,OKC,15,33,36,25,4,113,PHO,25,28,33,23,8,117
2/27/2015,OKC,25,34,30,23,0,112,POR,28,19,31,37,0,115
3/1/2015,OKC,28,28,28,24,0,108,LAL,19,29,24,29,0,101
3/4/2015,PHI,34,25,31,20,8,118,OKC,37,19,28,26,13,123
3/5/2015,OKC,30,20,29,26,0,105,CHI,18,30,24,36,0,108
3/8/2015,TOR,26,35,18,25,0,104,OKC,31,27,28,22,0,108
3/11/2015,LAC,36,29,35,20,0,120,OKC,30,27,28,23,0,108
3/13/2015,MIN,26,23,23,27,0,99,OKC,31,24,24,34,0,113
3/15/2015,CHI,15,32,23,30,0,100,OKC,17,30,28,34,0,109
3/16/2015,OKC,29,34,29,23,0,115,DAL,27,26,39,27,0,119
3/18/2015,BOS,24,33,24,37,0,118,OKC,28,25,40,29,0,122
3/20/2015,ATL,35,33,27,20,0,115,OKC,34,27,29,33,0,123
3/22/2015,MIA,21,17,20,17,0,75,OKC,25,23,18,27,0,93
3/24/2015,LAL,27,26,35,29,0,117,OKC,37,31,32,27,0,127
3/25/2015,OKC,28,22,24,17,0,91,SAS,32,39,29,30,0,130
3/28/2015,OKC,32,17,17,23,0,89,UTA,21,26,29,18,0,94
3/29/2015,OKC,24,30,22,33,0,109,PHO,35,27,17,18,0,97
4/1/2015,DAL,28,38,35,34,0,135,OKC,25,38,38,30,0,131
4/3/2015,OKC,26,23,20,23,0,92,MEM,24,31,22,23,0,100
4/5/2015,HOU,27,28,28,32,0,115,OKC,17,30,30,35,0,112
4/7/2015,SAS,29,34,25,25,0,113,OKC,10,31,16,31,0,88
4/10/2015,SAC,24,25,27,27,0,103,OKC,34,23,25,34,0,116
4/12/2015,OKC,32,19,25,28,0,104,IND,29,27,26,34,0,116
4/13/2015,POR,21,21,28,20,0,90,OKC,35,14,32,20,0,101
4/15/2015,OKC,47,29,30,32,0,138,MIN,29,25,31,28,0,113
10/29/2014,ATL,22,30,19,31,0,102,TOR,24,36,26,23,0,109
11/1/2014,TOR,29,20,38,21,0,108,ORL,26,26,26,17,0,95
11/2/2014,TOR,26,28,23,25,0,102,MIA,31,33,23,20,0,107
11/4/2014,OKC,30,22,18,18,0,88,TOR,23,28,22,27,0,100
11/5/2014,TOR,23,31,34,22,0,110,BOS,35,22,29,21,0,107
11/7/2014,WAS,18,17,23,26,0,84,TOR,28,31,23,21,0,103
11/9/2014,PHI,20,25,18,25,0,88,TOR,33,27,28,32,0,120
11/11/2014,ORL,32,28,23,17,0,100,TOR,24,27,21,32,0,104
11/13/2014,CHI,25,20,35,20,0,100,TOR,24,28,14,27,0,93
11/15/2014,UTA,25,24,23,21,0,93,TOR,23,23,30,35,0,111
11/19/2014,MEM,20,28,27,17,0,92,TOR,22,20,27,27,0,96
11/21/2014,MIL,27,18,12,25,0,82,TOR,37,34,30,23,0,124
11/22/2014,TOR,21,35,29,25,0,110,CLE,34,20,17,22,0,93
11/24/2014,PHO,26,22,18,34,0,100,TOR,29,25,27,23,0,104
11/26/2014,TOR,34,30,27,35,0,126,ATL,24,37,27,27,0,115
11/28/2014,DAL,26,22,23,35,0,106,TOR,21,22,21,38,0,102
11/30/2014,TOR,24,25,31,29,13,122,LAL,27,31,23,28,20,129
12/2/2014,TOR,31,26,35,25,0,117,SAC,22,33,28,26,0,109
12/3/2014,TOR,31,38,28,26,0,123,UTA,24,29,29,22,0,104
12/5/2014,CLE,30,21,25,29,0,105,TOR,21,23,20,27,0,91
12/8/2014,DEN,30,22,29,21,5,107,TOR,35,27,20,20,10,112
12/9/2014,TOR,33,30,25,13,0,101,CLE,26,29,26,24,0,105
12/12/2014,IND,20,22,30,22,0,94,TOR,28,25,27,26,0,106
12/14/2014,TOR,27,18,27,14,9,95,NYK,27,19,21,19,4,90
12/15/2014,ORL,25,27,13,17,0,82,TOR,28,16,27,24,0,95
12/17/2014,BRK,30,22,21,16,0,89,TOR,22,31,23,29,0,105
12/19/2014,TOR,26,26,29,29,0,110,DET,31,21,18,30,0,100
12/21/2014,NYK,25,26,24,33,0,108,TOR,33,25,33,27,0,118
12/22/2014,TOR,33,33,17,37,0,120,CHI,33,27,20,49,0,129
12/27/2014,TOR,22,27,31,30,0,110,LAC,26,23,29,20,0,98
12/28/2014,TOR,27,33,28,28,0,116,DEN,24,30,33,15,0,102
12/30/2014,TOR,23,22,25,17,10,97,POR,23,15,25,24,15,102
1/2/2015,TOR,31,30,23,21,0,105,GSW,40,26,31,29,0,126
1/4/2015,TOR,19,34,23,33,0,109,PHO,27,43,28,27,0,125
1/8/2015,CHO,31,19,25,28,0,103,TOR,23,29,14,29,0,95
1/10/2015,BOS,26,17,22,31,0,96,TOR,19,28,35,27,0,109
1/12/2015,DET,20,28,34,32,0,114,TOR,32,28,23,28,0,111
1/14/2015,PHI,19,27,15,23,0,84,TOR,34,16,21,29,0,100
1/16/2015,ATL,24,28,33,25,0,110,TOR,19,19,30,21,0,89
1/18/2015,NOP,21,29,14,31,0,95,TOR,14,22,35,22,0,93
1/19/2015,TOR,22,31,15,24,0,92,MIL,25,19,18,27,0,89
1/21/2015,TOR,16,22,23,25,0,86,MEM,16,25,19,32,0,92
1/23/2015,TOR,22,26,15,28,0,91,PHI,30,11,21,24,0,86
1/25/2015,DET,25,28,26,31,0,110,TOR,26,32,31,25,0,114
1/27/2015,TOR,21,29,27,27,0,104,IND,28,16,24,23,0,91
1/28/2015,SAC,22,32,22,26,0,102,TOR,26,28,39,26,0,119
1/30/2015,TOR,29,37,25,22,14,127,BRK,23,31,28,31,9,122
1/31/2015,TOR,33,32,29,15,11,120,WAS,30,20,28,31,7,116
2/2/2015,MIL,23,24,26,9,0,82,TOR,14,27,19,15,0,75
2/4/2015,BRK,22,27,27,33,0,109,TOR,28,23,21,21,0,93
2/6/2015,LAC,34,25,20,28,0,107,TOR,19,38,38,28,0,123
2/8/2015,SAS,25,21,12,24,0,82,TOR,28,17,19,23,0,87
2/11/2015,WAS,25,22,29,17,0,93,TOR,27,22,26,20,0,95
2/20/2015,TOR,26,23,28,28,0,105,ATL,26,19,13,22,0,80
2/21/2015,TOR,18,18,17,23,0,76,HOU,20,20,28,30,0,98
2/23/2015,TOR,28,28,18,23,0,97,NOP,17,27,23,33,0,100
2/24/2015,TOR,29,26,22,15,0,92,DAL,25,24,25,25,0,99
2/27/2015,GSW,27,27,44,15,0,113,TOR,11,20,26,32,0,89
2/28/2015,TOR,15,32,24,27,0,98,NYK,22,28,25,28,0,103
3/2/2015,TOR,26,29,28,31,0,114,PHI,22,27,27,27,0,103
3/4/2015,CLE,28,29,27,36,0,120,TOR,25,18,31,38,0,112
3/6/2015,TOR,24,18,29,23,0,94,CHO,25,28,24,26,0,103
3/8/2015,TOR,26,35,18,25,0,104,OKC,31,27,28,22,0,108
3/10/2015,TOR,17,24,30,36,0,107,SAS,28,33,24,32,0,117
3/13/2015,MIA,18,23,22,29,0,92,TOR,21,29,28,24,0,102
3/15/2015,POR,33,31,27,22,0,113,TOR,31,22,26,18,0,97
3/16/2015,TOR,29,29,30,29,0,117,IND,24,30,27,17,0,98
3/18/2015,MIN,32,22,21,25,0,100,TOR,31,23,28,23,0,105
3/20/2015,TOR,24,24,20,24,0,92,CHI,32,28,26,22,0,108
3/22/2015,NYK,23,18,25,23,0,89,TOR,27,29,18,32,0,106
3/24/2015,TOR,27,21,27,29,0,104,DET,37,23,25,23,0,108
3/25/2015,CHI,20,30,27,39,0,116,TOR,29,25,28,21,0,103
3/27/2015,LAL,24,24,18,17,0,83,TOR,17,29,25,23,0,94
3/30/2015,HOU,27,25,24,20,0,96,TOR,27,21,26,25,0,99
4/1/2015,TOR,31,29,26,27,0,113,MIN,27,19,23,30,0,99
4/3/2015,TOR,27,27,25,30,0,109,BRK,34,15,28,37,0,114
4/4/2015,BOS,15,32,34,23,13,117,TOR,24,23,23,34,12,116
4/8/2015,TOR,20,27,22,23,0,92,CHO,15,16,14,29,0,74
4/10/2015,TOR,29,20,27,25,0,101,ORL,19,32,25,23,0,99
4/11/2015,TOR,27,31,21,28,0,107,MIA,29,29,23,23,0,104
4/14/2015,TOR,26,27,17,23,0,93,BOS,19,27,27,22,0,95
4/15/2015,CHO,20,24,23,20,0,87,TOR,25,30,23,14,0,92
10/28/2014,ORL,25,16,23,20,0,84,NOP,24,24,30,23,0,101
10/30/2014,WAS,28,26,28,23,0,105,ORL,23,28,15,32,0,98
11/1/2014,TOR,29,20,38,21,0,108,ORL,26,26,26,17,0,95
11/4/2014,ORL,28,24,17,21,0,90,CHI,24,30,15,29,0,98
11/5/2014,ORL,26,26,23,16,0,91,PHI,28,24,23,14,0,89
11/7/2014,MIN,27,25,25,17,9,103,ORL,26,21,27,20,18,112
11/9/2014,ORL,23,29,25,19,0,96,BRK,24,26,31,23,0,104
11/11/2014,ORL,32,28,23,17,0,100,TOR,24,27,21,32,0,104
11/12/2014,ORL,31,25,18,23,0,97,NYK,27,23,26,19,0,95
11/14/2014,MIL,30,19,19,17,0,85,ORL,25,27,28,21,0,101
11/15/2014,ORL,17,21,24,31,0,93,WAS,24,24,21,29,0,98
11/17/2014,ORL,28,21,29,29,0,107,DET,28,24,24,17,0,93
11/19/2014,LAC,26,30,28,30,0,114,ORL,23,25,20,22,0,90
11/21/2014,ORL,26,14,24,41,0,105,CHO,27,24,28,21,0,100
11/22/2014,MIA,22,27,19,31,0,99,ORL,18,28,21,25,0,92
11/24/2014,ORL,16,22,20,16,0,74,CLE,26,30,25,25,0,106
11/26/2014,GSW,31,34,27,19,0,111,ORL,27,25,13,31,0,96
11/28/2014,ORL,20,25,14,24,0,83,IND,26,21,25,26,0,98
11/30/2014,ORL,27,25,17,24,0,93,PHO,23,16,19,32,0,90
12/2/2014,ORL,25,21,29,22,0,97,GSW,24,32,17,25,0,98
12/3/2014,ORL,23,21,18,24,0,86,LAC,31,26,27,30,0,114
12/5/2014,ORL,24,29,18,27,0,98,UTA,21,20,23,29,0,93
12/6/2014,ORL,27,25,25,28,0,105,SAC,27,22,17,30,0,96
12/10/2014,WAS,26,19,22,24,0,91,ORL,21,23,31,14,0,89
12/12/2014,ORL,26,14,24,17,0,81,ATL,29,11,24,23,0,87
12/13/2014,ATL,23,25,24,27,0,99,ORL,18,29,25,28,0,100
12/15/2014,ORL,25,27,13,17,0,82,TOR,28,16,27,24,0,95
12/17/2014,ORL,28,25,20,19,0,92,BOS,29,27,22,31,0,109
12/19/2014,UTA,29,20,32,20,0,101,ORL,17,26,23,28,0,94
12/21/2014,PHI,23,14,27,32,0,96,ORL,20,22,18,28,0,88
12/23/2014,BOS,9,21,30,35,0,95,ORL,26,27,32,15,0,100
12/26/2014,CLE,27,22,22,27,0,98,ORL,32,21,22,14,0,89
12/27/2014,ORL,22,30,29,21,0,102,CHO,18,24,26,26,0,94
12/29/2014,ORL,26,24,27,25,0,102,MIA,25,28,24,24,0,101
12/30/2014,DET,20,34,26,29,0,109,ORL,21,26,23,16,0,86
1/2/2015,BRK,22,30,34,14,0,100,ORL,25,15,21,37,0,98
1/3/2015,CHO,22,30,18,28,0,98,ORL,20,9,25,36,0,90
1/7/2015,ORL,18,21,19,32,0,90,DEN,25,15,23,30,0,93
1/9/2015,ORL,20,25,22,17,0,84,LAL,29,25,19,28,0,101
1/10/2015,ORL,13,28,29,22,0,92,POR,26,20,26,31,0,103
1/12/2015,ORL,29,34,30,28,0,121,CHI,21,34,23,36,0,114
1/14/2015,HOU,19,33,33,28,0,113,ORL,29,26,29,36,0,120
1/16/2015,MEM,27,21,33,25,0,106,ORL,28,21,25,22,0,96
1/18/2015,OKC,37,42,24,24,0,127,ORL,20,25,31,23,0,99
1/21/2015,ORL,24,24,36,34,0,118,DET,35,30,31,32,0,128
1/23/2015,ORL,26,24,28,28,0,106,NYK,20,31,31,31,0,113
1/25/2015,IND,24,27,24,31,0,106,ORL,27,22,33,17,0,99
1/26/2015,ORL,29,19,25,21,0,94,MEM,34,33,22,14,0,103
1/29/2015,MIL,28,31,37,19,0,115,ORL,18,26,27,29,0,100
1/31/2015,DAL,34,32,22,20,0,108,ORL,17,24,29,23,0,93
2/2/2015,ORL,22,28,17,30,0,97,OKC,29,32,21,22,0,104
2/4/2015,ORL,25,19,30,29,0,103,SAS,24,27,27,32,0,110
2/6/2015,LAL,23,29,26,13,6,97,ORL,26,12,31,22,12,103
2/8/2015,CHI,32,18,24,24,0,98,ORL,16,29,29,23,0,97
2/9/2015,ORL,16,19,19,26,0,80,WAS,24,19,31,22,0,96
2/11/2015,NYK,24,23,13,23,0,83,ORL,27,17,20,25,0,89
2/20/2015,NOP,20,27,24,13,0,84,ORL,19,24,30,22,0,95
2/22/2015,PHI,23,24,22,29,0,98,ORL,29,26,21,27,0,103
2/25/2015,MIA,17,19,25,24,8,93,ORL,17,23,21,24,5,90
2/27/2015,ORL,16,29,22,21,0,88,ATL,28,14,34,19,0,95
3/1/2015,CHO,28,15,28,27,0,98,ORL,22,20,18,23,0,83
3/4/2015,PHO,22,21,34,28,0,105,ORL,25,27,17,31,0,100
3/6/2015,SAC,26,31,29,28,0,114,ORL,35,33,24,27,0,119
3/8/2015,BOS,31,18,20,29,0,98,ORL,17,26,26,34,0,103
3/10/2015,ORL,28,19,23,16,0,86,IND,26,33,27,32,0,118
3/11/2015,ORL,31,26,15,19,0,91,MIL,29,25,18,25,0,97
3/13/2015,ORL,23,27,22,16,0,88,BOS,19,21,26,29,0,95
3/15/2015,CLE,26,40,34,23,0,123,ORL,28,27,31,22,0,108
3/17/2015,ORL,24,26,28,16,0,94,HOU,28,23,26,30,0,107
3/18/2015,ORL,23,25,22,32,0,102,DAL,31,34,21,21,0,107
3/20/2015,POR,19,37,25,23,0,104,ORL,25,33,17,36,0,111
3/22/2015,DEN,28,41,33,17,0,119,ORL,25,26,21,28,0,100
3/25/2015,ATL,23,24,21,27,0,95,ORL,31,21,19,12,0,83
3/27/2015,DET,30,24,33,24,0,111,ORL,27,26,23,21,0,97
4/1/2015,SAS,23,29,30,21,0,103,ORL,19,21,20,31,0,91
4/3/2015,ORL,29,23,20,25,0,97,MIN,23,19,23,19,0,84
4/4/2015,ORL,22,29,21,25,0,97,MIL,31,22,20,17,0,90
4/8/2015,CHI,29,30,28,16,0,103,ORL,21,31,27,26,0,105
4/10/2015,TOR,29,20,27,25,0,101,ORL,19,32,25,23,0,99
4/11/2015,NYK,30,8,23,19,0,80,ORL,24,7,19,29,0,79
4/13/2015,ORL,22,17,27,27,0,93,MIA,33,24,27,16,0,100
4/15/2015,ORL,28,24,23,13,0,88,BRK,23,25,27,26,0,101
