date,away_team,away_q1,away_q2,away_q3,away_q4,away_OT,away_final,home_team,home_q1,home_q2,home_q3,home_q4,home_OT,home_final
10/25/2016,NYK,18,27,19,24,0,88,CLE,28,20,34,35,0,117
10/28/2016,CLE,28,22,21,23,0,94,TOR,23,17,27,24,0,91
10/29/2016,ORL,20,25,17,37,0,99,CLE,33,29,18,25,0,105
11/1/2016,HOU,35,24,25,36,0,120,CLE,29,34,22,43,0,128
11/3/2016,BOS,25,26,32,39,0,122,CLE,36,32,32,28,0,128
11/5/2016,CLE,34,23,25,20,0,102,PHI,19,27,34,21,0,101
11/8/2016,ATL,20,33,31,26,0,110,CLE,20,22,37,27,0,106
11/11/2016,CLE,26,32,26,21,0,105,WAS,31,25,19,19,0,94
11/13/2016,CHO,22,32,18,21,0,93,CLE,32,20,19,29,0,100
11/15/2016,TOR,25,32,27,33,0,117,CLE,30,31,30,30,0,121
11/16/2016,CLE,19,26,23,25,0,93,IND,30,20,30,23,0,103
11/18/2016,DET,19,20,17,25,0,81,CLE,30,26,26,22,0,104
11/23/2016,POR,31,29,32,33,0,125,CLE,46,35,31,25,0,137
11/25/2016,DAL,16,22,17,35,0,90,CLE,36,36,24,32,0,128
11/27/2016,CLE,24,28,25,35,0,112,PHI,30,28,23,27,0,108
11/29/2016,CLE,32,22,20,27,0,101,MIL,30,28,34,26,0,118
12/1/2016,LAC,24,34,27,28,0,113,CLE,28,22,15,29,0,94
12/2/2016,CLE,33,27,20,25,0,105,CHI,30,29,29,23,0,111
12/5/2016,CLE,30,32,28,26,0,116,TOR,27,34,20,31,0,112
12/7/2016,CLE,36,27,29,34,0,126,NYK,26,22,17,29,0,94
12/9/2016,MIA,27,19,23,15,0,84,CLE,31,26,30,27,0,114
12/10/2016,CHO,26,26,29,24,0,105,CLE,36,31,25,24,0,116
12/13/2016,MEM,20,23,15,28,0,86,CLE,32,26,15,30,0,103
12/14/2016,CLE,16,20,17,32,0,85,MEM,28,19,27,19,0,93
12/17/2016,LAL,31,28,24,25,0,108,CLE,26,36,27,30,0,119
12/20/2016,CLE,35,22,27,16,14,114,MIL,27,26,25,22,8,108
12/21/2016,MIL,22,32,23,25,0,102,CLE,31,28,33,21,0,113
12/23/2016,BRK,15,25,17,42,0,99,CLE,29,37,32,21,0,119
12/25/2016,GSW,27,28,32,21,0,108,CLE,25,27,28,29,0,109
12/26/2016,CLE,19,25,20,26,0,90,DET,22,28,26,30,0,106
12/29/2016,BOS,25,34,24,35,0,118,CLE,32,34,35,23,0,124
12/31/2016,CLE,35,36,28,22,0,121,CHO,28,31,23,27,0,109
1/2/2017,NOP,22,21,26,13,0,82,CLE,15,29,23,23,0,90
1/4/2017,CHI,16,36,31,23,0,106,CLE,23,23,28,20,0,94
1/6/2017,CLE,24,26,36,30,0,116,BRK,20,19,29,40,0,108
1/8/2017,CLE,41,28,24,27,0,120,PHO,28,25,37,26,0,116
1/10/2017,CLE,29,12,25,26,0,92,UTA,29,27,19,25,0,100
1/11/2017,CLE,20,21,20,25,0,86,POR,27,22,24,29,0,102
1/13/2017,CLE,32,29,23,36,0,120,SAC,15,28,31,34,0,108
1/16/2017,CLE,22,27,22,20,0,91,GSW,37,41,17,31,0,126
1/19/2017,PHO,21,20,35,27,0,103,CLE,29,30,30,29,0,118
1/21/2017,SAS,22,35,27,23,11,118,CLE,33,25,31,18,8,115
1/23/2017,CLE,26,24,36,36,0,122,NOP,35,35,24,30,0,124
1/25/2017,SAC,22,31,26,25,12,116,CLE,26,21,35,22,8,112
1/27/2017,BRK,25,22,26,43,0,116,CLE,27,28,39,30,0,124
1/29/2017,OKC,24,21,20,26,0,91,CLE,21,37,22,27,0,107
1/30/2017,CLE,29,21,20,27,0,97,DAL,26,29,26,23,0,104
2/1/2017,MIN,32,28,19,18,0,97,CLE,36,27,30,32,0,125
2/4/2017,CLE,34,30,20,27,0,111,NYK,25,20,23,36,0,104
2/6/2017,CLE,26,28,32,34,20,140,WAS,32,25,25,38,15,135
2/8/2017,CLE,25,32,40,35,0,132,IND,36,27,18,36,0,117
2/9/2017,CLE,21,36,25,27,0,109,OKC,29,26,31,32,0,118
2/11/2017,DEN,33,22,23,31,0,109,CLE,28,31,33,33,0,125
2/14/2017,CLE,26,43,24,23,0,116,MIN,30,31,32,15,0,108
2/15/2017,IND,32,22,26,24,0,104,CLE,28,29,26,30,0,113
2/23/2017,NYK,33,18,28,25,0,104,CLE,34,35,18,32,0,119
2/25/2017,CHI,23,32,34,28,0,117,CLE,22,34,20,23,0,99
2/27/2017,MIL,25,25,23,22,0,95,CLE,27,25,25,25,0,102
3/1/2017,CLE,26,24,21,28,0,99,BOS,20,29,25,29,0,103
3/3/2017,CLE,39,38,29,29,0,135,ATL,33,27,28,42,0,130
3/4/2017,CLE,35,16,24,17,0,92,MIA,35,32,34,19,0,120
3/6/2017,MIA,29,33,27,17,0,106,CLE,22,30,19,27,0,98
3/9/2017,CLE,29,23,28,21,0,101,DET,22,33,18,33,0,106
3/11/2017,CLE,24,35,28,29,0,116,ORL,25,26,28,25,0,104
3/12/2017,CLE,26,41,19,26,0,112,HOU,33,25,32,27,0,117
3/14/2017,DET,26,22,22,26,0,96,CLE,44,30,30,24,0,128
3/16/2017,UTA,20,22,25,16,0,83,CLE,29,15,23,24,0,91
3/18/2017,CLE,16,15,27,20,0,78,LAC,14,33,29,32,0,108
3/19/2017,CLE,31,24,27,43,0,125,LAL,28,31,33,28,0,120
3/22/2017,CLE,31,28,31,23,0,113,DEN,34,39,28,25,0,126
3/24/2017,CLE,33,26,31,22,0,112,CHO,31,22,32,20,0,105
3/25/2017,WAS,40,31,25,31,0,127,CLE,26,35,30,24,0,115
3/27/2017,CLE,18,22,18,16,0,74,SAS,28,36,17,22,0,103
3/30/2017,CLE,28,22,21,22,0,93,CHI,22,19,37,21,0,99
3/31/2017,PHI,29,23,25,28,0,105,CLE,32,38,34,18,0,122
4/2/2017,IND,27,26,24,27,10,130,CLE,26,34,23,21,10,135
4/4/2017,ORL,31,24,20,27,0,102,CLE,28,25,43,26,0,122
4/5/2017,CLE,19,38,33,24,0,114,BOS,20,22,24,25,0,91
4/7/2017,ATL,21,31,31,31,0,114,CLE,19,31,28,22,0,100
4/9/2017,CLE,38,27,28,18,14,125,ATL,21,25,21,44,15,126
4/10/2017,CLE,37,23,31,17,13,121,MIA,24,32,24,28,16,124
4/12/2017,TOR,26,27,22,23,0,98,CLE,21,13,24,25,0,83
10/26/2016,BRK,31,27,23,36,0,117,BOS,33,31,33,25,0,122
10/27/2016,BOS,20,29,24,26,0,99,CHI,30,27,22,26,0,105
10/29/2016,BOS,28,16,27,33,0,104,CHO,19,22,31,26,0,98
11/2/2016,CHI,25,27,18,30,0,100,BOS,36,19,26,26,0,107
11/3/2016,BOS,25,26,32,39,0,122,CLE,36,32,32,28,0,128
11/6/2016,DEN,42,35,26,20,0,123,BOS,23,29,31,24,0,107
11/9/2016,BOS,8,35,26,24,0,93,WAS,34,24,31,29,0,118
11/11/2016,NYK,27,24,22,14,0,87,BOS,31,30,25,29,0,115
11/12/2016,BOS,24,24,31,26,0,105,IND,31,14,31,23,0,99
11/14/2016,BOS,26,25,23,31,0,105,NOP,27,29,28,22,0,106
11/16/2016,DAL,17,14,23,29,0,83,BOS,29,10,18,33,0,90
11/18/2016,GSW,29,26,31,18,0,104,BOS,27,21,9,31,0,88
11/19/2016,BOS,30,20,21,23,0,94,DET,23,24,26,19,0,92
11/21/2016,BOS,23,19,26,31,0,99,MIN,21,31,29,12,0,93
11/23/2016,BOS,30,21,28,32,0,111,BRK,16,33,17,26,0,92
11/25/2016,SAS,22,24,29,34,0,109,BOS,32,16,26,29,0,103
11/28/2016,BOS,21,27,35,29,0,112,MIA,19,12,42,31,0,104
11/30/2016,DET,31,28,33,29,0,121,BOS,28,25,31,30,0,114
12/2/2016,SAC,29,17,26,20,0,92,BOS,29,18,22,28,0,97
12/3/2016,BOS,22,23,29,33,0,107,PHI,30,23,21,32,0,106
12/5/2016,BOS,17,31,35,23,0,106,HOU,26,32,19,30,0,107
12/7/2016,BOS,26,23,36,32,0,117,ORL,27,23,23,14,0,87
12/9/2016,TOR,25,17,33,26,0,101,BOS,28,22,18,26,0,94
12/11/2016,BOS,24,19,28,25,0,96,OKC,21,18,28,32,0,99
12/14/2016,BOS,23,24,26,28,0,101,SAS,32,24,21,31,0,108
12/16/2016,CHO,22,28,19,19,0,88,BOS,23,18,28,27,0,96
12/18/2016,BOS,37,21,19,28,0,105,MIA,19,22,30,24,0,95
12/20/2016,BOS,15,16,31,35,15,112,MEM,22,23,26,26,12,109
12/22/2016,BOS,22,29,26,32,0,109,IND,31,9,27,35,0,102
12/23/2016,OKC,25,33,30,29,0,117,BOS,28,26,25,33,0,112
12/25/2016,BOS,22,34,32,31,0,119,NYK,28,20,34,32,0,114
12/27/2016,MEM,24,24,29,26,0,103,BOS,28,28,28,29,0,113
12/29/2016,BOS,25,34,24,35,0,118,CLE,32,34,35,23,0,124
12/30/2016,MIA,25,23,30,36,0,114,BOS,25,27,30,35,0,117
1/3/2017,UTA,29,16,29,30,0,104,BOS,28,26,31,30,0,115
1/6/2017,PHI,23,39,18,26,0,106,BOS,25,26,27,32,0,110
1/7/2017,NOP,31,22,20,35,0,108,BOS,28,29,36,24,0,117
1/10/2017,BOS,18,37,29,22,0,106,TOR,23,23,34,34,0,114
1/11/2017,WAS,35,24,26,23,0,108,BOS,36,19,28,34,0,117
1/13/2017,BOS,28,20,30,25,0,103,ATL,18,26,21,36,0,101
1/16/2017,CHO,30,23,18,27,0,98,BOS,34,25,21,28,0,108
1/18/2017,NYK,31,32,25,29,0,117,BOS,34,20,29,23,0,106
1/21/2017,POR,26,30,32,25,14,127,BOS,28,37,21,27,10,123
1/24/2017,BOS,24,35,21,28,0,108,WAS,33,33,25,32,0,123
1/25/2017,HOU,27,31,28,23,0,109,BOS,24,28,36,32,0,120
1/27/2017,ORL,24,24,17,33,0,98,BOS,39,29,36,24,0,128
1/28/2017,BOS,42,22,17,21,10,112,MIL,27,26,20,29,6,108
1/30/2017,DET,25,21,24,39,0,109,BOS,26,28,25,34,0,113
2/1/2017,TOR,30,32,23,19,0,104,BOS,28,23,26,32,0,109
2/3/2017,LAL,30,21,23,33,0,107,BOS,29,33,20,31,0,113
2/5/2017,LAC,19,28,20,35,0,102,BOS,29,27,25,26,0,107
2/8/2017,BOS,28,21,22,21,0,92,SAC,19,30,28,31,0,108
2/9/2017,BOS,22,27,28,43,0,120,POR,32,23,21,35,0,111
2/11/2017,BOS,33,25,19,35,0,112,UTA,23,21,21,39,0,104
2/13/2017,BOS,30,31,22,28,0,111,DAL,28,22,32,16,0,98
2/15/2017,PHI,29,32,18,29,0,108,BOS,29,32,26,29,0,116
2/16/2017,BOS,25,33,20,25,0,103,CHI,22,30,29,23,0,104
2/24/2017,BOS,29,26,22,20,0,97,TOR,18,27,29,33,0,107
2/26/2017,BOS,27,27,25,25,0,104,DET,23,27,24,24,0,98
2/27/2017,ATL,24,27,33,30,0,114,BOS,24,23,24,27,0,98
3/1/2017,CLE,26,24,21,28,0,99,BOS,20,29,25,29,0,103
3/3/2017,BOS,35,35,23,22,0,115,LAL,26,19,33,17,0,95
3/5/2017,BOS,22,20,35,29,0,106,PHO,19,30,32,28,0,109
3/6/2017,BOS,25,21,25,31,0,102,LAC,22,21,32,41,0,116
3/8/2017,BOS,25,21,26,27,0,99,GSW,28,22,24,12,0,86
3/10/2017,BOS,25,29,26,19,0,99,DEN,35,30,29,25,0,119
3/12/2017,CHI,9,17,31,23,0,80,BOS,22,24,30,24,0,100
3/15/2017,MIN,32,28,17,27,0,104,BOS,30,28,27,32,0,117
3/17/2017,BOS,21,24,26,27,0,98,BRK,16,21,28,30,0,95
3/19/2017,BOS,23,28,28,20,0,99,PHI,25,21,30,29,0,105
3/20/2017,WAS,28,19,28,27,0,102,BOS,30,28,34,18,0,110
3/22/2017,IND,19,23,32,26,0,100,BOS,21,28,39,21,0,109
3/24/2017,PHO,16,27,37,40,0,120,BOS,29,37,31,33,0,130
3/26/2017,MIA,27,31,17,33,0,108,BOS,22,31,32,27,0,112
3/29/2017,MIL,24,31,25,23,0,103,BOS,24,25,28,23,0,100
3/31/2017,ORL,29,35,26,26,0,116,BOS,31,26,35,25,0,117
4/2/2017,BOS,34,26,28,22,0,110,NYK,23,24,24,23,0,94
4/5/2017,CLE,19,38,33,24,0,114,BOS,20,22,24,25,0,91
4/6/2017,BOS,24,31,34,27,0,116,ATL,32,39,28,24,0,123
4/8/2017,BOS,32,39,21,29,0,121,CHO,28,26,32,28,0,114
4/10/2017,BRK,13,27,37,28,0,105,BOS,28,30,32,24,0,114
4/12/2017,MIL,36,20,22,16,0,94,BOS,25,32,23,32,0,112
10/27/2016,WAS,27,29,24,19,0,99,ATL,29,28,24,33,0,114
10/30/2016,WAS,22,32,23,23,3,103,MEM,27,31,20,22,12,112
11/2/2016,TOR,27,27,30,29,0,113,WAS,29,27,19,28,0,103
11/4/2016,ATL,19,16,28,29,0,92,WAS,19,29,23,24,0,95
11/5/2016,WAS,24,26,20,16,0,86,ORL,20,20,21,27,0,88
11/7/2016,HOU,23,33,28,30,0,114,WAS,30,17,36,23,0,106
11/9/2016,BOS,8,35,26,24,0,93,WAS,34,24,31,29,0,118
11/11/2016,CLE,26,32,26,21,0,105,WAS,31,25,19,19,0,94
11/12/2016,WAS,27,29,14,25,0,95,CHI,28,25,28,25,0,106
11/16/2016,WAS,15,33,28,26,0,102,PHI,29,30,29,21,0,109
11/17/2016,NYK,18,24,23,47,0,112,WAS,24,28,35,32,0,119
11/19/2016,MIA,33,27,31,23,0,114,WAS,35,24,23,29,0,111
11/21/2016,PHO,20,26,34,21,0,101,WAS,26,24,25,31,0,106
11/25/2016,WAS,26,22,24,22,0,94,ORL,14,24,30,23,0,91
11/26/2016,SAS,23,31,36,22,0,112,WAS,22,22,32,24,0,100
11/28/2016,SAC,19,34,19,20,3,95,WAS,25,25,24,18,9,101
11/30/2016,WAS,19,34,31,21,10,115,OKC,32,28,24,21,21,126
12/2/2016,WAS,28,32,14,31,0,105,SAS,24,33,23,27,0,107
12/5/2016,WAS,29,22,32,35,0,118,BRK,32,34,15,32,0,113
12/6/2016,ORL,25,40,31,28,0,124,WAS,24,28,29,35,0,116
12/8/2016,DEN,29,23,21,12,0,85,WAS,18,29,28,17,0,92
12/10/2016,MIL,32,20,25,28,0,105,WAS,23,29,25,33,0,110
12/12/2016,WAS,29,24,29,19,0,101,MIA,28,31,22,31,0,112
12/14/2016,CHO,30,24,23,29,0,106,WAS,26,23,38,22,0,109
12/16/2016,DET,27,27,23,31,0,108,WAS,27,38,30,27,0,122
12/18/2016,LAC,27,28,32,23,0,110,WAS,28,24,33,32,0,117
12/19/2016,WAS,36,21,22,26,0,105,IND,29,28,31,19,0,107
12/21/2016,WAS,22,33,22,30,0,107,CHI,33,23,21,20,0,97
12/23/2016,WAS,29,29,20,18,0,96,MIL,37,36,27,23,0,123
12/26/2016,MIL,27,30,27,18,0,102,WAS,28,25,29,25,0,107
12/28/2016,IND,25,23,26,31,0,105,WAS,23,35,27,26,0,111
12/30/2016,BRK,23,27,27,18,0,95,WAS,31,35,25,27,0,118
1/2/2017,WAS,29,24,17,21,0,91,HOU,14,27,37,23,0,101
1/3/2017,WAS,29,38,21,17,0,105,DAL,28,33,26,26,0,113
1/6/2017,MIN,29,19,37,20,0,105,WAS,32,24,24,32,0,112
1/8/2017,WAS,24,25,33,25,0,107,MIL,31,26,21,23,0,101
1/10/2017,CHI,36,25,16,22,0,99,WAS,26,23,32,20,0,101
1/11/2017,WAS,35,24,26,23,0,108,BOS,36,19,28,34,0,117
1/14/2017,PHI,30,26,15,22,0,93,WAS,21,35,30,23,0,109
1/16/2017,POR,21,29,27,24,0,101,WAS,37,38,26,19,0,120
1/18/2017,MEM,24,27,26,24,0,101,WAS,30,36,17,21,0,104
1/19/2017,WAS,38,28,34,13,0,113,NYK,27,40,19,24,0,110
1/21/2017,WAS,26,29,27,30,0,112,DET,30,31,37,15,0,113
1/23/2017,WAS,30,30,20,29,0,109,CHO,22,26,26,25,0,99
1/24/2017,BOS,24,35,21,28,0,108,WAS,33,33,25,32,0,123
1/27/2017,WAS,37,30,26,19,0,112,ATL,25,20,23,18,0,86
1/29/2017,WAS,29,28,17,33,0,107,NOP,23,17,33,21,0,94
1/31/2017,NYK,28,26,22,25,0,101,WAS,28,31,32,26,0,117
2/2/2017,LAL,29,15,35,29,0,108,WAS,31,27,32,26,0,116
2/4/2017,NOP,18,31,34,8,0,91,WAS,24,29,27,25,0,105
2/6/2017,CLE,26,28,32,34,20,140,WAS,32,25,25,38,15,135
2/8/2017,WAS,31,28,20,21,14,114,BRK,22,27,23,28,10,110
2/10/2017,IND,27,32,22,26,0,107,WAS,33,26,27,26,0,112
2/13/2017,OKC,32,22,19,25,0,98,WAS,38,29,34,19,0,120
2/16/2017,WAS,34,28,28,21,0,111,IND,27,25,25,21,0,98
2/24/2017,WAS,28,21,32,31,0,112,PHI,26,35,34,25,0,120
2/26/2017,UTA,24,25,24,29,0,102,WAS,24,15,21,32,0,92
2/28/2017,GSW,26,23,36,23,0,108,WAS,40,21,24,27,0,112
3/1/2017,WAS,24,38,20,23,0,105,TOR,26,20,14,36,0,96
3/3/2017,TOR,35,27,17,35,0,114,WAS,27,26,25,28,0,106
3/5/2017,ORL,28,33,29,24,0,114,WAS,25,20,34,36,0,115
3/7/2017,WAS,38,30,26,37,0,131,PHO,25,36,31,35,0,127
3/8/2017,WAS,35,32,30,26,0,123,DEN,28,22,35,28,0,113
3/10/2017,WAS,28,28,26,34,14,130,SAC,32,36,29,19,6,122
3/11/2017,WAS,30,19,33,30,13,125,POR,36,34,21,21,12,124
3/13/2017,WAS,23,33,24,24,0,104,MIN,41,23,25,30,0,119
3/15/2017,DAL,32,21,20,39,0,112,WAS,39,18,23,27,0,107
3/17/2017,CHI,23,17,32,35,0,107,WAS,29,30,25,28,0,112
3/18/2017,WAS,20,20,21,32,0,93,CHO,19,20,25,34,0,98
3/20/2017,WAS,28,19,28,27,0,102,BOS,30,28,34,18,0,110
3/22/2017,ATL,20,26,21,33,0,100,WAS,16,24,27,37,0,104
3/24/2017,BRK,22,20,39,27,0,108,WAS,31,32,34,32,0,129
3/25/2017,WAS,40,31,25,31,0,127,CLE,26,35,30,24,0,115
3/28/2017,WAS,27,28,27,37,0,119,LAL,27,31,37,13,0,108
3/29/2017,WAS,31,32,35,26,0,124,LAC,39,35,36,23,0,133
3/31/2017,WAS,19,20,22,27,0,88,UTA,24,18,22,31,0,95
4/2/2017,WAS,30,27,31,27,0,115,GSW,35,32,39,33,0,139
4/4/2017,CHO,24,39,18,30,0,111,WAS,22,29,36,31,0,118
4/6/2017,WAS,33,26,23,24,0,106,NYK,27,24,24,28,0,103
4/8/2017,MIA,28,24,26,28,0,106,WAS,29,23,22,29,0,103
4/10/2017,WAS,34,21,24,26,0,105,DET,21,21,31,28,0,101
4/12/2017,WAS,27,23,27,25,0,102,MIA,23,33,35,19,0,110
10/26/2016,CHO,32,24,27,24,0,107,MIL,24,17,25,30,0,96
10/28/2016,CHO,21,25,27,24,0,97,MIA,23,34,20,14,0,91
10/29/2016,BOS,28,16,27,33,0,104,CHO,19,22,31,26,0,98
11/2/2016,PHI,26,27,20,20,0,93,CHO,26,20,39,24,0,109
11/4/2016,CHO,23,20,30,26,0,99,BRK,23,27,20,25,0,95
11/7/2016,IND,34,21,23,22,0,100,CHO,43,32,24,23,0,122
11/9/2016,UTA,32,26,20,20,0,98,CHO,24,27,25,28,0,104
11/11/2016,TOR,28,30,21,34,0,113,CHO,27,17,38,29,0,111
11/13/2016,CHO,22,32,18,21,0,93,CLE,32,20,19,29,0,100
11/15/2016,CHO,31,15,36,33,0,115,MIN,30,28,17,33,0,108
11/18/2016,ATL,28,17,35,16,0,96,CHO,29,19,27,25,0,100
11/19/2016,CHO,23,23,39,23,8,116,NOP,21,26,27,34,13,121
11/21/2016,MEM,32,37,15,21,0,105,CHO,22,23,26,19,0,90
11/23/2016,SAS,30,29,25,35,0,119,CHO,28,32,24,30,0,114
11/25/2016,CHO,28,28,18,30,7,111,NYK,30,22,27,25,9,113
11/26/2016,NYK,22,25,24,31,0,102,CHO,38,20,17,32,0,107
11/28/2016,CHO,25,31,25,23,0,104,MEM,25,14,21,25,0,85
11/29/2016,DET,33,24,27,28,0,112,CHO,25,29,20,15,0,89
12/1/2016,DAL,14,27,19,27,0,87,CHO,23,21,24,29,0,97
12/3/2016,MIN,19,30,25,32,19,125,CHO,29,23,32,22,14,120
12/5/2016,CHO,23,25,27,34,0,109,DAL,23,27,28,23,0,101
12/7/2016,DET,24,15,19,19,0,77,CHO,23,15,23,26,0,87
12/9/2016,ORL,21,25,24,18,0,88,CHO,20,32,39,18,0,109
12/10/2016,CHO,26,26,29,24,0,105,CLE,36,31,25,24,0,116
12/12/2016,CHO,20,23,30,21,0,94,IND,25,20,31,34,0,110
12/14/2016,CHO,30,24,23,29,0,106,WAS,26,23,38,22,0,109
12/16/2016,CHO,22,28,19,19,0,88,BOS,23,18,28,27,0,96
12/17/2016,CHO,22,31,27,27,0,107,ATL,22,20,32,25,0,99
12/20/2016,LAL,41,32,23,17,0,113,CHO,35,24,35,23,0,117
12/23/2016,CHI,26,14,27,24,0,91,CHO,22,26,27,28,0,103
12/26/2016,CHO,40,23,25,30,0,118,BRK,31,23,29,37,0,120
12/28/2016,CHO,32,30,35,23,0,120,ORL,28,27,13,33,0,101
12/29/2016,MIA,19,30,17,16,0,82,CHO,21,21,31,18,0,91
12/31/2016,CLE,35,36,28,22,0,121,CHO,28,31,23,27,0,109
1/2/2017,CHO,23,34,28,26,0,111,CHI,25,33,24,36,0,118
1/4/2017,OKC,22,33,33,24,0,112,CHO,27,33,27,36,0,123
1/5/2017,CHO,26,22,22,44,0,114,DET,37,21,27,30,0,115
1/7/2017,CHO,24,26,14,21,0,85,SAS,24,23,26,29,0,102
1/10/2017,CHO,26,21,32,35,0,114,HOU,32,35,29,25,0,121
1/13/2017,CHO,21,24,26,22,0,93,PHI,26,26,24,26,0,102
1/16/2017,CHO,30,23,18,27,0,98,BOS,34,25,21,28,0,108
1/18/2017,POR,26,20,26,13,0,85,CHO,23,31,25,28,0,107
1/20/2017,TOR,18,30,15,15,0,78,CHO,26,29,33,25,0,113
1/21/2017,BRK,14,32,35,24,0,105,CHO,28,32,21,31,0,112
1/23/2017,WAS,30,30,20,29,0,109,CHO,22,26,26,25,0,99
1/25/2017,GSW,29,24,22,38,0,113,CHO,28,19,33,23,0,103
1/27/2017,CHO,23,28,36,20,0,107,NYK,29,25,28,28,0,110
1/28/2017,SAC,24,28,33,24,0,109,CHO,22,22,33,29,0,106
1/31/2017,CHO,23,27,18,30,0,98,POR,28,28,30,29,0,115
2/1/2017,CHO,21,35,27,28,0,111,GSW,41,36,31,18,0,126
2/4/2017,CHO,28,16,38,16,0,98,UTA,23,29,21,32,0,105
2/7/2017,BRK,16,21,35,35,0,107,CHO,24,30,27,30,0,111
2/9/2017,HOU,23,27,36,21,0,107,CHO,29,25,22,19,0,95
2/11/2017,LAC,29,24,24,30,0,107,CHO,27,24,19,32,0,102
2/13/2017,PHI,31,17,32,25,0,105,CHO,22,25,25,27,0,99
2/15/2017,CHO,20,21,34,10,0,85,TOR,31,13,14,32,0,90
2/23/2017,CHO,28,34,23,15,8,108,DET,23,27,20,30,14,114
2/25/2017,CHO,24,27,28,20,0,99,SAC,19,21,18,27,0,85
2/26/2017,CHO,24,27,29,33,8,121,LAC,32,27,25,29,11,124
2/28/2017,CHO,27,31,22,29,0,109,LAL,31,24,27,22,0,104
3/2/2017,CHO,32,26,33,12,0,103,PHO,28,33,33,26,0,120
3/4/2017,CHO,31,30,29,22,0,112,DEN,23,29,27,23,0,102
3/6/2017,IND,16,21,29,22,0,88,CHO,27,31,16,26,0,100
3/8/2017,CHO,22,32,32,15,0,101,MIA,18,36,27,27,0,108
3/10/2017,ORL,24,16,22,19,0,81,CHO,37,21,30,33,0,121
3/11/2017,NOP,32,27,24,29,13,125,CHO,27,31,20,34,10,122
3/13/2017,CHI,36,22,29,28,0,115,CHO,24,24,29,32,0,109
3/15/2017,CHO,22,20,16,19,0,77,IND,24,18,33,23,0,98
3/18/2017,WAS,20,20,21,32,0,93,CHO,19,20,25,34,0,98
3/20/2017,ATL,19,23,26,22,0,90,CHO,19,32,32,22,0,105
3/22/2017,CHO,21,27,29,32,0,109,ORL,27,27,28,20,0,102
3/24/2017,CLE,33,26,31,22,0,112,CHO,31,22,32,20,0,105
3/26/2017,PHO,18,29,33,26,0,106,CHO,38,31,29,22,0,120
3/28/2017,MIL,35,37,22,24,0,118,CHO,24,26,26,32,0,108
3/29/2017,CHO,22,28,16,44,0,110,TOR,19,28,27,32,0,106
3/31/2017,DEN,32,24,38,20,0,114,CHO,24,32,30,36,0,122
4/2/2017,CHO,31,28,25,29,0,113,OKC,22,32,16,31,0,101
4/4/2017,CHO,24,39,18,30,0,111,WAS,22,29,36,31,0,118
4/5/2017,MIA,27,25,34,26,0,112,CHO,23,28,22,26,0,99
4/8/2017,BOS,32,39,21,29,0,121,CHO,28,26,32,28,0,114
4/10/2017,CHO,24,22,20,13,0,79,MIL,18,25,18,28,0,89
4/11/2017,CHO,26,18,17,15,0,76,ATL,38,25,21,19,0,103
10/26/2016,MIN,32,27,16,23,0,98,MEM,29,21,26,26,0,102
10/29/2016,MIN,34,31,12,26,0,103,SAC,25,29,31,21,0,106
11/1/2016,MEM,16,20,23,21,0,80,MIN,29,33,35,19,0,116
11/3/2016,DEN,25,30,33,14,0,102,MIN,37,24,14,24,0,99
11/5/2016,MIN,25,28,19,20,0,92,OKC,32,27,31,22,0,112
11/8/2016,MIN,33,32,19,26,0,110,BRK,33,33,22,31,0,119
11/9/2016,MIN,39,35,23,26,0,123,ORL,17,30,30,30,0,107
11/12/2016,LAC,34,26,28,31,0,119,MIN,21,30,22,32,0,105
11/13/2016,LAL,27,19,26,27,0,99,MIN,36,33,18,38,0,125
11/15/2016,CHO,31,15,36,33,0,115,MIN,30,28,17,33,0,108
11/17/2016,PHI,18,15,25,28,0,86,MIN,27,34,24,25,0,110
11/19/2016,MIN,16,23,13,19,0,71,MEM,18,25,22,28,0,93
11/21/2016,BOS,23,19,26,31,0,99,MIN,21,31,29,12,0,93
11/23/2016,MIN,26,24,18,28,0,96,NOP,31,22,36,28,0,117
11/25/2016,MIN,29,18,20,31,0,98,PHO,27,25,23,10,0,85
11/26/2016,MIN,33,15,25,29,0,102,GSW,30,26,34,25,0,115
11/28/2016,UTA,22,28,24,38,0,112,MIN,27,18,24,34,0,103
11/30/2016,NYK,28,30,23,25,0,106,MIN,31,18,25,30,0,104
12/2/2016,MIN,21,31,36,26,0,114,NYK,30,32,36,20,0,118
12/3/2016,MIN,19,30,25,32,19,125,CHO,29,23,32,22,14,120
12/6/2016,SAS,19,24,29,33,0,105,MIN,22,24,18,27,0,91
12/8/2016,MIN,32,27,30,21,0,110,TOR,22,37,29,36,0,124
12/9/2016,DET,25,24,33,35,0,117,MIN,20,23,25,22,0,90
12/11/2016,GSW,30,30,18,38,0,116,MIN,27,31,30,20,0,108
12/13/2016,MIN,22,30,26,21,0,99,CHI,38,18,19,19,0,94
12/17/2016,HOU,28,16,23,28,16,111,MIN,24,33,23,15,14,109
12/19/2016,PHO,23,31,33,21,0,108,MIN,29,33,29,24,0,115
12/21/2016,MIN,28,21,18,25,0,92,ATL,26,18,25,15,0,84
12/23/2016,SAC,25,26,27,31,0,109,MIN,26,29,30,20,0,105
12/25/2016,MIN,27,26,22,25,0,100,OKC,23,34,29,26,0,112
12/26/2016,ATL,25,20,20,25,0,90,MIN,23,31,35,15,0,104
12/28/2016,MIN,31,18,24,30,0,103,DEN,22,27,32,24,0,105
12/30/2016,MIL,21,27,23,28,0,99,MIN,34,21,30,31,0,116
1/1/2017,POR,24,13,32,26,0,95,MIN,23,26,15,25,0,89
1/3/2017,MIN,16,26,26,23,0,91,PHI,29,28,22,14,0,93
1/6/2017,MIN,29,19,37,20,0,105,WAS,32,24,24,32,0,112
1/7/2017,UTA,25,22,22,25,0,94,MIN,24,24,32,12,0,92
1/9/2017,DAL,19,27,24,22,0,92,MIN,33,21,23,24,0,101
1/11/2017,HOU,23,31,23,28,0,105,MIN,30,25,34,30,0,119
1/13/2017,OKC,28,22,18,18,0,86,MIN,30,15,29,22,0,96
1/15/2017,MIN,25,22,23,17,0,87,DAL,27,29,23,19,0,98
1/17/2017,MIN,30,41,19,24,0,114,SAS,30,37,25,30,0,122
1/19/2017,MIN,25,19,33,27,0,104,LAC,22,29,28,22,0,101
1/22/2017,DEN,29,29,26,24,0,108,MIN,28,34,22,27,0,111
1/24/2017,MIN,23,36,28,25,0,112,PHO,27,29,23,32,0,111
1/26/2017,IND,25,27,24,33,0,109,MIN,20,26,24,33,0,103
1/28/2017,BRK,26,29,23,31,0,109,MIN,33,30,29,37,0,129
1/30/2017,ORL,23,28,28,19,7,105,MIN,26,26,28,18,13,111
2/1/2017,MIN,32,28,19,18,0,97,CLE,36,27,30,32,0,125
2/3/2017,MIN,18,34,24,32,0,108,DET,24,29,30,33,0,116
2/4/2017,MEM,15,33,21,38,0,107,MIN,31,17,19,32,0,99
2/6/2017,MIA,40,31,22,22,0,115,MIN,33,24,31,25,0,113
2/8/2017,TOR,33,30,25,21,0,109,MIN,25,28,30,29,0,112
2/10/2017,NOP,28,33,37,24,0,122,MIN,40,25,24,17,0,106
2/12/2017,CHI,17,23,25,24,0,89,MIN,34,23,27,33,0,117
2/14/2017,CLE,26,43,24,23,0,116,MIN,30,31,32,15,0,108
2/15/2017,MIN,32,30,23,27,0,112,DEN,31,29,19,20,0,99
2/24/2017,DAL,22,18,23,21,0,84,MIN,26,23,22,26,0,97
2/25/2017,MIN,28,30,30,42,0,130,HOU,35,31,40,36,0,142
2/27/2017,MIN,20,40,17,25,0,102,SAC,25,19,21,23,0,88
3/1/2017,MIN,21,30,30,26,0,107,UTA,16,19,18,27,0,80
3/4/2017,MIN,26,29,15,13,7,90,SAS,14,29,19,21,14,97
3/8/2017,LAC,19,36,13,23,0,91,MIN,31,27,24,25,0,107
3/10/2017,GSW,24,29,23,26,0,102,MIN,34,28,26,15,0,103
3/11/2017,MIN,19,29,27,20,0,95,MIL,23,25,28,26,0,102
3/13/2017,WAS,23,33,24,24,0,104,MIN,41,23,25,30,0,119
3/15/2017,MIN,32,28,17,27,0,104,BOS,30,28,27,32,0,117
3/17/2017,MIN,23,26,32,24,0,105,MIA,27,37,26,33,0,123
3/19/2017,MIN,34,20,30,25,0,109,NOP,28,20,40,35,0,123
3/21/2017,SAS,25,17,31,27,0,100,MIN,23,28,16,26,0,93
3/24/2017,MIN,27,40,21,21,10,119,LAL,26,28,26,29,21,130
3/25/2017,MIN,21,25,28,26,0,100,POR,27,33,34,18,0,112
3/28/2017,MIN,26,33,28,28,0,115,IND,25,32,33,24,0,114
3/30/2017,LAL,37,23,22,22,0,104,MIN,37,30,29,23,0,119
4/1/2017,SAC,18,37,36,32,0,123,MIN,31,28,26,32,0,117
4/3/2017,POR,23,34,26,26,0,109,MIN,29,20,37,24,0,110
4/4/2017,MIN,32,28,26,21,0,107,GSW,32,36,36,17,0,121
4/6/2017,MIN,34,27,26,11,0,98,POR,20,33,27,25,0,105
4/7/2017,MIN,31,29,28,25,0,113,UTA,29,26,40,25,0,120
4/9/2017,MIN,21,30,28,30,0,109,LAL,29,24,25,32,0,110
4/11/2017,OKC,33,23,15,29,0,100,MIN,16,27,29,26,0,98
4/12/2017,MIN,32,28,21,37,0,118,HOU,33,27,35,28,0,123
10/26/2016,DAL,21,31,33,30,6,121,IND,33,26,35,21,15,130
10/28/2016,HOU,24,28,25,29,0,106,DAL,24,26,17,31,0,98
10/30/2016,DAL,25,28,17,22,0,92,HOU,34,29,17,13,0,93
11/2/2016,DAL,14,19,26,22,0,81,UTA,15,26,25,31,0,97
11/4/2016,POR,26,29,24,26,0,105,DAL,26,26,24,19,0,95
11/6/2016,MIL,27,12,17,18,1,75,DAL,19,28,12,15,12,86
11/8/2016,DAL,25,33,25,26,0,109,LAL,27,27,23,20,0,97
11/9/2016,DAL,15,21,32,27,0,95,GSW,34,33,17,32,0,116
11/14/2016,DAL,23,16,12,26,0,77,NYK,15,21,31,26,0,93
11/16/2016,DAL,17,14,23,29,0,83,BOS,29,10,18,33,0,90
11/18/2016,MEM,19,17,20,24,0,80,DAL,19,10,12,23,0,64
11/19/2016,DAL,16,29,24,18,0,87,ORL,17,27,22,29,0,95
11/21/2016,DAL,28,21,24,18,0,91,SAS,24,24,25,23,0,96
11/23/2016,LAC,32,36,25,31,0,124,DAL,26,19,25,34,0,104
11/25/2016,DAL,16,22,17,35,0,90,CLE,36,36,24,32,0,128
11/27/2016,NOP,20,22,18,21,0,81,DAL,26,18,16,31,0,91
11/30/2016,SAS,21,22,18,33,0,94,DAL,17,23,26,21,0,87
12/1/2016,DAL,14,27,19,27,0,87,CHO,23,21,24,29,0,97
12/3/2016,CHI,18,27,21,16,0,82,DAL,29,28,25,25,0,107
12/5/2016,CHO,23,25,27,34,0,109,DAL,23,27,28,23,0,101
12/7/2016,SAC,26,30,29,35,0,120,DAL,23,29,12,25,0,89
12/9/2016,IND,27,25,25,26,0,103,DAL,25,29,31,26,0,111
12/10/2016,DAL,27,22,20,18,0,87,HOU,36,24,26,23,0,109
12/12/2016,DEN,19,24,24,25,0,92,DAL,27,38,27,20,0,112
12/14/2016,DET,17,26,17,35,0,95,DAL,20,23,21,21,0,85
12/16/2016,DAL,29,29,19,23,0,100,UTA,33,31,26,13,0,103
12/18/2016,SAC,21,23,14,21,0,79,DAL,28,27,21,23,0,99
12/19/2016,DAL,31,27,27,22,0,107,DEN,28,32,33,24,0,117
12/21/2016,DAL,30,32,19,15,0,96,POR,20,18,33,24,0,95
12/23/2016,DAL,21,29,18,22,0,90,LAC,24,27,21,16,0,88
12/26/2016,DAL,20,33,24,27,0,104,NOP,25,30,30,26,0,111
12/27/2016,HOU,31,35,32,25,0,123,DAL,31,16,27,33,0,107
12/29/2016,DAL,26,24,31,20,0,101,LAL,27,30,13,19,0,89
12/30/2016,DAL,29,19,21,30,0,99,GSW,29,30,32,17,0,108
1/3/2017,WAS,29,38,21,17,0,105,DAL,28,33,26,26,0,113
1/5/2017,PHO,19,22,29,32,0,102,DAL,22,23,27,23,0,95
1/7/2017,ATL,22,23,21,31,0,97,DAL,20,22,17,23,0,82
1/9/2017,DAL,19,27,24,22,0,92,MIN,33,21,23,24,0,101
1/12/2017,DAL,32,25,31,25,0,113,PHO,29,30,17,32,0,108
1/15/2017,MIN,25,22,23,17,0,87,DAL,27,29,23,19,0,98
1/17/2017,DAL,24,30,22,23,0,99,CHI,28,19,27,24,0,98
1/19/2017,DAL,22,31,20,22,0,95,MIA,29,15,26,29,0,99
1/20/2017,UTA,19,27,26,26,14,112,DAL,22,19,27,30,9,107
1/22/2017,LAL,22,11,22,18,0,73,DAL,29,38,23,32,0,122
1/25/2017,NYK,25,26,22,22,0,95,DAL,30,22,26,25,0,103
1/26/2017,DAL,26,29,18,25,0,98,OKC,23,30,34,22,0,109
1/29/2017,DAL,27,22,28,28,0,105,SAS,28,31,22,20,0,101
1/30/2017,CLE,29,21,20,27,0,97,DAL,26,29,26,23,0,104
2/1/2017,PHI,23,24,22,26,0,95,DAL,20,30,31,32,0,113
2/3/2017,DAL,35,25,24,24,0,108,POR,22,25,29,28,0,104
2/6/2017,DAL,24,13,30,20,0,87,DEN,29,30,23,28,0,110
2/7/2017,POR,32,32,22,28,0,114,DAL,27,26,29,31,0,113
2/9/2017,UTA,23,31,24,22,5,105,DAL,20,22,26,32,12,112
2/11/2017,ORL,23,12,17,28,0,80,DAL,29,32,23,28,0,112
2/13/2017,BOS,30,31,22,28,0,111,DAL,28,22,32,16,0,98
2/15/2017,DAL,17,18,28,28,0,91,DET,27,35,16,20,0,98
2/24/2017,DAL,22,18,23,21,0,84,MIN,26,23,22,26,0,97
2/25/2017,NOP,30,19,14,20,0,83,DAL,24,23,20,29,0,96
2/27/2017,MIA,31,23,15,20,0,89,DAL,22,33,23,18,0,96
3/1/2017,DAL,22,30,24,19,0,95,ATL,27,36,18,19,0,100
3/3/2017,MEM,22,28,22,28,0,100,DAL,20,31,28,25,0,104
3/5/2017,OKC,27,23,21,18,0,89,DAL,28,32,28,16,0,104
3/7/2017,LAL,29,23,22,37,0,111,DAL,38,32,33,19,0,122
3/10/2017,BRK,26,23,24,23,0,96,DAL,23,23,28,31,0,105
3/11/2017,PHO,25,20,27,28,0,100,DAL,24,23,22,29,0,98
3/13/2017,DAL,26,20,20,12,0,78,TOR,25,25,29,21,0,100
3/15/2017,DAL,32,21,20,39,0,112,WAS,39,18,23,27,0,107
3/17/2017,DAL,23,17,16,18,0,74,PHI,21,30,36,29,0,116
3/19/2017,DAL,32,25,25,29,0,111,BRK,26,17,29,32,0,104
3/21/2017,GSW,28,34,29,21,0,112,DAL,30,20,21,16,0,87
3/23/2017,LAC,24,30,21,20,0,95,DAL,29,19,29,20,0,97
3/25/2017,TOR,30,24,20,20,0,94,DAL,22,22,20,22,0,86
3/27/2017,OKC,25,10,22,35,0,92,DAL,26,24,19,22,0,91
3/29/2017,DAL,23,28,32,35,0,118,NOP,27,36,26,32,0,121
3/31/2017,DAL,19,15,28,28,0,90,MEM,21,34,18,26,0,99
4/2/2017,DAL,31,22,22,34,0,109,MIL,28,25,25,27,0,105
4/4/2017,DAL,17,21,31,18,0,87,SAC,22,14,32,30,0,98
4/5/2017,DAL,24,25,24,28,0,101,LAC,35,27,28,22,0,112
4/7/2017,SAS,21,29,25,27,0,102,DAL,26,35,8,20,0,89
4/9/2017,DAL,29,36,20,26,0,111,PHO,40,28,36,20,0,124
4/11/2017,DEN,23,34,26,26,0,109,DAL,26,18,31,16,0,91
4/12/2017,DAL,22,24,24,30,0,100,MEM,27,28,19,19,0,93
10/26/2016,CHO,32,24,27,24,0,107,MIL,24,17,25,30,0,96
10/29/2016,BRK,18,23,32,35,0,108,MIL,24,22,34,30,0,110
10/30/2016,MIL,21,18,26,18,0,83,DET,24,26,25,23,0,98
11/1/2016,MIL,29,34,21,33,0,117,NOP,32,22,32,27,0,113
11/3/2016,IND,30,27,22,28,0,107,MIL,29,34,27,35,0,125
11/5/2016,SAC,24,24,15,28,0,91,MIL,34,27,29,27,0,117
11/6/2016,MIL,27,12,17,18,1,75,DAL,19,28,12,15,12,86
11/10/2016,NOP,26,35,27,24,0,112,MIL,27,27,27,25,0,106
11/12/2016,MEM,19,20,31,26,0,96,MIL,24,20,31,31,0,106
11/16/2016,MIL,26,9,35,30,0,100,ATL,21,31,32,23,0,107
11/17/2016,MIL,27,21,14,11,0,73,MIA,21,27,19,29,0,96
11/19/2016,GSW,28,41,34,21,0,124,MIL,37,29,26,29,0,121
11/21/2016,ORL,27,17,30,15,0,89,MIL,20,29,20,24,0,93
11/25/2016,TOR,27,20,26,32,0,105,MIL,24,18,25,32,0,99
11/27/2016,MIL,36,22,21,25,0,104,ORL,29,23,20,24,0,96
11/29/2016,CLE,32,22,20,27,0,101,MIL,30,28,34,26,0,118
12/1/2016,MIL,27,25,38,21,0,111,BRK,26,25,27,15,0,93
12/3/2016,BRK,22,18,32,31,0,103,MIL,25,25,25,37,0,112
12/5/2016,SAS,26,9,36,26,0,97,MIL,24,24,25,23,0,96
12/7/2016,POR,28,30,18,31,0,107,MIL,28,23,34,30,0,115
12/9/2016,ATL,23,21,40,30,0,114,MIL,30,34,28,18,0,110
12/10/2016,MIL,32,20,25,28,0,105,WAS,23,29,25,33,0,110
12/12/2016,MIL,23,26,33,18,0,100,TOR,33,36,23,30,0,122
12/15/2016,CHI,18,27,21,31,0,97,MIL,30,34,24,20,0,108
12/16/2016,MIL,34,22,18,21,0,95,CHI,15,22,15,17,0,69
12/20/2016,CLE,35,22,27,16,14,114,MIL,27,26,25,22,8,108
12/21/2016,MIL,22,32,23,25,0,102,CLE,31,28,33,21,0,113
12/23/2016,WAS,29,29,20,18,0,96,MIL,37,36,27,23,0,123
12/26/2016,MIL,27,30,27,18,0,102,WAS,28,25,29,25,0,107
12/28/2016,MIL,31,31,28,29,0,119,DET,28,26,21,19,0,94
12/30/2016,MIL,21,27,23,28,0,99,MIN,34,21,30,31,0,116
12/31/2016,MIL,22,27,31,36,0,116,CHI,27,24,25,20,0,96
1/2/2017,OKC,30,26,16,22,0,94,MIL,22,28,29,19,0,98
1/4/2017,MIL,27,25,21,32,0,105,NYK,25,27,35,17,0,104
1/6/2017,NYK,32,21,30,33,0,116,MIL,33,32,31,15,0,111
1/8/2017,WAS,24,25,33,25,0,107,MIL,31,26,21,23,0,101
1/10/2017,MIL,23,30,30,26,0,109,SAS,23,36,30,18,0,107
1/13/2017,MIA,30,18,26,34,0,108,MIL,42,23,26,25,0,116
1/15/2017,MIL,36,17,30,15,0,98,ATL,36,24,28,23,0,111
1/16/2017,PHI,24,22,35,32,0,113,MIL,24,30,24,26,0,104
1/18/2017,MIL,27,12,26,27,0,92,HOU,22,30,27,32,0,111
1/20/2017,MIL,23,32,19,22,0,96,ORL,25,34,29,24,0,112
1/21/2017,MIL,22,21,28,26,0,97,MIA,25,28,29,27,0,109
1/23/2017,HOU,33,31,27,23,0,114,MIL,33,35,25,34,0,127
1/25/2017,PHI,33,39,16,26,0,114,MIL,39,19,24,27,0,109
1/27/2017,MIL,19,20,31,16,0,86,TOR,36,17,24,25,0,102
1/28/2017,BOS,42,22,17,21,10,112,MIL,27,26,20,29,6,108
2/1/2017,MIL,27,16,18,27,0,88,UTA,30,31,19,24,0,104
2/3/2017,MIL,31,22,36,28,0,117,DEN,31,39,28,23,0,121
2/4/2017,MIL,45,29,27,36,0,137,PHO,25,41,23,23,0,112
2/8/2017,MIA,28,27,26,25,0,106,MIL,15,29,19,25,0,88
2/10/2017,LAL,47,29,27,19,0,122,MIL,30,25,29,30,0,114
2/11/2017,MIL,29,33,26,28,0,116,IND,22,30,22,26,0,100
2/13/2017,DET,19,15,27,28,0,89,MIL,23,28,26,25,0,102
2/15/2017,MIL,39,23,33,34,0,129,BRK,33,27,22,43,0,125
2/24/2017,UTA,36,23,28,22,0,109,MIL,27,19,29,20,0,95
2/26/2017,PHO,23,24,26,23,0,96,MIL,21,21,35,23,0,100
2/27/2017,MIL,25,25,23,22,0,95,CLE,27,25,25,25,0,102
3/1/2017,DEN,32,31,23,24,0,110,MIL,15,22,29,32,0,98
3/3/2017,LAC,19,28,29,25,0,101,MIL,34,32,19,27,0,112
3/4/2017,TOR,19,23,25,27,0,94,MIL,12,41,27,21,0,101
3/6/2017,MIL,27,33,31,21,0,112,PHI,19,24,25,30,0,98
3/8/2017,NYK,30,26,17,20,0,93,MIL,32,23,21,28,0,104
3/10/2017,IND,27,23,18,17,0,85,MIL,23,22,29,25,0,99
3/11/2017,MIN,19,29,27,20,0,95,MIL,23,25,28,26,0,102
3/13/2017,MIL,24,27,23,19,0,93,MEM,30,31,24,28,0,113
3/15/2017,MIL,28,18,21,30,0,97,LAC,20,26,23,27,0,96
3/17/2017,MIL,31,30,23,23,0,107,LAL,24,22,31,26,0,103
3/18/2017,MIL,29,15,26,22,0,92,GSW,27,36,31,23,0,117
3/21/2017,MIL,18,30,19,26,0,93,POR,21,14,28,27,0,90
3/22/2017,MIL,25,44,21,26,0,116,SAC,24,26,25,23,0,98
3/24/2017,ATL,21,22,31,23,0,97,MIL,29,16,27,28,0,100
3/26/2017,CHI,29,27,35,18,0,109,MIL,31,24,24,15,0,94
3/28/2017,MIL,35,37,22,24,0,118,CHO,24,26,26,32,0,108
3/29/2017,MIL,24,31,25,23,0,103,BOS,24,25,28,23,0,100
3/31/2017,DET,22,26,25,22,10,105,MIL,35,21,15,24,13,108
4/2/2017,DAL,31,22,22,34,0,109,MIL,28,25,25,27,0,105
4/4/2017,MIL,20,19,20,20,0,79,OKC,28,35,26,21,0,110
4/6/2017,MIL,21,29,23,16,0,89,IND,25,31,29,19,0,104
4/8/2017,MIL,23,19,25,23,0,90,PHI,21,27,12,22,0,82
4/10/2017,CHO,24,22,20,13,0,79,MIL,18,25,18,28,0,89
4/12/2017,MIL,36,20,22,16,0,94,BOS,25,32,23,32,0,112
10/26/2016,OKC,23,28,18,34,0,103,PHI,24,27,24,22,0,97
10/29/2016,ATL,29,24,21,30,0,104,PHI,24,15,19,14,0,72
11/1/2016,ORL,24,19,41,19,0,103,PHI,29,28,30,14,0,101
11/2/2016,PHI,26,27,20,20,0,93,CHO,26,20,39,24,0,109
11/5/2016,CLE,34,23,25,20,0,102,PHI,19,27,34,21,0,101
11/7/2016,UTA,30,22,25,32,0,109,PHI,24,19,18,23,0,84
11/9/2016,PHI,26,34,24,25,6,115,IND,31,23,30,25,13,122
11/11/2016,IND,27,25,20,28,5,105,PHI,21,30,25,24,9,109
11/12/2016,PHI,27,21,30,18,0,96,ATL,23,36,28,30,0,117
11/14/2016,PHI,26,26,16,20,0,88,HOU,38,27,28,22,0,115
11/16/2016,WAS,15,33,28,26,0,102,PHI,29,30,29,21,0,109
11/17/2016,PHI,18,15,25,28,0,86,MIN,27,34,24,25,0,110
11/19/2016,PHO,19,29,27,30,0,105,PHI,32,26,34,28,0,120
11/21/2016,MIA,30,15,31,18,0,94,PHI,24,22,32,23,0,101
11/23/2016,MEM,20,23,20,23,5,104,PHI,26,25,20,15,5,99
11/25/2016,CHI,23,34,33,15,0,105,PHI,19,28,17,25,0,89
11/27/2016,CLE,24,28,25,35,0,112,PHI,30,28,23,27,0,108
11/28/2016,PHI,26,23,22,24,0,95,TOR,33,27,31,31,0,122
12/2/2016,ORL,21,29,32,23,0,105,PHI,14,28,19,27,0,88
12/3/2016,BOS,22,23,29,33,0,107,PHI,30,23,21,32,0,106
12/5/2016,DEN,18,33,23,32,0,106,PHI,27,26,17,28,0,98
12/6/2016,PHI,20,23,34,14,0,91,MEM,28,19,29,20,0,96
12/8/2016,PHI,26,26,19,28,0,99,NOP,31,26,12,19,0,88
12/11/2016,PHI,32,26,22,17,0,97,DET,12,23,29,15,0,79
12/14/2016,TOR,22,38,32,31,0,123,PHI,25,29,20,40,0,114
12/16/2016,LAL,30,23,21,26,0,100,PHI,18,22,24,25,0,89
12/18/2016,BRK,32,25,29,21,0,107,PHI,30,24,29,25,0,108
12/20/2016,NOP,15,42,27,24,0,108,PHI,23,21,25,24,0,93
12/23/2016,PHI,31,35,19,31,0,116,PHO,24,29,28,42,0,123
12/26/2016,PHI,23,24,30,23,0,100,SAC,24,27,19,32,0,102
12/29/2016,PHI,24,27,23,9,0,83,UTA,22,27,21,30,0,100
12/30/2016,PHI,30,30,31,33,0,124,DEN,28,32,27,35,0,122
1/3/2017,MIN,16,26,26,23,0,91,PHI,29,28,22,14,0,93
1/6/2017,PHI,23,39,18,26,0,106,BOS,25,26,27,32,0,110
1/8/2017,PHI,24,22,32,27,0,105,BRK,27,30,16,22,0,95
1/11/2017,NYK,32,20,23,22,0,97,PHI,27,20,24,27,0,98
1/13/2017,CHO,21,24,26,22,0,93,PHI,26,26,24,26,0,102
1/14/2017,PHI,30,26,15,22,0,93,WAS,21,35,30,23,0,109
1/16/2017,PHI,24,22,35,32,0,113,MIL,24,30,24,26,0,104
1/18/2017,TOR,21,23,21,24,0,89,PHI,25,21,22,26,0,94
1/20/2017,POR,33,23,15,21,0,92,PHI,22,21,27,23,0,93
1/21/2017,PHI,25,29,23,16,0,93,ATL,25,37,28,20,0,110
1/24/2017,LAC,29,39,21,21,0,110,PHI,27,32,30,32,0,121
1/25/2017,PHI,33,39,16,26,0,114,MIL,39,19,24,27,0,109
1/27/2017,HOU,31,30,33,29,0,123,PHI,28,33,21,36,0,118
1/29/2017,PHI,23,34,30,21,0,108,CHI,37,30,29,25,0,121
1/30/2017,SAC,35,20,30,34,0,119,PHI,21,27,42,32,0,122
2/1/2017,PHI,23,24,22,26,0,95,DAL,20,30,31,32,0,113
2/2/2017,PHI,21,32,20,13,0,86,SAS,24,24,31,23,0,102
2/4/2017,PHI,17,35,23,27,0,102,MIA,32,32,36,25,0,125
2/6/2017,PHI,27,19,21,29,0,96,DET,24,31,34,24,0,113
2/8/2017,SAS,29,29,24,29,0,111,PHI,23,28,24,28,0,103
2/9/2017,PHI,20,35,30,27,0,112,ORL,25,23,36,27,0,111
2/11/2017,MIA,27,21,28,33,0,109,PHI,27,27,30,33,0,117
2/13/2017,PHI,31,17,32,25,0,105,CHO,22,25,25,27,0,99
2/15/2017,PHI,29,32,18,29,0,108,BOS,29,32,26,29,0,116
2/24/2017,WAS,28,21,32,31,0,112,PHI,26,35,34,25,0,120
2/25/2017,PHI,25,25,25,34,0,109,NYK,31,29,26,24,0,110
2/27/2017,GSW,32,27,34,26,0,119,PHI,31,25,24,28,0,108
3/1/2017,PHI,27,17,30,24,0,98,MIA,37,27,24,37,0,125
3/3/2017,NYK,35,18,28,21,0,102,PHI,29,34,16,26,0,105
3/4/2017,DET,33,34,39,30,0,136,PHI,25,27,30,24,0,106
3/6/2017,MIL,27,33,31,21,0,112,PHI,19,24,25,30,0,98
3/9/2017,PHI,17,35,26,19,11,108,POR,27,30,19,21,17,114
3/11/2017,PHI,30,27,22,21,0,100,LAC,32,24,19,37,0,112
3/12/2017,PHI,32,33,28,25,0,118,LAL,27,38,20,31,0,116
3/14/2017,PHI,34,25,31,14,0,104,GSW,35,23,20,28,0,106
3/17/2017,DAL,23,17,16,18,0,74,PHI,21,30,36,29,0,116
3/19/2017,BOS,23,28,28,20,0,99,PHI,25,21,30,29,0,105
3/20/2017,PHI,26,30,27,15,11,109,ORL,25,16,33,24,14,112
3/22/2017,PHI,22,28,20,27,0,97,OKC,29,34,32,27,0,122
3/24/2017,PHI,24,35,34,24,0,117,CHI,28,18,25,36,0,107
3/26/2017,PHI,18,27,24,25,0,94,IND,27,24,30,26,0,107
3/28/2017,PHI,31,27,21,27,0,106,BRK,24,33,21,23,0,101
3/29/2017,ATL,25,27,27,20,0,99,PHI,18,25,27,22,0,92
3/31/2017,PHI,29,23,25,28,0,105,CLE,32,38,34,18,0,122
4/2/2017,PHI,29,20,27,29,0,105,TOR,28,31,27,27,0,113
4/4/2017,BRK,40,41,30,30,0,141,PHI,27,26,24,41,0,118
4/6/2017,CHI,27,26,27,22,0,102,PHI,17,30,20,23,0,90
4/8/2017,MIL,23,19,25,23,0,90,PHI,21,27,12,22,0,82
4/10/2017,IND,35,29,26,30,0,120,PHI,20,34,25,32,0,111
4/12/2017,PHI,22,37,28,26,0,113,NYK,25,31,22,36,0,114
10/26/2016,SAC,30,27,27,29,0,113,PHO,19,19,29,27,0,94
10/28/2016,PHO,40,13,30,19,8,110,OKC,25,24,28,25,11,113
10/30/2016,GSW,22,33,26,25,0,106,PHO,30,27,21,22,0,100
10/31/2016,PHO,24,12,34,28,0,98,LAC,24,24,34,34,0,116
11/2/2016,POR,28,25,20,30,12,115,PHO,28,29,19,27,15,118
11/4/2016,PHO,30,28,23,21,10,112,NOP,29,32,18,23,9,111
11/6/2016,PHO,15,28,33,32,0,108,LAL,23,31,29,36,0,119
11/8/2016,PHO,25,30,27,39,0,121,POR,42,21,26,35,0,124
11/9/2016,DET,28,23,25,24,0,100,PHO,19,35,27,26,0,107
11/12/2016,BRK,23,35,32,32,0,122,PHO,21,24,38,21,0,104
11/13/2016,PHO,32,27,33,28,0,120,GSW,28,34,37,34,0,133
11/16/2016,PHO,17,26,33,28,0,104,DEN,28,33,28,31,0,120
11/18/2016,PHO,27,30,32,27,0,116,IND,18,31,33,14,0,96
11/19/2016,PHO,19,29,27,30,0,105,PHI,32,26,34,28,0,120
11/21/2016,PHO,20,26,34,21,0,101,WAS,26,24,25,31,0,106
11/23/2016,PHO,24,22,22,24,0,92,ORL,22,22,22,21,0,87
11/25/2016,MIN,29,18,20,31,0,98,PHO,27,25,23,10,0,85
11/27/2016,DEN,29,34,23,34,0,120,PHO,28,15,36,35,0,114
11/30/2016,ATL,27,21,27,32,0,107,PHO,36,14,27,32,0,109
12/3/2016,PHO,30,27,27,25,0,109,GSW,37,29,42,30,0,138
12/6/2016,PHO,19,26,30,30,0,105,UTA,33,32,29,18,0,112
12/7/2016,IND,23,26,33,27,0,109,PHO,22,31,27,14,0,94
12/9/2016,PHO,32,30,27,30,0,119,LAL,26,26,28,35,0,115
12/11/2016,NOP,25,26,25,34,10,120,PHO,31,27,24,28,9,119
12/13/2016,NYK,25,21,27,28,10,111,PHO,31,23,31,16,12,113
12/15/2016,SAS,23,28,23,33,0,107,PHO,20,23,28,21,0,92
12/17/2016,PHO,20,19,30,32,0,101,OKC,30,24,35,25,0,114
12/19/2016,PHO,23,31,33,21,0,108,MIN,29,33,29,24,0,115
12/21/2016,HOU,30,31,30,34,0,125,PHO,26,29,29,27,0,111
12/23/2016,PHI,31,35,19,31,0,116,PHO,24,29,28,42,0,123
12/26/2016,PHO,23,20,37,35,0,115,HOU,39,30,38,24,0,131
12/28/2016,PHO,27,37,18,16,0,98,SAS,30,28,31,30,0,119
12/29/2016,TOR,18,22,22,29,0,91,PHO,16,26,34,23,0,99
12/31/2016,PHO,29,22,20,15,0,86,UTA,29,26,21,15,0,91
1/2/2017,PHO,26,32,18,22,0,98,LAC,27,37,25,20,0,109
1/3/2017,MIA,29,23,14,24,0,90,PHO,28,28,27,16,0,99
1/5/2017,PHO,19,22,29,32,0,102,DAL,22,23,27,23,0,95
1/8/2017,CLE,41,28,24,27,0,120,PHO,28,25,37,26,0,116
1/12/2017,DAL,32,25,31,25,0,113,PHO,29,30,17,32,0,108
1/14/2017,SAS,25,33,27,20,0,105,PHO,25,26,29,28,0,108
1/16/2017,UTA,24,23,32,27,0,106,PHO,28,25,27,21,0,101
1/19/2017,PHO,21,20,35,27,0,103,CLE,29,30,30,29,0,118
1/21/2017,PHO,30,31,29,17,0,107,NYK,33,22,35,15,0,105
1/22/2017,PHO,28,29,25,33,0,115,TOR,31,29,25,18,0,103
1/24/2017,MIN,23,36,28,25,0,112,PHO,27,29,23,32,0,111
1/26/2017,PHO,29,32,31,28,0,120,DEN,35,22,39,31,0,127
1/28/2017,DEN,21,38,36,28,0,123,PHO,33,28,22,29,0,112
1/30/2017,MEM,31,28,29,27,0,115,PHO,28,20,22,26,0,96
2/1/2017,LAC,38,24,30,32,0,124,PHO,31,28,29,26,0,114
2/3/2017,PHO,15,34,30,26,0,105,SAC,21,28,30,24,0,103
2/4/2017,MIL,45,29,27,36,0,137,PHO,25,41,23,23,0,112
2/6/2017,PHO,21,21,32,32,0,106,NOP,29,18,30,34,0,111
2/8/2017,PHO,15,23,27,26,0,91,MEM,24,22,33,31,0,110
2/10/2017,CHI,26,17,33,21,0,97,PHO,28,28,30,29,0,115
2/11/2017,PHO,24,29,24,25,0,102,HOU,38,39,34,22,0,133
2/13/2017,NOP,29,24,24,33,0,110,PHO,28,30,22,28,0,108
2/15/2017,LAL,15,33,28,25,0,101,PHO,32,36,34,35,0,137
2/24/2017,PHO,25,29,25,29,13,121,CHI,24,28,28,28,20,128
2/26/2017,PHO,23,24,26,23,0,96,MIL,21,21,35,23,0,100
2/28/2017,PHO,27,29,29,27,0,112,MEM,25,30,38,37,0,130
3/2/2017,CHO,32,26,33,12,0,103,PHO,28,33,33,26,0,120
3/3/2017,OKC,28,27,24,32,0,111,PHO,23,35,29,31,0,118
3/5/2017,BOS,22,20,35,29,0,106,PHO,19,30,32,28,0,109
3/7/2017,WAS,38,30,26,37,0,131,PHO,25,36,31,35,0,127
3/9/2017,LAL,32,29,29,32,0,122,PHO,33,30,18,29,0,110
3/11/2017,PHO,25,20,27,28,0,100,DAL,24,23,22,29,0,98
3/12/2017,POR,33,33,16,28,0,110,PHO,18,32,29,22,0,101
3/15/2017,SAC,22,26,26,33,0,107,PHO,29,18,28,26,0,101
3/17/2017,ORL,30,30,24,25,0,109,PHO,22,36,27,18,0,103
3/19/2017,PHO,23,26,26,20,0,95,DET,24,23,30,35,0,112
3/21/2017,PHO,26,20,17,34,0,97,MIA,23,36,25,28,0,112
3/23/2017,PHO,32,18,15,33,0,98,BRK,22,30,32,42,0,126
3/24/2017,PHO,16,27,37,40,0,120,BOS,29,37,31,33,0,130
3/26/2017,PHO,18,29,33,26,0,106,CHO,38,31,29,22,0,120
3/28/2017,PHO,12,32,24,23,0,91,ATL,27,20,24,24,0,95
3/30/2017,LAC,31,36,26,31,0,124,PHO,35,24,33,26,0,118
4/1/2017,PHO,21,32,34,30,0,117,POR,37,26,34,33,0,130
4/2/2017,HOU,31,28,31,33,0,123,PHO,21,33,29,33,0,116
4/5/2017,GSW,41,17,33,29,0,120,PHO,18,34,26,33,0,111
4/7/2017,OKC,19,29,24,27,0,99,PHO,32,39,24,25,0,120
4/9/2017,DAL,29,36,20,26,0,111,PHO,40,28,36,20,0,124
4/11/2017,PHO,25,14,38,27,0,104,SAC,28,30,39,32,0,129
10/26/2016,HOU,38,33,25,18,0,114,LAL,38,25,27,30,0,120
10/28/2016,LAL,27,16,22,24,0,89,UTA,28,20,17,31,0,96
10/30/2016,LAL,24,22,25,25,0,96,OKC,30,28,19,36,0,113
11/1/2016,LAL,18,33,28,29,0,108,IND,27,35,22,31,0,115
11/2/2016,LAL,28,23,39,33,0,123,ATL,37,23,34,22,0,116
11/4/2016,GSW,15,34,33,15,0,97,LAL,24,41,28,24,0,117
11/6/2016,PHO,15,28,33,32,0,108,LAL,23,31,29,36,0,119
11/8/2016,DAL,25,33,25,26,0,109,LAL,27,27,23,20,0,97
11/10/2016,LAL,16,29,25,31,0,101,SAC,30,25,18,18,0,91
11/12/2016,LAL,30,25,29,42,0,126,NOP,26,30,15,28,0,99
11/13/2016,LAL,27,19,26,27,0,99,MIN,36,33,18,38,0,125
11/15/2016,BRK,29,22,34,33,0,118,LAL,27,29,37,32,0,125
11/18/2016,SAS,26,26,39,25,0,116,LAL,16,36,24,31,0,107
11/20/2016,CHI,30,32,28,28,0,118,LAL,30,31,24,25,0,110
11/22/2016,OKC,16,32,26,35,0,109,LAL,29,20,31,31,0,111
11/23/2016,LAL,26,23,29,28,0,106,GSW,41,39,26,43,0,149
11/25/2016,GSW,30,23,27,29,0,109,LAL,20,23,21,21,0,85
11/27/2016,ATL,32,16,29,17,0,94,LAL,21,35,28,25,0,109
11/29/2016,LAL,22,19,22,25,0,88,NOP,33,32,24,16,0,105
11/30/2016,LAL,17,30,23,26,0,96,CHI,28,19,26,17,0,90
12/2/2016,LAL,22,26,14,18,0,80,TOR,28,41,15,29,0,113
12/3/2016,LAL,25,37,20,18,0,100,MEM,25,29,28,21,0,103
12/5/2016,UTA,26,31,32,18,0,107,LAL,26,27,21,27,0,101
12/7/2016,LAL,27,28,22,18,0,95,HOU,43,24,39,28,0,134
12/9/2016,PHO,32,30,27,30,0,119,LAL,26,26,28,35,0,115
12/11/2016,NYK,32,25,27,34,0,118,LAL,30,26,19,37,0,112
12/12/2016,LAL,24,34,13,21,0,92,SAC,31,18,39,28,0,116
12/14/2016,LAL,30,13,33,21,0,97,BRK,27,25,23,32,0,107
12/16/2016,LAL,30,23,21,26,0,100,PHI,18,22,24,25,0,89
12/17/2016,LAL,31,28,24,25,0,108,CLE,26,36,27,30,0,119
12/20/2016,LAL,41,32,23,17,0,113,CHO,35,24,35,23,0,117
12/22/2016,LAL,25,35,20,27,0,107,MIA,17,36,29,33,0,115
12/23/2016,LAL,14,26,29,21,0,90,ORL,30,27,29,23,0,109
12/25/2016,LAC,31,27,16,28,0,102,LAL,27,28,34,22,0,111
12/27/2016,UTA,28,20,24,30,0,102,LAL,25,27,22,26,0,100
12/29/2016,DAL,26,24,31,20,0,101,LAL,27,30,13,19,0,89
1/1/2017,TOR,27,31,27,38,0,123,LAL,33,24,26,31,0,114
1/3/2017,MEM,20,28,29,25,0,102,LAL,22,35,34,25,0,116
1/5/2017,LAL,24,38,22,25,0,109,POR,29,24,31,34,0,118
1/6/2017,MIA,23,33,23,21,0,100,LAL,32,26,32,37,0,127
1/8/2017,ORL,34,26,9,26,0,95,LAL,40,22,19,30,0,111
1/10/2017,POR,25,30,23,30,0,108,LAL,26,31,12,18,0,87
1/12/2017,LAL,24,30,21,19,0,94,SAS,36,36,34,28,0,134
1/14/2017,LAL,15,24,29,29,0,97,LAC,26,32,26,29,0,113
1/15/2017,DET,23,36,16,27,0,102,LAL,31,26,15,25,0,97
1/17/2017,DEN,40,26,35,26,0,127,LAL,26,28,30,37,0,121
1/20/2017,IND,24,29,22,20,0,95,LAL,27,24,35,22,0,108
1/22/2017,LAL,22,11,22,18,0,73,DAL,29,38,23,32,0,122
1/25/2017,LAL,31,27,17,23,0,98,POR,30,29,24,22,0,105
1/26/2017,LAL,16,25,19,28,0,88,UTA,23,21,26,26,0,96
1/31/2017,DEN,30,29,17,40,0,116,LAL,30,24,27,39,0,120
2/2/2017,LAL,29,15,35,29,0,108,WAS,31,27,32,26,0,116
2/3/2017,LAL,30,21,23,33,0,107,BOS,29,33,20,31,0,113
2/6/2017,LAL,29,32,36,24,0,121,NYK,19,26,28,34,0,107
2/8/2017,LAL,25,25,20,32,0,102,DET,25,31,36,29,0,121
2/10/2017,LAL,47,29,27,19,0,122,MIL,30,25,29,30,0,114
2/14/2017,SAC,29,14,27,27,0,97,LAL,23,18,23,32,0,96
2/15/2017,LAL,15,33,28,25,0,101,PHO,32,36,34,35,0,137
2/24/2017,LAL,23,28,19,23,0,93,OKC,29,29,28,24,0,110
2/26/2017,SAS,36,25,35,23,0,119,LAL,20,21,29,28,0,98
2/28/2017,CHO,27,31,22,29,0,109,LAL,31,24,27,22,0,104
3/3/2017,BOS,35,35,23,22,0,115,LAL,26,19,33,17,0,95
3/5/2017,NOP,26,29,28,22,0,105,LAL,20,39,14,24,0,97
3/7/2017,LAL,29,23,22,37,0,111,DAL,38,32,33,19,0,122
3/9/2017,LAL,32,29,29,32,0,122,PHO,33,30,18,29,0,110
3/12/2017,PHI,32,33,28,25,0,118,LAL,27,38,20,31,0,116
3/13/2017,LAL,23,20,33,25,0,101,DEN,35,32,26,36,0,129
3/15/2017,LAL,26,26,23,25,0,100,HOU,37,29,27,46,0,139
3/17/2017,MIL,31,30,23,23,0,107,LAL,24,22,31,26,0,103
3/19/2017,CLE,31,24,27,43,0,125,LAL,28,31,33,28,0,120
3/21/2017,LAC,33,37,38,25,0,133,LAL,24,16,34,35,0,109
3/24/2017,MIN,27,40,21,21,10,119,LAL,26,28,26,29,21,130
3/26/2017,POR,22,18,37,20,0,97,LAL,17,15,24,25,0,81
3/28/2017,WAS,27,28,27,37,0,119,LAL,27,31,37,13,0,108
3/30/2017,LAL,37,23,22,22,0,104,MIN,37,30,29,23,0,119
4/1/2017,LAL,22,28,22,32,0,104,LAC,28,27,38,22,0,115
4/2/2017,MEM,27,22,31,23,0,103,LAL,22,28,29,29,0,108
4/5/2017,LAL,31,22,23,26,0,102,SAS,14,27,29,25,0,95
4/7/2017,SAC,31,14,25,24,0,94,LAL,18,26,25,29,0,98
4/9/2017,MIN,21,30,28,30,0,109,LAL,29,24,25,32,0,110
4/11/2017,NOP,25,28,20,23,0,96,LAL,26,31,28,23,0,108
4/12/2017,LAL,28,22,20,24,0,94,GSW,43,21,29,16,0,109
10/25/2016,UTA,26,20,37,21,0,104,POR,26,28,23,36,0,113
10/28/2016,LAL,27,16,22,24,0,89,UTA,28,20,17,31,0,96
10/30/2016,UTA,22,13,21,19,0,75,LAC,19,23,27,19,0,88
11/1/2016,UTA,38,16,19,33,0,106,SAS,28,22,21,20,0,91
11/2/2016,DAL,14,19,26,22,0,81,UTA,15,26,25,31,0,97
11/4/2016,SAS,27,26,29,18,0,100,UTA,17,24,25,20,0,86
11/6/2016,UTA,20,29,29,36,0,114,NYK,30,24,26,29,0,109
11/7/2016,UTA,30,22,25,32,0,109,PHI,24,19,18,23,0,84
11/9/2016,UTA,32,26,20,20,0,98,CHO,24,27,25,28,0,104
11/11/2016,UTA,23,19,18,27,0,87,ORL,17,21,26,10,0,74
11/12/2016,UTA,23,29,24,26,0,102,MIA,21,26,12,32,0,91
11/14/2016,MEM,33,23,17,29,0,102,UTA,25,23,22,26,0,96
11/17/2016,CHI,25,16,25,19,0,85,UTA,26,17,15,19,0,77
11/19/2016,UTA,22,22,26,32,0,102,HOU,28,27,26,30,0,111
11/20/2016,UTA,14,27,22,28,0,91,DEN,24,29,23,29,0,105
11/23/2016,DEN,27,20,14,22,0,83,UTA,36,17,31,24,0,108
11/25/2016,ATL,23,11,14,20,0,68,UTA,24,24,13,34,0,95
11/28/2016,UTA,22,28,24,38,0,112,MIN,27,18,24,34,0,103
11/29/2016,HOU,29,21,23,28,0,101,UTA,38,24,23,35,0,120
12/1/2016,MIA,26,26,31,28,0,111,UTA,27,21,29,33,0,110
12/3/2016,DEN,21,26,16,35,0,98,UTA,24,25,33,23,0,105
12/5/2016,UTA,26,31,32,18,0,107,LAL,26,27,21,27,0,101
12/6/2016,PHO,19,26,30,30,0,105,UTA,33,32,29,18,0,112
12/8/2016,GSW,35,30,17,24,0,106,UTA,17,29,24,29,0,99
12/10/2016,SAC,25,25,26,8,0,84,UTA,29,23,26,26,0,104
12/14/2016,OKC,21,20,27,21,0,89,UTA,26,29,25,29,0,109
12/16/2016,DAL,29,29,19,23,0,100,UTA,33,31,26,13,0,103
12/18/2016,UTA,18,16,27,21,0,82,MEM,18,17,23,15,0,73
12/20/2016,UTA,15,18,21,20,0,74,GSW,19,36,27,22,0,104
12/21/2016,SAC,17,21,24,32,0,94,UTA,24,24,25,20,0,93
12/23/2016,TOR,28,28,16,32,0,104,UTA,29,22,23,24,0,98
12/27/2016,UTA,28,20,24,30,0,102,LAL,25,27,22,26,0,100
12/29/2016,PHI,24,27,23,9,0,83,UTA,22,27,21,30,0,100
12/31/2016,PHO,29,22,20,15,0,86,UTA,29,26,21,15,0,91
1/2/2017,UTA,24,26,20,31,0,101,BRK,26,26,18,19,0,89
1/3/2017,UTA,29,16,29,30,0,104,BOS,28,26,31,30,0,115
1/5/2017,UTA,27,25,21,20,0,93,TOR,18,30,23,30,0,101
1/7/2017,UTA,25,22,22,25,0,94,MIN,24,24,32,12,0,92
1/8/2017,UTA,18,17,16,28,0,79,MEM,19,23,21,25,0,88
1/10/2017,CLE,29,12,25,26,0,92,UTA,29,27,19,25,0,100
1/13/2017,DET,19,24,20,14,0,77,UTA,14,31,33,32,0,110
1/14/2017,ORL,42,23,18,24,0,107,UTA,29,35,20,30,0,114
1/16/2017,UTA,24,23,32,27,0,106,PHO,28,25,27,21,0,101
1/20/2017,UTA,19,27,26,26,14,112,DAL,22,19,27,30,9,107
1/21/2017,IND,21,29,22,28,0,100,UTA,34,26,25,24,0,109
1/23/2017,OKC,27,29,11,30,0,97,UTA,26,27,19,23,0,95
1/24/2017,UTA,22,17,28,26,0,93,DEN,18,33,29,23,0,103
1/26/2017,LAL,16,25,19,28,0,88,UTA,23,21,26,26,0,96
1/28/2017,MEM,26,26,28,22,0,102,UTA,27,16,31,21,0,95
2/1/2017,MIL,27,16,18,27,0,88,UTA,30,31,19,24,0,104
2/4/2017,CHO,28,16,38,16,0,98,UTA,23,29,21,32,0,105
2/6/2017,UTA,29,25,37,29,0,120,ATL,21,29,23,22,0,95
2/8/2017,UTA,32,30,28,37,0,127,NOP,25,28,16,25,0,94
2/9/2017,UTA,23,31,24,22,5,105,DAL,20,22,26,32,12,112
2/11/2017,BOS,33,25,19,35,0,112,UTA,23,21,21,39,0,104
2/13/2017,LAC,18,27,31,12,0,88,UTA,19,15,15,23,0,72
2/15/2017,POR,17,20,25,26,0,88,UTA,18,22,34,37,0,111
2/24/2017,UTA,36,23,28,22,0,109,MIL,27,19,29,20,0,95
2/26/2017,UTA,24,25,24,29,0,102,WAS,24,15,21,32,0,92
2/28/2017,UTA,25,28,22,31,0,106,OKC,31,30,25,23,0,109
3/1/2017,MIN,21,30,30,26,0,107,UTA,16,19,18,27,0,80
3/3/2017,BRK,26,25,19,27,0,97,UTA,38,22,28,24,0,112
3/5/2017,UTA,25,20,24,28,13,110,SAC,31,28,22,16,12,109
3/6/2017,NOP,14,20,18,31,0,83,UTA,29,14,18,27,0,88
3/8/2017,UTA,30,34,20,31,0,115,HOU,22,31,24,31,0,108
3/11/2017,UTA,23,25,28,28,0,104,OKC,29,33,29,21,0,112
3/13/2017,LAC,28,28,30,22,0,108,UTA,23,26,40,25,0,114
3/15/2017,UTA,28,26,23,20,0,97,DET,19,16,27,21,0,83
3/16/2017,UTA,20,22,25,16,0,83,CLE,29,15,23,24,0,91
3/18/2017,UTA,23,21,20,22,0,86,CHI,16,24,21,34,0,95
3/20/2017,UTA,23,23,24,30,0,100,IND,28,23,29,27,0,107
3/22/2017,NYK,34,21,20,26,0,101,UTA,26,25,21,36,0,108
3/25/2017,UTA,14,27,29,25,0,95,LAC,28,21,23,36,0,108
3/27/2017,NOP,21,30,20,29,0,100,UTA,28,28,25,27,0,108
3/29/2017,UTA,34,16,28,34,0,112,SAC,14,29,24,15,0,82
3/31/2017,WAS,19,20,22,27,0,88,UTA,24,18,22,31,0,95
4/2/2017,UTA,28,24,26,25,0,103,SAS,33,21,34,21,0,109
4/4/2017,POR,17,24,23,23,0,87,UTA,24,23,28,31,0,106
4/7/2017,MIN,31,29,28,25,0,113,UTA,29,26,40,25,0,120
4/8/2017,UTA,20,22,18,26,0,86,POR,34,14,29,24,0,101
4/10/2017,UTA,32,17,25,31,0,105,GSW,33,18,23,25,0,99
4/12/2017,SAS,23,23,26,25,0,97,UTA,32,21,29,19,0,101
10/26/2016,SAC,30,27,27,29,0,113,PHO,19,19,29,27,0,94
10/27/2016,SAS,27,26,23,26,0,102,SAC,29,28,14,23,0,94
10/29/2016,MIN,34,31,12,26,0,103,SAC,25,29,31,21,0,106
10/31/2016,SAC,15,29,37,14,0,95,ATL,22,31,26,27,0,106
11/1/2016,SAC,26,24,17,24,5,96,MIA,28,26,19,18,17,108
11/3/2016,SAC,29,21,28,16,0,94,ORL,23,33,28,18,0,102
11/5/2016,SAC,24,24,15,28,0,91,MIL,34,27,29,27,0,117
11/6/2016,SAC,20,24,24,28,0,96,TOR,23,27,16,25,0,91
11/8/2016,NOP,26,20,24,24,0,94,SAC,33,20,23,26,0,102
11/10/2016,LAL,16,29,25,31,0,101,SAC,30,25,18,18,0,91
11/11/2016,SAC,31,26,26,23,14,120,POR,35,27,22,22,16,122
11/16/2016,SAS,27,30,27,26,0,110,SAC,22,24,25,34,0,105
11/18/2016,LAC,40,33,31,17,0,121,SAC,24,30,31,30,0,115
11/20/2016,TOR,28,35,18,18,0,99,SAC,36,22,28,16,0,102
11/23/2016,OKC,27,21,27,26,0,101,SAC,27,24,36,29,0,116
11/25/2016,HOU,38,30,22,27,0,117,SAC,19,31,24,30,0,104
11/27/2016,SAC,31,27,34,30,0,122,BRK,35,24,18,28,0,105
11/28/2016,SAC,19,34,19,20,3,95,WAS,25,25,24,18,9,101
12/2/2016,SAC,29,17,26,20,0,92,BOS,29,18,22,28,0,97
12/4/2016,SAC,21,20,36,21,0,98,NYK,26,29,26,25,0,106
12/7/2016,SAC,26,30,29,35,0,120,DAL,23,29,12,25,0,89
12/9/2016,NYK,30,24,24,25,0,103,SAC,32,21,24,23,0,100
12/10/2016,SAC,25,25,26,8,0,84,UTA,29,23,26,26,0,104
12/12/2016,LAL,24,34,13,21,0,92,SAC,31,18,39,28,0,116
12/14/2016,SAC,25,18,24,31,0,98,HOU,36,28,38,30,0,132
12/16/2016,SAC,24,28,24,20,0,96,MEM,19,23,23,27,0,92
12/18/2016,SAC,21,23,14,21,0,79,DAL,28,27,21,23,0,99
12/20/2016,POR,35,37,27,22,0,121,SAC,27,33,33,33,0,126
12/21/2016,SAC,17,21,24,32,0,94,UTA,24,24,25,20,0,93
12/23/2016,SAC,25,26,27,31,0,109,MIN,26,29,30,20,0,105
12/26/2016,PHI,23,24,30,23,0,100,SAC,24,27,19,32,0,102
12/28/2016,SAC,21,23,19,26,0,89,POR,30,30,15,27,0,102
12/31/2016,MEM,21,29,32,30,0,112,SAC,20,25,22,31,0,98
1/3/2017,SAC,29,31,34,26,0,120,DEN,28,23,37,25,0,113
1/4/2017,MIA,30,34,23,20,0,107,SAC,25,34,22,21,0,102
1/6/2017,LAC,19,34,22,31,0,106,SAC,29,12,32,25,0,98
1/8/2017,GSW,24,27,39,27,0,117,SAC,33,25,22,26,0,106
1/10/2017,DET,29,27,21,17,0,94,SAC,21,22,25,32,0,100
1/13/2017,CLE,32,29,23,36,0,120,SAC,15,28,31,34,0,108
1/15/2017,OKC,28,31,29,34,0,122,SAC,23,23,33,39,0,118
1/18/2017,IND,21,20,30,35,0,106,SAC,34,26,19,21,0,100
1/20/2017,SAC,23,19,22,27,0,91,MEM,15,34,34,24,0,107
1/21/2017,SAC,21,31,21,26,0,99,CHI,24,31,20,27,0,102
1/23/2017,SAC,28,37,23,21,0,109,DET,38,24,19,23,0,104
1/25/2017,SAC,22,31,26,25,12,116,CLE,26,21,35,22,8,112
1/27/2017,SAC,30,34,23,17,7,111,IND,27,28,26,23,11,115
1/28/2017,SAC,24,28,33,24,0,109,CHO,22,22,33,29,0,106
1/30/2017,SAC,35,20,30,34,0,119,PHI,21,27,42,32,0,122
1/31/2017,SAC,24,11,22,26,0,83,HOU,29,25,28,23,0,105
2/3/2017,PHO,15,34,30,26,0,105,SAC,21,28,30,24,0,103
2/4/2017,GSW,31,25,26,16,8,106,SAC,27,29,26,16,11,109
2/6/2017,CHI,27,33,25,27,0,112,SAC,11,34,24,38,0,107
2/8/2017,BOS,28,21,22,21,0,92,SAC,19,30,28,31,0,108
2/10/2017,ATL,28,31,25,23,0,107,SAC,17,26,31,34,0,108
2/12/2017,NOP,29,27,17,26,0,99,SAC,23,30,23,29,0,105
2/14/2017,SAC,29,14,27,27,0,97,LAL,23,18,23,32,0,96
2/15/2017,SAC,25,25,15,21,0,86,GSW,28,19,42,20,0,109
2/23/2017,DEN,26,18,26,30,0,100,SAC,29,32,26,29,0,116
2/25/2017,CHO,24,27,28,20,0,99,SAC,19,21,18,27,0,85
2/27/2017,MIN,20,40,17,25,0,102,SAC,25,19,21,23,0,88
3/1/2017,BRK,35,22,24,28,0,109,SAC,31,23,18,28,0,100
3/5/2017,UTA,25,20,24,28,13,110,SAC,31,28,22,16,12,109
3/6/2017,SAC,24,26,23,23,0,96,DEN,25,32,33,18,0,108
3/8/2017,SAC,37,26,23,18,0,104,SAS,15,33,34,32,0,114
3/10/2017,WAS,28,28,26,34,14,130,SAC,32,36,29,19,6,122
3/11/2017,DEN,25,29,21,30,0,105,SAC,19,25,25,23,0,92
3/13/2017,ORL,23,35,26,31,0,115,SAC,24,34,35,27,0,120
3/15/2017,SAC,22,26,26,33,0,107,PHO,29,18,28,26,0,101
3/18/2017,SAC,19,22,24,29,0,94,OKC,29,34,22,25,0,110
3/19/2017,SAC,27,22,25,28,0,102,SAS,21,37,41,19,0,118
3/22/2017,MIL,25,44,21,26,0,116,SAC,24,26,25,23,0,98
3/24/2017,SAC,20,30,22,28,0,100,GSW,27,30,35,22,0,114
3/26/2017,SAC,24,18,23,33,0,98,LAC,24,20,32,21,0,97
3/27/2017,MEM,27,22,19,22,0,90,SAC,28,23,23,17,0,91
3/29/2017,UTA,34,16,28,34,0,112,SAC,14,29,24,15,0,82
3/31/2017,SAC,19,19,26,25,0,89,NOP,32,26,26,33,0,117
4/1/2017,SAC,18,37,36,32,0,123,MIN,31,28,26,32,0,117
4/4/2017,DAL,17,21,31,18,0,87,SAC,22,14,32,30,0,98
4/7/2017,SAC,31,14,25,24,0,94,LAL,18,26,25,29,0,98
4/9/2017,HOU,42,36,29,28,0,135,SAC,27,35,27,39,0,128
4/11/2017,PHO,25,14,38,27,0,104,SAC,28,30,39,32,0,129
4/12/2017,SAC,23,24,26,22,0,95,LAC,30,23,34,28,0,115
10/25/2016,NYK,18,27,19,24,0,88,CLE,28,20,34,35,0,117
10/29/2016,MEM,19,30,28,27,0,104,NYK,32,25,25,29,0,111
11/1/2016,NYK,29,26,24,10,0,89,DET,32,32,22,16,0,102
11/2/2016,HOU,33,35,32,18,0,118,NYK,25,26,27,21,0,99
11/4/2016,NYK,32,24,28,33,0,117,CHI,23,34,24,23,0,104
11/6/2016,UTA,20,29,29,36,0,114,NYK,30,24,26,29,0,109
11/9/2016,BRK,29,26,16,25,0,96,NYK,19,31,22,38,0,110
11/11/2016,NYK,27,24,22,14,0,87,BOS,31,30,25,29,0,115
11/12/2016,NYK,28,28,29,22,0,107,TOR,24,29,34,31,0,118
11/14/2016,DAL,23,16,12,26,0,77,NYK,15,21,31,26,0,93
11/16/2016,DET,27,22,25,28,0,102,NYK,29,25,27,24,0,105
11/17/2016,NYK,18,24,23,47,0,112,WAS,24,28,35,32,0,119
11/20/2016,ATL,20,21,25,28,0,94,NYK,24,22,29,29,0,104
11/22/2016,POR,33,25,23,22,0,103,NYK,28,32,21,26,0,107
11/25/2016,CHO,28,28,18,30,7,111,NYK,30,22,27,25,9,113
11/26/2016,NYK,22,25,24,31,0,102,CHO,38,20,17,32,0,107
11/28/2016,OKC,24,34,30,24,0,112,NYK,29,26,26,22,0,103
11/30/2016,NYK,28,30,23,25,0,106,MIN,31,18,25,30,0,104
12/2/2016,MIN,21,31,36,26,0,114,NYK,30,32,36,20,0,118
12/4/2016,SAC,21,20,36,21,0,98,NYK,26,29,26,25,0,106
12/6/2016,NYK,26,27,31,30,0,114,MIA,25,29,23,26,0,103
12/7/2016,CLE,36,27,29,34,0,126,NYK,26,22,17,29,0,94
12/9/2016,NYK,30,24,24,25,0,103,SAC,32,21,24,23,0,100
12/11/2016,NYK,32,25,27,34,0,118,LAL,30,26,19,37,0,112
12/13/2016,NYK,25,21,27,28,10,111,PHO,31,23,31,16,12,113
12/15/2016,NYK,25,20,21,24,0,90,GSW,32,27,29,15,0,103
12/17/2016,NYK,22,32,26,34,0,114,DEN,33,29,34,31,0,127
12/20/2016,IND,24,35,28,24,0,111,NYK,20,34,30,34,0,118
12/22/2016,ORL,19,28,25,23,0,95,NYK,27,30,24,25,0,106
12/25/2016,BOS,22,34,32,31,0,119,NYK,28,20,34,32,0,114
12/28/2016,NYK,25,22,19,19,13,98,ATL,22,23,20,20,17,102
12/30/2016,NYK,21,30,18,23,0,92,NOP,31,24,24,25,0,104
12/31/2016,NYK,32,23,37,30,0,122,HOU,27,42,30,30,0,129
1/2/2017,ORL,33,34,25,23,0,115,NYK,32,27,21,23,0,103
1/4/2017,MIL,27,25,21,32,0,105,NYK,25,27,35,17,0,104
1/6/2017,NYK,32,21,30,33,0,116,MIL,33,32,31,15,0,111
1/7/2017,NYK,29,14,27,39,0,109,IND,33,29,34,27,0,123
1/9/2017,NOP,29,31,31,19,0,110,NYK,26,25,15,30,0,96
1/11/2017,NYK,32,20,23,22,0,97,PHI,27,20,24,27,0,98
1/12/2017,CHI,22,29,14,24,0,89,NYK,24,30,22,28,0,104
1/15/2017,NYK,26,28,8,39,0,101,TOR,27,42,27,20,0,116
1/16/2017,ATL,26,27,35,20,0,108,NYK,27,27,29,24,0,107
1/18/2017,NYK,31,32,25,29,0,117,BOS,34,20,29,23,0,106
1/19/2017,WAS,38,28,34,13,0,113,NYK,27,40,19,24,0,110
1/21/2017,PHO,30,31,29,17,0,107,NYK,33,22,35,15,0,105
1/23/2017,NYK,22,40,24,23,0,109,IND,34,24,17,28,0,103
1/25/2017,NYK,25,26,22,22,0,95,DAL,30,22,26,25,0,103
1/27/2017,CHO,23,28,36,20,0,107,NYK,29,25,28,28,0,110
1/29/2017,NYK,37,28,16,23,9,139,ATL,30,31,22,21,9,142
1/31/2017,NYK,28,26,22,25,0,101,WAS,28,31,32,26,0,117
2/1/2017,NYK,15,23,26,31,0,95,BRK,27,18,24,21,0,90
2/4/2017,CLE,34,30,20,27,0,111,NYK,25,20,23,36,0,104
2/6/2017,LAL,29,32,36,24,0,121,NYK,19,26,28,34,0,107
2/8/2017,LAC,36,32,20,31,0,119,NYK,36,31,28,20,0,115
2/10/2017,DEN,34,30,36,31,0,131,NYK,32,34,22,35,0,123
2/12/2017,SAS,21,27,17,25,0,90,NYK,18,24,27,25,0,94
2/15/2017,NYK,39,21,20,25,0,105,OKC,27,35,26,28,0,116
2/23/2017,NYK,33,18,28,25,0,104,CLE,34,35,18,32,0,119
2/25/2017,PHI,25,25,25,34,0,109,NYK,31,29,26,24,0,110
2/27/2017,TOR,21,19,23,29,0,92,NYK,25,28,14,24,0,91
3/1/2017,NYK,31,29,19,22,0,101,ORL,24,27,16,23,0,90
3/3/2017,NYK,35,18,28,21,0,102,PHI,29,34,16,26,0,105
3/5/2017,GSW,29,20,35,28,0,112,NYK,18,32,26,29,0,105
3/6/2017,NYK,20,31,34,28,0,113,ORL,28,26,38,13,0,105
3/8/2017,NYK,30,26,17,20,0,93,MIL,32,23,21,28,0,104
3/11/2017,NYK,23,30,28,11,0,92,DET,35,31,23,23,0,112
3/12/2017,NYK,26,23,31,32,0,112,BRK,39,28,24,29,0,120
3/14/2017,IND,24,28,12,17,0,81,NYK,18,24,20,25,0,87
3/16/2017,BRK,28,26,38,29,0,121,NYK,33,28,26,23,0,110
3/20/2017,NYK,23,30,19,33,0,105,LAC,29,34,34,17,0,114
3/22/2017,NYK,34,21,20,26,0,101,UTA,26,25,21,36,0,108
3/23/2017,NYK,23,23,22,27,0,95,POR,37,30,18,25,0,110
3/25/2017,NYK,23,20,31,24,0,98,SAS,33,28,17,28,0,106
3/27/2017,DET,36,23,15,21,0,95,NYK,34,30,25,20,0,109
3/29/2017,MIA,24,25,28,28,0,105,NYK,22,19,27,20,0,88
3/31/2017,NYK,33,26,18,21,0,98,MIA,29,26,20,19,0,94
4/2/2017,BOS,34,26,28,22,0,110,NYK,23,24,24,23,0,94
4/4/2017,CHI,24,16,24,27,0,91,NYK,29,25,26,20,0,100
4/6/2017,WAS,33,26,23,24,0,106,NYK,27,24,24,28,0,103
4/7/2017,NYK,21,26,25,16,0,88,MEM,27,26,17,31,0,101
4/9/2017,TOR,23,29,24,34,0,110,NYK,29,26,20,22,0,97
4/12/2017,PHI,22,37,28,26,0,113,NYK,25,31,22,36,0,114
10/26/2016,DEN,30,30,25,22,0,107,NOP,24,24,29,25,0,102
10/28/2016,GSW,32,27,33,30,0,122,NOP,22,28,31,33,0,114
10/29/2016,NOP,23,22,15,19,0,79,SAS,28,27,28,15,0,98
11/1/2016,MIL,29,34,21,33,0,117,NOP,32,22,32,27,0,113
11/2/2016,NOP,13,35,11,16,8,83,MEM,21,20,25,9,14,89
11/4/2016,PHO,30,28,23,21,10,112,NOP,29,32,18,23,9,111
11/7/2016,NOP,24,25,29,28,0,106,GSW,28,35,21,32,0,116
11/8/2016,NOP,26,20,24,24,0,94,SAC,33,20,23,26,0,102
11/10/2016,NOP,26,35,27,24,0,112,MIL,27,27,27,25,0,106
11/12/2016,LAL,30,25,29,42,0,126,NOP,26,30,15,28,0,99
11/14/2016,BOS,26,25,23,31,0,105,NOP,27,29,28,22,0,106
11/16/2016,NOP,19,21,23,19,0,82,ORL,21,31,13,24,0,89
11/18/2016,POR,28,23,24,26,0,101,NOP,31,33,24,25,0,113
11/19/2016,CHO,23,23,39,23,8,116,NOP,21,26,27,34,13,121
11/22/2016,NOP,34,32,29,17,0,112,ATL,14,30,27,23,0,94
11/23/2016,MIN,26,24,18,28,0,96,NOP,31,22,36,28,0,117
11/25/2016,NOP,34,23,26,21,0,104,POR,32,34,34,19,0,119
11/27/2016,NOP,20,22,18,21,0,81,DAL,26,18,16,31,0,91
11/29/2016,LAL,22,19,22,25,0,88,NOP,33,32,24,16,0,105
12/2/2016,LAC,25,35,29,25,0,114,NOP,30,27,19,20,0,96
12/4/2016,NOP,26,15,25,26,0,92,OKC,29,20,29,23,0,101
12/5/2016,MEM,17,27,30,20,6,110,NOP,21,25,23,25,6,108
12/8/2016,PHI,26,26,19,28,0,99,NOP,31,26,12,19,0,88
12/10/2016,NOP,31,24,25,25,0,105,LAC,35,26,37,35,0,133
12/11/2016,NOP,25,26,25,34,10,120,PHO,31,27,24,28,9,119
12/13/2016,GSW,29,29,37,18,0,113,NOP,35,30,29,15,0,109
12/15/2016,IND,20,30,24,21,0,95,NOP,24,22,25,31,0,102
12/16/2016,NOP,24,26,29,21,0,100,HOU,35,37,25,25,0,122
12/18/2016,NOP,26,23,22,29,0,100,SAS,30,31,31,21,0,113
12/20/2016,NOP,15,42,27,24,0,108,PHI,23,21,25,24,0,93
12/21/2016,OKC,34,29,24,34,0,121,NOP,28,30,26,26,0,110
12/23/2016,MIA,28,21,19,19,0,87,NOP,25,19,20,27,0,91
12/26/2016,DAL,20,33,24,27,0,104,NOP,25,30,30,26,0,111
12/28/2016,LAC,27,29,21,21,0,98,NOP,19,30,27,26,0,102
12/30/2016,NYK,21,30,18,23,0,92,NOP,31,24,24,25,0,104
1/2/2017,NOP,22,21,26,13,0,82,CLE,15,29,23,23,0,90
1/5/2017,ATL,23,19,33,24,0,99,NOP,28,19,25,22,0,94
1/7/2017,NOP,31,22,20,35,0,108,BOS,28,29,36,24,0,117
1/9/2017,NOP,29,31,31,19,0,110,NYK,26,25,15,30,0,96
1/12/2017,NOP,35,16,22,31,0,104,BRK,31,26,22,16,0,95
1/14/2017,NOP,22,23,26,28,0,99,CHI,21,34,22,30,0,107
1/16/2017,NOP,18,34,18,25,0,95,IND,32,22,22,22,0,98
1/18/2017,ORL,29,23,21,25,0,98,NOP,32,33,27,26,0,118
1/20/2017,BRK,29,37,43,34,0,143,NOP,32,22,30,30,0,114
1/23/2017,CLE,26,24,36,36,0,122,NOP,35,35,24,30,0,124
1/25/2017,OKC,33,31,28,22,0,114,NOP,20,25,37,23,0,105
1/27/2017,SAS,20,37,27,19,0,103,NOP,23,25,37,34,0,119
1/29/2017,WAS,29,28,17,33,0,107,NOP,23,17,33,21,0,94
1/31/2017,NOP,25,35,15,21,10,106,TOR,23,23,31,19,12,108
2/1/2017,NOP,30,24,27,17,0,98,DET,34,26,23,35,0,118
2/4/2017,NOP,18,31,34,8,0,91,WAS,24,29,27,25,0,105
2/6/2017,PHO,21,21,32,32,0,106,NOP,29,18,30,34,0,111
2/8/2017,UTA,32,30,28,37,0,127,NOP,25,28,16,25,0,94
2/10/2017,NOP,28,33,37,24,0,122,MIN,40,25,24,17,0,106
2/12/2017,NOP,29,27,17,26,0,99,SAC,23,30,23,29,0,105
2/13/2017,NOP,29,24,24,33,0,110,PHO,28,30,22,28,0,108
2/15/2017,NOP,28,22,27,18,0,95,MEM,22,21,18,30,0,91
2/23/2017,HOU,30,36,34,29,0,129,NOP,28,22,17,32,0,99
2/25/2017,NOP,30,19,14,20,0,83,DAL,24,23,20,29,0,96
2/26/2017,NOP,35,24,25,26,0,110,OKC,32,27,28,31,0,118
3/1/2017,DET,18,32,20,16,0,86,NOP,31,22,25,31,0,109
3/3/2017,SAS,27,22,18,22,12,101,NOP,30,18,18,23,9,98
3/5/2017,NOP,26,29,28,22,0,105,LAL,20,39,14,24,0,97
3/6/2017,NOP,14,20,18,31,0,83,UTA,29,14,18,27,0,88
3/8/2017,TOR,22,23,23,26,0,94,NOP,26,20,18,23,0,87
3/11/2017,NOP,32,27,24,29,13,125,CHO,27,31,20,34,10,122
3/14/2017,POR,16,20,18,23,0,77,NOP,23,27,27,23,0,100
3/15/2017,NOP,21,31,27,33,0,112,MIA,28,26,31,35,0,120
3/17/2017,HOU,23,27,31,31,0,112,NOP,36,32,31,29,0,128
3/19/2017,MIN,34,20,30,25,0,109,NOP,28,20,40,35,0,123
3/21/2017,MEM,23,18,13,28,0,82,NOP,21,13,32,29,0,95
3/24/2017,NOP,33,17,29,28,0,107,HOU,28,21,31,37,0,117
3/26/2017,NOP,29,26,32,28,0,115,DEN,26,14,19,31,0,90
3/27/2017,NOP,21,30,20,29,0,100,UTA,28,28,25,27,0,108
3/29/2017,DAL,23,28,32,35,0,118,NOP,27,36,26,32,0,121
3/31/2017,SAC,19,19,26,25,0,89,NOP,32,26,26,33,0,117
4/2/2017,CHI,28,35,24,30,0,117,NOP,21,26,32,31,0,110
4/4/2017,DEN,27,42,33,32,0,134,NOP,31,44,30,26,0,131
4/7/2017,NOP,25,25,24,32,0,106,DEN,30,21,41,30,0,122
4/8/2017,NOP,17,29,22,33,0,101,GSW,23,31,39,30,0,123
4/11/2017,NOP,25,28,20,23,0,96,LAL,26,31,28,23,0,108
4/12/2017,NOP,22,31,25,25,0,103,POR,30,23,32,15,0,100
10/26/2016,DET,23,23,25,20,0,91,TOR,33,25,28,23,0,109
10/28/2016,ORL,22,9,20,31,0,82,DET,24,30,32,22,0,108
10/30/2016,MIL,21,18,26,18,0,83,DET,24,26,25,23,0,98
11/1/2016,NYK,29,26,24,10,0,89,DET,32,32,22,16,0,102
11/2/2016,DET,30,25,26,20,0,101,BRK,38,33,21,17,0,109
11/5/2016,DEN,12,32,23,19,0,86,DET,29,22,26,26,0,103
11/7/2016,DET,15,17,21,29,0,82,LAC,33,29,29,23,0,114
11/9/2016,DET,28,23,25,24,0,100,PHO,19,35,27,26,0,107
11/11/2016,DET,26,26,15,19,0,86,SAS,28,21,26,21,0,96
11/12/2016,DET,36,21,23,26,0,106,DEN,21,28,22,24,0,95
11/14/2016,OKC,25,22,21,20,0,88,DET,28,31,19,26,0,104
11/16/2016,DET,27,22,25,28,0,102,NYK,29,25,27,24,0,105
11/18/2016,DET,19,20,17,25,0,81,CLE,30,26,26,22,0,104
11/19/2016,BOS,30,20,21,23,0,94,DET,23,24,26,19,0,92
11/21/2016,HOU,18,33,28,20,0,99,DET,25,21,29,21,0,96
11/23/2016,MIA,16,26,22,20,0,84,DET,28,28,30,21,0,107
11/25/2016,LAC,23,25,32,17,0,97,DET,35,22,25,26,0,108
11/26/2016,DET,19,27,22,20,0,88,OKC,29,27,21,29,0,106
11/29/2016,DET,33,24,27,28,0,112,CHO,25,29,20,15,0,89
11/30/2016,DET,31,28,33,29,0,121,BOS,28,25,31,30,0,114
12/2/2016,DET,27,31,32,31,0,121,ATL,24,15,18,28,0,85
12/4/2016,ORL,23,35,20,20,0,98,DET,27,23,23,19,0,92
12/6/2016,CHI,21,23,28,19,0,91,DET,32,19,20,31,0,102
12/7/2016,DET,24,15,19,19,0,77,CHO,23,15,23,26,0,87
12/9/2016,DET,25,24,33,35,0,117,MIN,20,23,25,22,0,90
12/11/2016,PHI,32,26,22,17,0,97,DET,12,23,29,15,0,79
12/14/2016,DET,17,26,17,35,0,95,DAL,20,23,21,21,0,85
12/16/2016,DET,27,27,23,31,0,108,WAS,27,38,30,27,0,122
12/17/2016,IND,27,28,28,22,0,105,DET,26,18,25,21,0,90
12/19/2016,DET,19,15,29,19,0,82,CHI,35,34,28,16,0,113
12/21/2016,MEM,29,24,26,19,0,98,DET,19,25,19,23,0,86
12/23/2016,GSW,33,24,31,31,0,119,DET,32,27,25,29,0,113
12/26/2016,CLE,19,25,20,26,0,90,DET,22,28,26,30,0,106
12/28/2016,MIL,31,31,28,29,0,119,DET,28,26,21,19,0,94
12/30/2016,DET,19,22,21,36,0,98,ATL,19,32,23,31,0,105
1/1/2017,DET,33,25,27,22,0,107,MIA,37,29,15,17,0,98
1/3/2017,IND,36,30,26,29,0,121,DET,28,32,32,24,0,116
1/5/2017,CHO,26,22,22,44,0,114,DET,37,21,27,30,0,115
1/8/2017,DET,31,22,27,26,8,125,POR,30,26,31,19,8,124
1/10/2017,DET,29,27,21,17,0,94,SAC,21,22,25,32,0,100
1/12/2017,DET,30,28,19,30,0,107,GSW,37,23,41,26,0,127
1/13/2017,DET,19,24,20,14,0,77,UTA,14,31,33,32,0,110
1/15/2017,DET,23,36,16,27,0,102,LAL,31,26,15,25,0,97
1/18/2017,ATL,18,27,23,27,0,95,DET,42,27,25,24,0,118
1/21/2017,WAS,26,29,27,30,0,112,DET,30,31,37,15,0,113
1/23/2017,SAC,28,37,23,21,0,109,DET,38,24,19,23,0,104
1/28/2017,DET,33,27,31,12,0,103,MIA,35,29,26,26,0,116
1/30/2017,DET,25,21,24,39,0,109,BOS,26,28,25,34,0,113
2/1/2017,NOP,30,24,27,17,0,98,DET,34,26,23,35,0,118
2/3/2017,MIN,18,34,24,32,0,108,DET,24,29,30,33,0,116
2/4/2017,DET,32,26,14,12,0,84,IND,30,26,26,23,0,105
2/6/2017,PHI,27,19,21,29,0,96,DET,24,31,34,24,0,113
2/8/2017,LAL,25,25,20,32,0,102,DET,25,31,36,29,0,121
2/10/2017,SAS,27,33,23,20,0,103,DET,19,22,25,26,0,92
2/12/2017,DET,25,20,21,36,0,102,TOR,27,24,31,19,0,101
2/13/2017,DET,19,15,27,28,0,89,MIL,23,28,26,25,0,102
2/15/2017,DAL,17,18,28,28,0,91,DET,27,35,16,20,0,98
2/23/2017,CHO,28,34,23,15,8,108,DET,23,27,20,30,14,114
2/26/2017,BOS,27,27,25,25,0,104,DET,23,27,24,24,0,98
2/28/2017,POR,27,22,30,30,4,113,DET,19,25,31,34,11,120
3/1/2017,DET,18,32,20,16,0,86,NOP,31,22,25,31,0,109
3/4/2017,DET,33,34,39,30,0,136,PHI,25,27,30,24,0,106
3/6/2017,CHI,26,29,24,16,0,95,DET,14,37,28,30,0,109
3/8/2017,DET,23,27,23,25,0,98,IND,30,28,32,25,0,115
3/9/2017,CLE,29,23,28,21,0,101,DET,22,33,18,33,0,106
3/11/2017,NYK,23,30,28,11,0,92,DET,35,31,23,23,0,112
3/14/2017,DET,26,22,22,26,0,96,CLE,44,30,30,24,0,128
3/15/2017,UTA,28,26,23,20,0,97,DET,19,16,27,21,0,83
3/17/2017,TOR,16,24,20,27,0,87,DET,13,25,28,9,0,75
3/19/2017,PHO,23,26,26,20,0,95,DET,24,23,30,35,0,112
3/21/2017,DET,31,13,21,31,0,96,BRK,22,28,24,24,0,98
3/22/2017,DET,23,30,20,22,0,95,CHI,32,27,32,26,0,117
3/24/2017,DET,18,21,23,25,0,87,ORL,22,35,35,23,0,115
3/27/2017,DET,36,23,15,21,0,95,NYK,34,30,25,20,0,109
3/28/2017,MIA,24,31,23,19,0,97,DET,24,26,19,27,0,96
3/30/2017,BRK,18,21,24,26,0,89,DET,16,19,24,31,0,90
3/31/2017,DET,22,26,25,22,10,105,MIL,35,21,15,24,13,108
4/5/2017,TOR,15,31,22,37,0,105,DET,33,23,24,22,0,102
4/7/2017,DET,24,28,23,39,0,114,HOU,30,24,33,22,0,109
4/9/2017,DET,24,24,27,28,0,103,MEM,28,29,10,23,0,90
4/10/2017,WAS,34,21,24,26,0,105,DET,21,21,31,28,0,101
4/12/2017,DET,17,32,32,28,0,109,ORL,38,21,28,26,0,113
10/27/2016,WAS,27,29,24,19,0,99,ATL,29,28,24,33,0,114
10/29/2016,ATL,29,24,21,30,0,104,PHI,24,15,19,14,0,72
10/31/2016,SAC,15,29,37,14,0,95,ATL,22,31,26,27,0,106
11/2/2016,LAL,28,23,39,33,0,123,ATL,37,23,34,22,0,116
11/4/2016,ATL,19,16,28,29,0,92,WAS,19,29,23,24,0,95
11/5/2016,HOU,30,29,25,13,0,97,ATL,30,35,28,19,0,112
11/8/2016,ATL,20,33,31,26,0,110,CLE,20,22,37,27,0,106
11/9/2016,CHI,27,34,27,19,0,107,ATL,35,33,26,21,0,115
11/12/2016,PHI,27,21,30,18,0,96,ATL,23,36,28,30,0,117
11/15/2016,ATL,22,27,23,21,0,93,MIA,25,18,24,23,0,90
11/16/2016,MIL,26,9,35,30,0,100,ATL,21,31,32,23,0,107
11/18/2016,ATL,28,17,35,16,0,96,CHO,29,19,27,25,0,100
11/20/2016,ATL,20,21,25,28,0,94,NYK,24,22,29,29,0,104
11/22/2016,NOP,34,32,29,17,0,112,ATL,14,30,27,23,0,94
11/23/2016,ATL,31,18,25,22,0,96,IND,24,20,22,19,0,85
11/25/2016,ATL,23,11,14,20,0,68,UTA,24,24,13,34,0,95
11/27/2016,ATL,32,16,29,17,0,94,LAL,21,35,28,25,0,109
11/28/2016,ATL,27,26,28,19,0,100,GSW,29,21,30,25,0,105
11/30/2016,ATL,27,21,27,32,0,107,PHO,36,14,27,32,0,109
12/2/2016,DET,27,31,32,31,0,121,ATL,24,15,18,28,0,85
12/3/2016,ATL,22,25,23,14,0,84,TOR,32,30,24,42,0,128
12/5/2016,OKC,23,32,28,19,0,102,ATL,21,33,15,30,0,99
12/7/2016,MIA,25,21,17,32,0,95,ATL,29,24,25,25,0,103
12/9/2016,ATL,23,21,40,30,0,114,MIL,30,34,28,18,0,110
12/13/2016,ORL,35,37,27,32,0,131,ATL,34,28,34,24,0,120
12/16/2016,ATL,35,34,26,30,0,125,TOR,27,25,30,39,0,121
12/17/2016,CHO,22,31,27,27,0,107,ATL,22,20,32,25,0,99
12/19/2016,ATL,22,26,33,29,0,110,OKC,16,37,25,30,0,108
12/21/2016,MIN,28,21,18,25,0,92,ATL,26,18,25,15,0,84
12/23/2016,ATL,29,22,31,27,0,109,DEN,29,26,27,26,0,108
12/26/2016,ATL,25,20,20,25,0,90,MIN,23,31,35,15,0,104
12/28/2016,NYK,25,22,19,19,13,98,ATL,22,23,20,20,17,102
12/30/2016,DET,19,22,21,36,0,98,ATL,19,32,23,31,0,105
1/1/2017,SAS,27,19,28,26,12,112,ATL,25,19,25,31,14,114
1/4/2017,ATL,23,29,26,33,0,111,ORL,26,21,18,27,0,92
1/5/2017,ATL,23,19,33,24,0,99,NOP,28,19,25,22,0,94
1/7/2017,ATL,22,23,21,31,0,97,DAL,20,22,17,23,0,82
1/10/2017,ATL,35,26,25,31,0,117,BRK,29,14,27,27,0,97
1/13/2017,BOS,28,20,30,25,0,103,ATL,18,26,21,36,0,101
1/15/2017,MIL,36,17,30,15,0,98,ATL,36,24,28,23,0,111
1/16/2017,ATL,26,27,35,20,0,108,NYK,27,27,29,24,0,107
1/18/2017,ATL,18,27,23,27,0,95,DET,42,27,25,24,0,118
1/20/2017,CHI,13,23,21,36,0,93,ATL,35,30,22,15,0,102
1/21/2017,PHI,25,29,23,16,0,93,ATL,25,37,28,20,0,110
1/23/2017,LAC,30,28,27,30,0,115,ATL,21,19,35,30,0,105
1/25/2017,ATL,22,29,27,41,0,119,CHI,29,30,24,31,0,114
1/27/2017,WAS,37,30,26,19,0,112,ATL,25,20,23,18,0,86
1/29/2017,NYK,37,28,16,23,9,139,ATL,30,31,22,21,9,142
2/1/2017,ATL,22,25,24,22,0,93,MIA,29,33,32,22,0,116
2/2/2017,ATL,26,21,26,40,0,113,HOU,32,18,36,22,0,108
2/4/2017,ORL,24,15,26,21,0,86,ATL,35,30,26,22,0,113
2/6/2017,UTA,29,25,37,29,0,120,ATL,21,29,23,22,0,95
2/8/2017,DEN,30,25,32,19,0,106,ATL,39,33,26,19,0,117
2/10/2017,ATL,28,31,25,23,0,107,SAC,17,26,31,34,0,108
2/13/2017,ATL,21,21,33,22,12,109,POR,28,20,26,23,7,104
2/15/2017,ATL,22,18,24,20,0,84,LAC,21,33,29,16,0,99
2/24/2017,MIA,25,38,24,21,0,108,ATL,24,25,17,24,0,90
2/25/2017,ATL,19,27,19,21,0,86,ORL,22,27,31,25,0,105
2/27/2017,ATL,24,27,33,30,0,114,BOS,24,23,24,27,0,98
3/1/2017,DAL,22,30,24,19,0,95,ATL,27,36,18,19,0,100
3/3/2017,CLE,39,38,29,29,0,135,ATL,33,27,28,42,0,130
3/5/2017,IND,19,31,31,16,0,97,ATL,30,20,24,22,0,96
3/6/2017,GSW,35,26,33,25,0,119,ATL,42,24,24,21,0,111
3/8/2017,BRK,27,23,30,25,0,105,ATL,23,23,35,29,0,110
3/10/2017,TOR,19,29,27,24,0,99,ATL,18,31,25,31,0,105
3/11/2017,ATL,33,14,30,30,0,107,MEM,15,20,22,33,0,90
3/13/2017,ATL,18,25,30,26,0,99,SAS,28,26,27,26,0,107
3/16/2017,MEM,26,29,23,25,0,103,ATL,28,24,13,26,0,91
3/18/2017,POR,40,23,22,28,0,113,ATL,18,28,27,24,0,97
3/20/2017,ATL,19,23,26,22,0,90,CHO,19,32,32,22,0,105
3/22/2017,ATL,20,26,21,33,0,100,WAS,16,24,27,37,0,104
3/24/2017,ATL,21,22,31,23,0,97,MIL,29,16,27,28,0,100
3/26/2017,BRK,32,23,23,29,0,107,ATL,20,28,20,24,0,92
3/28/2017,PHO,12,32,24,23,0,91,ATL,27,20,24,24,0,95
3/29/2017,ATL,25,27,27,20,0,99,PHI,18,25,27,22,0,92
4/1/2017,ATL,21,25,38,20,0,104,CHI,23,29,27,27,0,106
4/2/2017,ATL,24,19,18,21,0,82,BRK,29,17,24,21,0,91
4/6/2017,BOS,24,31,34,27,0,116,ATL,32,39,28,24,0,123
4/7/2017,ATL,21,31,31,31,0,114,CLE,19,31,28,22,0,100
4/9/2017,CLE,38,27,28,18,14,125,ATL,21,25,21,44,15,126
4/11/2017,CHO,26,18,17,15,0,76,ATL,38,25,21,19,0,103
4/12/2017,ATL,15,28,25,18,0,86,IND,22,28,34,20,0,104
10/27/2016,BOS,20,29,24,26,0,99,CHI,30,27,22,26,0,105
10/29/2016,IND,20,21,26,34,0,101,CHI,24,38,30,26,0,118
10/31/2016,CHI,38,27,28,25,0,118,BRK,20,24,22,22,0,88
11/2/2016,CHI,25,27,18,30,0,100,BOS,36,19,26,26,0,107
11/4/2016,NYK,32,24,28,33,0,117,CHI,23,34,24,23,0,104
11/5/2016,CHI,15,28,21,30,0,94,IND,31,31,26,23,0,111
11/7/2016,ORL,24,28,11,17,0,80,CHI,37,24,27,24,0,112
11/9/2016,CHI,27,34,27,19,0,107,ATL,35,33,26,21,0,115
11/10/2016,CHI,23,30,17,28,0,98,MIA,22,31,17,25,0,95
11/12/2016,WAS,27,29,14,25,0,95,CHI,28,25,28,25,0,106
11/15/2016,CHI,35,21,27,30,0,113,POR,14,23,26,25,0,88
11/17/2016,CHI,25,16,25,19,0,85,UTA,26,17,15,19,0,77
11/19/2016,CHI,33,19,25,18,0,95,LAC,23,24,25,30,0,102
11/20/2016,CHI,30,32,28,28,0,118,LAL,30,31,24,25,0,110
11/22/2016,CHI,31,29,28,19,0,107,DEN,19,41,31,19,0,110
11/25/2016,CHI,23,34,33,15,0,105,PHI,19,28,17,25,0,89
11/30/2016,LAL,17,30,23,26,0,96,CHI,28,19,26,17,0,90
12/2/2016,CLE,33,27,20,25,0,105,CHI,30,29,29,23,0,111
12/3/2016,CHI,18,27,21,16,0,82,DAL,29,28,25,25,0,107
12/5/2016,POR,29,36,21,26,0,112,CHI,32,25,30,23,0,110
12/6/2016,CHI,21,23,28,19,0,91,DET,32,19,20,31,0,102
12/8/2016,SAS,17,15,31,28,0,91,CHI,21,24,27,23,0,95
12/10/2016,MIA,27,28,20,25,0,100,CHI,29,26,28,22,0,105
12/13/2016,MIN,22,30,26,21,0,99,CHI,38,18,19,19,0,94
12/15/2016,CHI,18,27,21,31,0,97,MIL,30,34,24,20,0,108
12/16/2016,MIL,34,22,18,21,0,95,CHI,15,22,15,17,0,69
12/19/2016,DET,19,15,29,19,0,82,CHI,35,34,28,16,0,113
12/21/2016,WAS,22,33,22,30,0,107,CHI,33,23,21,20,0,97
12/23/2016,CHI,26,14,27,24,0,91,CHO,22,26,27,28,0,103
12/25/2016,CHI,25,25,26,24,0,100,SAS,36,19,32,32,0,119
12/26/2016,IND,19,22,20,24,0,85,CHI,28,23,12,27,0,90
12/28/2016,BRK,20,29,29,21,0,99,CHI,23,23,30,25,0,101
12/30/2016,CHI,22,28,23,28,0,101,IND,28,34,22,27,0,111
12/31/2016,MIL,22,27,31,36,0,116,CHI,27,24,25,20,0,96
1/2/2017,CHO,23,34,28,26,0,111,CHI,25,33,24,36,0,118
1/4/2017,CHI,16,36,31,23,0,106,CLE,23,23,28,20,0,94
1/7/2017,TOR,28,33,25,21,11,118,CHI,29,19,26,33,16,123
1/9/2017,OKC,26,35,28,20,0,109,CHI,20,26,21,27,0,94
1/10/2017,CHI,36,25,16,22,0,99,WAS,26,23,32,20,0,101
1/12/2017,CHI,22,29,14,24,0,89,NYK,24,30,22,28,0,104
1/14/2017,NOP,22,23,26,28,0,99,CHI,21,34,22,30,0,107
1/15/2017,CHI,14,38,26,30,0,108,MEM,19,27,31,27,0,104
1/17/2017,DAL,24,30,22,23,0,99,CHI,28,19,27,24,0,98
1/20/2017,CHI,13,23,21,36,0,93,ATL,35,30,22,15,0,102
1/21/2017,SAC,21,31,21,26,0,99,CHI,24,31,20,27,0,102
1/24/2017,CHI,20,32,26,22,0,100,ORL,22,27,24,19,0,92
1/25/2017,ATL,22,29,27,41,0,119,CHI,29,30,24,31,0,114
1/27/2017,MIA,33,20,24,23,0,100,CHI,24,29,14,21,0,88
1/29/2017,PHI,23,34,30,21,0,108,CHI,37,30,29,25,0,121
2/1/2017,CHI,21,34,39,34,0,128,OKC,20,27,26,27,0,100
2/3/2017,CHI,26,23,32,27,9,117,HOU,24,36,19,29,13,121
2/6/2017,CHI,27,33,25,27,0,112,SAC,11,34,24,38,0,107
2/8/2017,CHI,17,24,29,22,0,92,GSW,30,25,31,37,0,123
2/10/2017,CHI,26,17,33,21,0,97,PHO,28,28,30,29,0,115
2/12/2017,CHI,17,23,25,24,0,89,MIN,34,23,27,33,0,117
2/14/2017,TOR,18,21,25,30,0,94,CHI,24,34,20,27,0,105
2/16/2017,BOS,25,33,20,25,0,103,CHI,22,30,29,23,0,104
2/24/2017,PHO,25,29,25,29,13,121,CHI,24,28,28,28,20,128
2/25/2017,CHI,23,32,34,28,0,117,CLE,22,34,20,23,0,99
2/28/2017,DEN,22,34,35,34,0,125,CHI,25,34,24,24,0,107
3/2/2017,GSW,26,25,22,14,0,87,CHI,19,28,32,15,0,94
3/4/2017,LAC,23,32,27,19,0,101,CHI,29,32,12,18,0,91
3/6/2017,CHI,26,29,24,16,0,95,DET,14,37,28,30,0,109
3/8/2017,CHI,22,31,24,14,0,91,ORL,19,24,34,21,0,98
3/10/2017,HOU,23,33,36,23,0,115,CHI,33,16,14,31,0,94
3/12/2017,CHI,9,17,31,23,0,80,BOS,22,24,30,24,0,100
3/13/2017,CHI,36,22,29,28,0,115,CHO,24,24,29,32,0,109
3/15/2017,MEM,24,30,20,24,0,98,CHI,24,26,21,20,0,91
3/17/2017,CHI,23,17,32,35,0,107,WAS,29,30,25,28,0,112
3/18/2017,UTA,23,21,20,22,0,86,CHI,16,24,21,34,0,95
3/21/2017,CHI,31,28,35,19,7,120,TOR,27,27,25,34,9,122
3/22/2017,DET,23,30,20,22,0,95,CHI,32,27,32,26,0,117
3/24/2017,PHI,24,35,34,24,0,117,CHI,28,18,25,36,0,107
3/26/2017,CHI,29,27,35,18,0,109,MIL,31,24,24,15,0,94
3/30/2017,CLE,28,22,21,22,0,93,CHI,22,19,37,21,0,99
4/1/2017,ATL,21,25,38,20,0,104,CHI,23,29,27,27,0,106
4/2/2017,CHI,28,35,24,30,0,117,NOP,21,26,32,31,0,110
4/4/2017,CHI,24,16,24,27,0,91,NYK,29,25,26,20,0,100
4/6/2017,CHI,27,26,27,22,0,102,PHI,17,30,20,23,0,90
4/8/2017,CHI,25,20,37,24,0,106,BRK,32,19,24,32,0,107
4/10/2017,ORL,13,24,22,16,0,75,CHI,34,30,28,30,0,122
4/12/2017,BRK,13,19,24,17,0,73,CHI,27,23,25,37,0,112
10/26/2016,MIA,23,27,30,28,0,108,ORL,27,26,16,27,0,96
10/28/2016,CHO,21,25,27,24,0,97,MIA,23,34,20,14,0,91
10/30/2016,SAS,24,28,25,29,0,106,MIA,19,25,28,27,0,99
11/1/2016,SAC,26,24,17,24,5,96,MIA,28,26,19,18,17,108
11/4/2016,MIA,27,19,26,15,0,87,TOR,25,27,23,21,0,96
11/7/2016,MIA,28,19,14,24,0,85,OKC,39,16,28,14,0,97
11/10/2016,CHI,23,30,17,28,0,98,MIA,22,31,17,25,0,95
11/12/2016,UTA,23,29,24,26,0,102,MIA,21,26,12,32,0,91
11/14/2016,MIA,19,21,20,30,0,90,SAS,25,30,16,23,0,94
11/15/2016,ATL,22,27,23,21,0,93,MIA,25,18,24,23,0,90
11/17/2016,MIL,27,21,14,11,0,73,MIA,21,27,19,29,0,96
11/19/2016,MIA,33,27,31,23,0,114,WAS,35,24,23,29,0,111
11/21/2016,MIA,30,15,31,18,0,94,PHI,24,22,32,23,0,101
11/23/2016,MIA,16,26,22,20,0,84,DET,28,28,30,21,0,107
11/25/2016,MIA,28,17,26,19,0,90,MEM,19,20,18,24,0,81
11/26/2016,MEM,24,27,31,28,0,110,MIA,31,18,33,25,0,107
11/28/2016,BOS,21,27,35,29,0,112,MIA,19,12,42,31,0,104
11/30/2016,MIA,28,24,23,31,0,106,DEN,30,17,33,18,0,98
12/1/2016,MIA,26,26,31,28,0,111,UTA,27,21,29,33,0,110
12/3/2016,MIA,29,20,22,21,0,92,POR,21,34,18,26,0,99
12/6/2016,NYK,26,27,31,30,0,114,MIA,25,29,23,26,0,103
12/7/2016,MIA,25,21,17,32,0,95,ATL,29,24,25,25,0,103
12/9/2016,MIA,27,19,23,15,0,84,CLE,31,26,30,27,0,114
12/10/2016,MIA,27,28,20,25,0,100,CHI,29,26,28,22,0,105
12/12/2016,WAS,29,24,29,19,0,101,MIA,28,31,22,31,0,112
12/14/2016,IND,21,31,27,10,0,89,MIA,20,33,25,17,0,95
12/16/2016,LAC,31,29,19,23,0,102,MIA,27,19,23,29,0,98
12/18/2016,BOS,37,21,19,28,0,105,MIA,19,22,30,24,0,95
12/20/2016,ORL,27,30,28,24,9,136,MIA,28,36,25,20,9,130
12/22/2016,LAL,25,35,20,27,0,107,MIA,17,36,29,33,0,115
12/23/2016,MIA,28,21,19,19,0,87,NOP,25,19,20,27,0,91
12/27/2016,OKC,33,28,26,19,0,106,MIA,19,29,21,25,0,94
12/29/2016,MIA,19,30,17,16,0,82,CHO,21,21,31,18,0,91
12/30/2016,MIA,25,23,30,36,0,114,BOS,25,27,30,35,0,117
1/1/2017,DET,33,25,27,22,0,107,MIA,37,29,15,17,0,98
1/3/2017,MIA,29,23,14,24,0,90,PHO,28,28,27,16,0,99
1/4/2017,MIA,30,34,23,20,0,107,SAC,25,34,22,21,0,102
1/6/2017,MIA,23,33,23,21,0,100,LAL,32,26,32,37,0,127
1/8/2017,MIA,19,20,27,20,0,86,LAC,20,32,28,18,0,98
1/10/2017,MIA,29,25,14,27,0,95,GSW,27,26,26,28,0,107
1/13/2017,MIA,30,18,26,34,0,108,MIL,42,23,26,25,0,116
1/17/2017,HOU,32,21,26,24,0,103,MIA,27,26,26,30,0,109
1/19/2017,DAL,22,31,20,22,0,95,MIA,29,15,26,29,0,99
1/21/2017,MIL,22,21,28,26,0,97,MIA,25,28,29,27,0,109
1/23/2017,GSW,30,18,25,29,0,102,MIA,28,18,31,28,0,105
1/25/2017,MIA,34,21,16,38,0,109,BRK,30,36,23,17,0,106
1/27/2017,MIA,33,20,24,23,0,100,CHI,24,29,14,21,0,88
1/28/2017,DET,33,27,31,12,0,103,MIA,35,29,26,26,0,116
1/30/2017,BRK,32,20,25,19,0,96,MIA,28,28,28,20,0,104
2/1/2017,ATL,22,25,24,22,0,93,MIA,29,33,32,22,0,116
2/4/2017,PHI,17,35,23,27,0,102,MIA,32,32,36,25,0,125
2/6/2017,MIA,40,31,22,22,0,115,MIN,33,24,31,25,0,113
2/8/2017,MIA,28,27,26,25,0,106,MIL,15,29,19,25,0,88
2/10/2017,MIA,20,29,25,34,0,108,BRK,22,31,19,27,0,99
2/11/2017,MIA,27,21,28,33,0,109,PHI,27,27,30,33,0,117
2/13/2017,ORL,36,24,27,29,0,116,MIA,28,29,30,20,0,107
2/15/2017,MIA,34,24,30,29,0,117,HOU,28,17,28,36,0,109
2/24/2017,MIA,25,38,24,21,0,108,ATL,24,25,17,24,0,90
2/25/2017,IND,23,31,25,16,0,95,MIA,18,35,30,30,0,113
2/27/2017,MIA,31,23,15,20,0,89,DAL,22,33,23,18,0,96
3/1/2017,PHI,27,17,30,24,0,98,MIA,37,27,24,37,0,125
3/3/2017,MIA,25,28,20,26,0,99,ORL,33,27,25,25,0,110
3/4/2017,CLE,35,16,24,17,0,92,MIA,35,32,34,19,0,120
3/6/2017,MIA,29,33,27,17,0,106,CLE,22,30,19,27,0,98
3/8/2017,CHO,22,32,32,15,0,101,MIA,18,36,27,27,0,108
3/11/2017,TOR,26,15,22,26,0,89,MIA,32,27,26,19,0,104
3/12/2017,MIA,22,31,22,23,0,98,IND,32,28,23,19,0,102
3/15/2017,NOP,21,31,27,33,0,112,MIA,28,26,31,35,0,120
3/17/2017,MIN,23,26,32,24,0,105,MIA,27,37,26,33,0,123
3/19/2017,POR,28,24,33,30,0,115,MIA,29,22,28,25,0,104
3/21/2017,PHO,26,20,17,34,0,97,MIA,23,36,25,28,0,112
3/23/2017,TOR,23,22,30,26,0,101,MIA,33,14,21,16,0,84
3/26/2017,MIA,27,31,17,33,0,108,BOS,22,31,32,27,0,112
3/28/2017,MIA,24,31,23,19,0,97,DET,24,26,19,27,0,96
3/29/2017,MIA,24,25,28,28,0,105,NYK,22,19,27,20,0,88
3/31/2017,NYK,33,26,18,21,0,98,MIA,29,26,20,19,0,94
4/2/2017,DEN,37,31,25,23,0,116,MIA,30,28,29,26,0,113
4/5/2017,MIA,27,25,34,26,0,112,CHO,23,28,22,26,0,99
4/7/2017,MIA,19,24,22,29,0,94,TOR,26,27,17,26,0,96
4/8/2017,MIA,28,24,26,28,0,106,WAS,29,23,22,29,0,103
4/10/2017,CLE,37,23,31,17,13,121,MIA,24,32,24,28,16,124
4/12/2017,WAS,27,23,27,25,0,102,MIA,23,33,35,19,0,110
10/26/2016,MIN,32,27,16,23,0,98,MEM,29,21,26,26,0,102
10/29/2016,MEM,19,30,28,27,0,104,NYK,32,25,25,29,0,111
10/30/2016,WAS,22,32,23,23,3,103,MEM,27,31,20,22,12,112
11/1/2016,MEM,16,20,23,21,0,80,MIN,29,33,35,19,0,116
11/2/2016,NOP,13,35,11,16,8,83,MEM,21,20,25,9,14,89
11/4/2016,LAC,23,30,23,23,0,99,MEM,20,15,22,31,0,88
11/6/2016,POR,25,22,29,24,0,100,MEM,22,29,26,17,0,94
11/8/2016,DEN,26,30,20,31,0,107,MEM,26,30,23,29,0,108
11/12/2016,MEM,19,20,31,26,0,96,MIL,24,20,31,31,0,106
11/14/2016,MEM,33,23,17,29,0,102,UTA,25,23,22,26,0,96
11/16/2016,MEM,26,35,22,28,0,111,LAC,28,18,30,31,0,107
11/18/2016,MEM,19,17,20,24,0,80,DAL,19,10,12,23,0,64
11/19/2016,MIN,16,23,13,19,0,71,MEM,18,25,22,28,0,93
11/21/2016,MEM,32,37,15,21,0,105,CHO,22,23,26,19,0,90
11/23/2016,MEM,20,23,20,23,5,104,PHI,26,25,20,15,5,99
11/25/2016,MIA,28,17,26,19,0,90,MEM,19,20,18,24,0,81
11/26/2016,MEM,24,27,31,28,0,110,MIA,31,18,33,25,0,107
11/28/2016,CHO,25,31,25,23,0,104,MEM,25,14,21,25,0,85
11/30/2016,MEM,28,29,25,23,0,105,TOR,25,30,34,31,0,120
12/1/2016,ORL,28,21,19,26,0,94,MEM,30,20,15,30,0,95
12/3/2016,LAL,25,37,20,18,0,100,MEM,25,29,28,21,0,103
12/5/2016,MEM,17,27,30,20,6,110,NOP,21,25,23,25,6,108
12/6/2016,PHI,20,23,34,14,0,91,MEM,28,19,29,20,0,96
12/8/2016,POR,22,28,19,17,0,86,MEM,14,29,18,27,0,88
12/10/2016,GSW,16,22,27,24,0,89,MEM,31,30,26,23,0,110
12/13/2016,MEM,20,23,15,28,0,86,CLE,32,26,15,30,0,103
12/14/2016,CLE,16,20,17,32,0,85,MEM,28,19,27,19,0,93
12/16/2016,SAC,24,28,24,20,0,96,MEM,19,23,23,27,0,92
12/18/2016,UTA,18,16,27,21,0,82,MEM,18,17,23,15,0,73
12/20/2016,BOS,15,16,31,35,15,112,MEM,22,23,26,26,12,109
12/21/2016,MEM,29,24,26,19,0,98,DET,19,25,19,23,0,86
12/23/2016,HOU,31,18,26,34,0,109,MEM,25,29,23,38,0,115
12/26/2016,MEM,18,25,28,31,0,102,ORL,36,32,28,16,0,112
12/27/2016,MEM,24,24,29,26,0,103,BOS,28,28,28,29,0,113
12/29/2016,OKC,21,18,22,19,0,80,MEM,27,28,23,36,0,114
12/31/2016,MEM,21,29,32,30,0,112,SAC,20,25,22,31,0,98
1/3/2017,MEM,20,28,29,25,0,102,LAL,22,35,34,25,0,116
1/4/2017,MEM,29,34,22,21,0,106,LAC,30,23,36,26,0,115
1/6/2017,MEM,27,28,24,32,17,128,GSW,34,33,31,13,8,119
1/8/2017,UTA,18,17,16,28,0,79,MEM,19,23,21,25,0,88
1/11/2017,MEM,22,22,23,28,0,95,OKC,28,27,20,28,0,103
1/13/2017,MEM,25,26,32,27,0,110,HOU,31,33,21,20,0,105
1/15/2017,CHI,14,38,26,30,0,108,MEM,19,27,31,27,0,104
1/18/2017,MEM,24,27,26,24,0,101,WAS,30,36,17,21,0,104
1/20/2017,SAC,23,19,22,27,0,91,MEM,15,34,34,24,0,107
1/21/2017,HOU,32,26,33,28,0,119,MEM,22,27,23,23,0,95
1/25/2017,TOR,34,23,20,22,0,99,MEM,32,24,31,14,0,101
1/27/2017,MEM,24,32,28,25,0,109,POR,28,34,23,27,0,112
1/28/2017,MEM,26,26,28,22,0,102,UTA,27,16,31,21,0,95
1/30/2017,MEM,31,28,29,27,0,115,PHO,28,20,22,26,0,96
2/1/2017,MEM,27,35,25,32,0,119,DEN,18,31,20,30,0,99
2/3/2017,MEM,23,25,34,20,0,102,OKC,21,37,22,34,0,114
2/4/2017,MEM,15,33,21,38,0,107,MIN,31,17,19,32,0,99
2/6/2017,SAS,14,26,25,9,0,74,MEM,17,23,29,20,0,89
2/8/2017,PHO,15,23,27,26,0,91,MEM,24,22,33,31,0,110
2/10/2017,GSW,29,33,36,24,0,122,MEM,22,27,28,30,0,107
2/13/2017,MEM,27,25,27,33,0,112,BRK,19,23,30,31,0,103
2/15/2017,NOP,28,22,27,18,0,95,MEM,22,21,18,30,0,91
2/24/2017,MEM,26,23,19,24,0,92,IND,25,36,28,13,0,102
2/26/2017,MEM,22,28,18,37,0,105,DEN,19,28,21,30,0,98
2/28/2017,PHO,27,29,29,27,0,112,MEM,25,30,38,37,0,130
3/3/2017,MEM,22,28,22,28,0,100,DAL,20,31,28,25,0,104
3/4/2017,MEM,24,27,27,30,0,108,HOU,27,28,38,30,0,123
3/6/2017,BRK,36,20,32,34,0,122,MEM,34,23,34,18,0,109
3/9/2017,LAC,26,28,31,29,0,114,MEM,21,24,20,33,0,98
3/11/2017,ATL,33,14,30,30,0,107,MEM,15,20,22,33,0,90
3/13/2017,MIL,24,27,23,19,0,93,MEM,30,31,24,28,0,113
3/15/2017,MEM,24,30,20,24,0,98,CHI,24,26,21,20,0,91
3/16/2017,MEM,26,29,23,25,0,103,ATL,28,24,13,26,0,91
3/18/2017,SAS,18,25,30,23,0,96,MEM,29,15,31,29,0,104
3/21/2017,MEM,23,18,13,28,0,82,NOP,21,13,32,29,0,95
3/23/2017,MEM,22,20,27,21,0,90,SAS,27,24,23,23,0,97
3/26/2017,MEM,28,26,27,13,0,94,GSW,25,31,27,23,0,106
3/27/2017,MEM,27,22,19,22,0,90,SAC,28,23,23,17,0,91
3/29/2017,IND,24,29,26,18,0,97,MEM,38,34,24,14,0,110
3/31/2017,DAL,19,15,28,28,0,90,MEM,21,34,18,26,0,99
4/2/2017,MEM,27,22,31,23,0,103,LAL,22,28,29,29,0,108
4/4/2017,MEM,16,19,16,33,5,89,SAS,14,19,27,24,11,95
4/5/2017,OKC,34,23,22,24,0,103,MEM,27,23,24,26,0,100
4/7/2017,NYK,21,26,25,16,0,88,MEM,27,26,17,31,0,101
4/9/2017,DET,24,24,27,28,0,103,MEM,28,29,10,23,0,90
4/12/2017,DAL,22,24,24,30,0,100,MEM,27,28,19,19,0,93
10/25/2016,SAS,31,33,33,32,0,129,GSW,20,26,31,23,0,100
10/28/2016,GSW,32,27,33,30,0,122,NOP,22,28,31,33,0,114
10/30/2016,GSW,22,33,26,25,0,106,PHO,30,27,21,22,0,100
11/1/2016,GSW,34,25,41,27,0,127,POR,25,28,20,31,0,104
11/3/2016,OKC,32,11,27,26,0,96,GSW,31,37,30,24,0,122
11/4/2016,GSW,15,34,33,15,0,97,LAL,24,41,28,24,0,117
11/7/2016,NOP,24,25,29,28,0,106,GSW,28,35,21,32,0,116
11/9/2016,DAL,15,21,32,27,0,95,GSW,34,33,17,32,0,116
11/10/2016,GSW,38,27,34,26,0,125,DEN,19,32,24,26,0,101
11/13/2016,PHO,32,27,33,28,0,120,GSW,28,34,37,34,0,133
11/16/2016,GSW,34,32,29,32,0,127,TOR,38,15,33,35,0,121
11/18/2016,GSW,29,26,31,18,0,104,BOS,27,21,9,31,0,88
11/19/2016,GSW,28,41,34,21,0,124,MIL,37,29,26,29,0,121
11/21/2016,GSW,34,27,39,20,0,120,IND,21,21,29,12,0,83
11/23/2016,LAL,26,23,29,28,0,106,GSW,41,39,26,43,0,149
11/25/2016,GSW,30,23,27,29,0,109,LAL,20,23,21,21,0,85
11/26/2016,MIN,33,15,25,29,0,102,GSW,30,26,34,25,0,115
11/28/2016,ATL,27,26,28,19,0,100,GSW,29,21,30,25,0,105
12/1/2016,HOU,32,32,22,27,10,132,GSW,30,29,23,31,10,127
12/3/2016,PHO,30,27,27,25,0,109,GSW,37,29,42,30,0,138
12/5/2016,IND,27,23,33,23,0,106,GSW,38,42,36,26,0,142
12/7/2016,GSW,37,25,29,24,0,115,LAC,19,30,26,23,0,98
12/8/2016,GSW,35,30,17,24,0,106,UTA,17,29,24,29,0,99
12/10/2016,GSW,16,22,27,24,0,89,MEM,31,30,26,23,0,110
12/11/2016,GSW,30,30,18,38,0,116,MIN,27,31,30,20,0,108
12/13/2016,GSW,29,29,37,18,0,113,NOP,35,30,29,15,0,109
12/15/2016,NYK,25,20,21,24,0,90,GSW,32,27,29,15,0,103
12/17/2016,POR,21,24,27,18,0,90,GSW,39,31,38,27,0,135
12/20/2016,UTA,15,18,21,20,0,74,GSW,19,36,27,22,0,104
12/22/2016,GSW,33,16,39,29,0,117,BRK,34,31,19,17,0,101
12/23/2016,GSW,33,24,31,31,0,119,DET,32,27,25,29,0,113
12/25/2016,GSW,27,28,32,21,0,108,CLE,25,27,28,29,0,109
12/28/2016,TOR,17,38,32,24,0,111,GSW,42,30,32,17,0,121
12/30/2016,DAL,29,19,21,30,0,99,GSW,29,30,32,17,0,108
1/2/2017,DEN,33,31,21,34,0,119,GSW,35,33,26,33,0,127
1/4/2017,POR,34,37,21,25,0,117,GSW,40,29,30,26,0,125
1/6/2017,MEM,27,28,24,32,17,128,GSW,34,33,31,13,8,119
1/8/2017,GSW,24,27,39,27,0,117,SAC,33,25,22,26,0,106
1/10/2017,MIA,29,25,14,27,0,95,GSW,27,26,26,28,0,107
1/12/2017,DET,30,28,19,30,0,107,GSW,37,23,41,26,0,127
1/16/2017,CLE,22,27,22,20,0,91,GSW,37,41,17,31,0,126
1/18/2017,OKC,31,25,22,22,0,100,GSW,30,26,37,28,0,121
1/20/2017,GSW,32,30,37,26,0,125,HOU,29,28,22,29,0,108
1/22/2017,GSW,28,22,42,26,0,118,ORL,22,28,24,24,0,98
1/23/2017,GSW,30,18,25,29,0,102,MIA,28,18,31,28,0,105
1/25/2017,GSW,29,24,22,38,0,113,CHO,28,19,33,23,0,103
1/28/2017,LAC,22,29,23,24,0,98,GSW,31,41,45,27,0,144
1/29/2017,GSW,33,20,31,29,0,113,POR,24,26,24,37,0,111
2/1/2017,CHO,21,35,27,28,0,111,GSW,41,36,31,18,0,126
2/2/2017,GSW,33,32,39,29,0,133,LAC,22,33,32,33,0,120
2/4/2017,GSW,31,25,26,16,8,106,SAC,27,29,26,16,11,109
2/8/2017,CHI,17,24,29,22,0,92,GSW,30,25,31,37,0,123
2/10/2017,GSW,29,33,36,24,0,122,MEM,22,27,28,30,0,107
2/11/2017,GSW,30,43,32,25,0,130,OKC,24,26,37,27,0,114
2/13/2017,GSW,30,24,31,25,0,110,DEN,42,37,28,25,0,132
2/15/2017,SAC,25,25,15,21,0,86,GSW,28,19,42,20,0,109
2/23/2017,LAC,24,37,26,26,0,113,GSW,31,18,50,24,0,123
2/25/2017,BRK,28,23,25,19,0,95,GSW,32,30,29,21,0,112
2/27/2017,GSW,32,27,34,26,0,119,PHI,31,25,24,28,0,108
2/28/2017,GSW,26,23,36,23,0,108,WAS,40,21,24,27,0,112
3/2/2017,GSW,26,25,22,14,0,87,CHI,19,28,32,15,0,94
3/5/2017,GSW,29,20,35,28,0,112,NYK,18,32,26,29,0,105
3/6/2017,GSW,35,26,33,25,0,119,ATL,42,24,24,21,0,111
3/8/2017,BOS,25,21,26,27,0,99,GSW,28,22,24,12,0,86
3/10/2017,GSW,24,29,23,26,0,102,MIN,34,28,26,15,0,103
3/11/2017,GSW,22,22,19,22,0,85,SAS,33,31,22,21,0,107
3/14/2017,PHI,34,25,31,14,0,104,GSW,35,23,20,28,0,106
3/16/2017,ORL,20,30,21,21,0,92,GSW,34,33,36,19,0,122
3/18/2017,MIL,29,15,26,22,0,92,GSW,27,36,31,23,0,117
3/20/2017,GSW,25,34,33,19,0,111,OKC,22,17,27,29,0,95
3/21/2017,GSW,28,34,29,21,0,112,DAL,30,20,21,16,0,87
3/24/2017,SAC,20,30,22,28,0,100,GSW,27,30,35,22,0,114
3/26/2017,MEM,28,26,27,13,0,94,GSW,25,31,27,23,0,106
3/28/2017,GSW,37,23,26,27,0,113,HOU,20,32,23,31,0,106
3/29/2017,GSW,17,37,30,26,0,110,SAS,33,24,20,21,0,98
3/31/2017,HOU,25,36,24,13,0,98,GSW,23,33,27,24,0,107
4/2/2017,WAS,30,27,31,27,0,115,GSW,35,32,39,33,0,139
4/4/2017,MIN,32,28,26,21,0,107,GSW,32,36,36,17,0,121
4/5/2017,GSW,41,17,33,29,0,120,PHO,18,34,26,33,0,111
4/8/2017,NOP,17,29,22,33,0,101,GSW,23,31,39,30,0,123
4/10/2017,UTA,32,17,25,31,0,105,GSW,33,18,23,25,0,99
4/12/2017,LAL,28,22,20,24,0,94,GSW,43,21,29,16,0,109
10/26/2016,DEN,30,30,25,22,0,107,NOP,24,24,29,25,0,102
10/29/2016,POR,33,29,19,23,11,115,DEN,28,26,34,16,9,113
10/31/2016,DEN,24,25,35,18,0,102,TOR,33,29,26,17,0,105
11/3/2016,DEN,25,30,33,14,0,102,MIN,37,24,14,24,0,99
11/5/2016,DEN,12,32,23,19,0,86,DET,29,22,26,26,0,103
11/6/2016,DEN,42,35,26,20,0,123,BOS,23,29,31,24,0,107
11/8/2016,DEN,26,30,20,31,0,107,MEM,26,30,23,29,0,108
11/10/2016,GSW,38,27,34,26,0,125,DEN,19,32,24,26,0,101
11/12/2016,DET,36,21,23,26,0,106,DEN,21,28,22,24,0,95
11/13/2016,DEN,28,29,15,33,0,105,POR,20,30,36,26,0,112
11/16/2016,PHO,17,26,33,28,0,104,DEN,28,33,28,31,0,120
11/18/2016,TOR,29,23,25,25,11,113,DEN,19,38,25,20,9,111
11/20/2016,UTA,14,27,22,28,0,91,DEN,24,29,23,29,0,105
11/22/2016,CHI,31,29,28,19,0,107,DEN,19,41,31,19,0,110
11/23/2016,DEN,27,20,14,22,0,83,UTA,36,17,31,24,0,108
11/25/2016,OKC,31,31,22,38,10,132,DEN,30,33,26,33,7,129
11/27/2016,DEN,29,34,23,34,0,120,PHO,28,15,36,35,0,114
11/30/2016,MIA,28,24,23,31,0,106,DEN,30,17,33,18,0,98
12/2/2016,HOU,42,31,26,29,0,128,DEN,33,30,21,26,0,110
12/3/2016,DEN,21,26,16,35,0,98,UTA,24,25,33,23,0,105
12/5/2016,DEN,18,33,23,32,0,106,PHI,27,26,17,28,0,98
12/7/2016,DEN,23,29,27,32,0,111,BRK,36,32,28,20,0,116
12/8/2016,DEN,29,23,21,12,0,85,WAS,18,29,28,17,0,92
12/10/2016,DEN,32,33,27,29,0,121,ORL,29,29,37,18,0,113
12/12/2016,DEN,19,24,24,25,0,92,DAL,27,38,27,20,0,112
12/15/2016,POR,28,28,29,35,0,120,DEN,38,36,26,32,0,132
12/17/2016,NYK,22,32,26,34,0,114,DEN,33,29,34,31,0,127
12/19/2016,DAL,31,27,27,22,0,107,DEN,28,32,33,24,0,117
12/20/2016,DEN,26,27,19,30,0,102,LAC,36,32,27,24,0,119
12/23/2016,ATL,29,22,31,27,0,109,DEN,29,26,27,26,0,108
12/26/2016,DEN,23,40,16,27,0,106,LAC,23,23,31,25,0,102
12/28/2016,MIN,31,18,24,30,0,103,DEN,22,27,32,24,0,105
12/30/2016,PHI,30,30,31,33,0,124,DEN,28,32,27,35,0,122
1/2/2017,DEN,33,31,21,34,0,119,GSW,35,33,26,33,0,127
1/3/2017,SAC,29,31,34,26,0,120,DEN,28,23,37,25,0,113
1/5/2017,SAS,29,29,32,37,0,127,DEN,33,20,24,22,0,99
1/7/2017,DEN,22,38,20,26,0,106,OKC,24,36,28,33,0,121
1/12/2017,IND,29,27,20,36,0,112,DEN,30,37,39,34,0,140
1/16/2017,ORL,36,25,22,29,0,112,DEN,39,30,31,25,0,125
1/17/2017,DEN,40,26,35,26,0,127,LAL,26,28,30,37,0,121
1/19/2017,DEN,23,35,23,23,0,104,SAS,28,31,33,26,0,118
1/21/2017,LAC,18,27,26,27,0,98,DEN,27,32,36,28,0,123
1/22/2017,DEN,29,29,26,24,0,108,MIN,28,34,22,27,0,111
1/24/2017,UTA,22,17,28,26,0,93,DEN,18,33,29,23,0,103
1/26/2017,PHO,29,32,31,28,0,120,DEN,35,22,39,31,0,127
1/28/2017,DEN,21,38,36,28,0,123,PHO,33,28,22,29,0,112
1/31/2017,DEN,30,29,17,40,0,116,LAL,30,24,27,39,0,120
2/1/2017,MEM,27,35,25,32,0,119,DEN,18,31,20,30,0,99
2/3/2017,MIL,31,22,36,28,0,117,DEN,31,39,28,23,0,121
2/4/2017,DEN,27,23,22,25,0,97,SAS,30,26,35,30,0,121
2/6/2017,DAL,24,13,30,20,0,87,DEN,29,30,23,28,0,110
2/8/2017,DEN,30,25,32,19,0,106,ATL,39,33,26,19,0,117
2/10/2017,DEN,34,30,36,31,0,131,NYK,32,34,22,35,0,123
2/11/2017,DEN,33,22,23,31,0,109,CLE,28,31,33,33,0,125
2/13/2017,GSW,30,24,31,25,0,110,DEN,42,37,28,25,0,132
2/15/2017,MIN,32,30,23,27,0,112,DEN,31,29,19,20,0,99
2/23/2017,DEN,26,18,26,30,0,100,SAC,29,32,26,29,0,116
2/24/2017,BRK,25,28,22,34,0,109,DEN,30,34,37,28,0,129
2/26/2017,MEM,22,28,18,37,0,105,DEN,19,28,21,30,0,98
2/28/2017,DEN,22,34,35,34,0,125,CHI,25,34,24,24,0,107
3/1/2017,DEN,32,31,23,24,0,110,MIL,15,22,29,32,0,98
3/4/2017,CHO,31,30,29,22,0,112,DEN,23,29,27,23,0,102
3/6/2017,SAC,24,26,23,23,0,96,DEN,25,32,33,18,0,108
3/8/2017,WAS,35,32,30,26,0,123,DEN,28,22,35,28,0,113
3/10/2017,BOS,25,29,26,19,0,99,DEN,35,30,29,25,0,119
3/11/2017,DEN,25,29,21,30,0,105,SAC,19,25,25,23,0,92
3/13/2017,LAL,23,20,33,25,0,101,DEN,35,32,26,36,0,129
3/16/2017,LAC,19,27,34,34,0,114,DEN,27,32,44,26,0,129
3/18/2017,HOU,26,25,29,29,0,109,DEN,26,30,18,31,0,105
3/20/2017,DEN,28,37,32,27,0,124,HOU,35,27,32,31,0,125
3/22/2017,CLE,31,28,31,23,0,113,DEN,34,39,28,25,0,126
3/24/2017,DEN,34,30,30,31,0,125,IND,26,27,22,42,0,117
3/26/2017,NOP,29,26,32,28,0,115,DEN,26,14,19,31,0,90
3/28/2017,DEN,35,29,21,28,0,113,POR,32,34,29,27,0,122
3/31/2017,DEN,32,24,38,20,0,114,CHO,24,32,30,36,0,122
4/2/2017,DEN,37,31,25,23,0,116,MIA,30,28,29,26,0,113
4/4/2017,DEN,27,42,33,32,0,134,NOP,31,44,30,26,0,131
4/5/2017,DEN,25,25,29,25,0,104,HOU,36,23,26,25,0,110
4/7/2017,NOP,25,25,24,32,0,106,DEN,30,21,41,30,0,122
4/9/2017,OKC,27,25,29,25,0,106,DEN,26,27,38,14,0,105
4/11/2017,DEN,23,34,26,26,0,109,DAL,26,18,31,16,0,91
4/12/2017,DEN,25,31,30,25,0,111,OKC,26,38,21,20,0,105
10/26/2016,BRK,31,27,23,36,0,117,BOS,33,31,33,25,0,122
10/28/2016,IND,27,21,31,15,0,94,BRK,20,32,20,31,0,103
10/29/2016,BRK,18,23,32,35,0,108,MIL,24,22,34,30,0,110
10/31/2016,CHI,38,27,28,25,0,118,BRK,20,24,22,22,0,88
11/2/2016,DET,30,25,26,20,0,101,BRK,38,33,21,17,0,109
11/4/2016,CHO,23,20,30,26,0,99,BRK,23,27,20,25,0,95
11/8/2016,MIN,33,32,19,26,0,110,BRK,33,33,22,31,0,119
11/9/2016,BRK,29,26,16,25,0,96,NYK,19,31,22,38,0,110
11/12/2016,BRK,23,35,32,32,0,122,PHO,21,24,38,21,0,104
11/14/2016,BRK,14,33,18,30,0,95,LAC,39,32,28,28,0,127
11/15/2016,BRK,29,22,34,33,0,118,LAL,27,29,37,32,0,125
11/18/2016,BRK,40,21,21,23,0,105,OKC,34,30,32,28,0,124
11/20/2016,POR,32,38,29,30,0,129,BRK,29,35,20,25,0,109
11/23/2016,BOS,30,21,28,32,0,111,BRK,16,33,17,26,0,92
11/25/2016,BRK,23,20,22,32,0,97,IND,28,30,34,26,0,118
11/27/2016,SAC,31,27,34,30,0,122,BRK,35,24,18,28,0,105
11/29/2016,LAC,28,37,21,21,11,122,BRK,24,29,20,34,11,127
12/1/2016,MIL,27,25,38,21,0,111,BRK,26,25,27,15,0,93
12/3/2016,BRK,22,18,32,31,0,103,MIL,25,25,25,37,0,112
12/5/2016,WAS,29,22,32,35,0,118,BRK,32,34,15,32,0,113
12/7/2016,DEN,23,29,27,32,0,111,BRK,36,32,28,20,0,116
12/10/2016,BRK,26,26,18,31,0,101,SAS,41,26,36,27,0,130
12/12/2016,BRK,24,19,42,33,0,118,HOU,29,24,37,32,0,122
12/14/2016,LAL,30,13,33,21,0,97,BRK,27,25,23,32,0,107
12/16/2016,BRK,28,24,30,29,0,111,ORL,25,28,30,35,0,118
12/18/2016,BRK,32,25,29,21,0,107,PHI,30,24,29,25,0,108
12/20/2016,BRK,23,23,26,32,0,104,TOR,29,35,27,25,0,116
12/22/2016,GSW,33,16,39,29,0,117,BRK,34,31,19,17,0,101
12/23/2016,BRK,15,25,17,42,0,99,CLE,29,37,32,21,0,119
12/26/2016,CHO,40,23,25,30,0,118,BRK,31,23,29,37,0,120
12/28/2016,BRK,20,29,29,21,0,99,CHI,23,23,30,25,0,101
12/30/2016,BRK,23,27,27,18,0,95,WAS,31,35,25,27,0,118
1/2/2017,UTA,24,26,20,31,0,101,BRK,26,26,18,19,0,89
1/5/2017,BRK,27,25,32,25,0,109,IND,34,25,38,24,0,121
1/6/2017,CLE,24,26,36,30,0,116,BRK,20,19,29,40,0,108
1/8/2017,PHI,24,22,32,27,0,105,BRK,27,30,16,22,0,95
1/10/2017,ATL,35,26,25,31,0,117,BRK,29,14,27,27,0,97
1/12/2017,NOP,35,16,22,31,0,104,BRK,31,26,22,16,0,95
1/13/2017,BRK,27,26,36,24,0,113,TOR,30,24,36,42,0,132
1/15/2017,HOU,37,37,30,33,0,137,BRK,36,30,24,22,0,112
1/17/2017,TOR,26,32,34,27,0,119,BRK,29,32,24,24,0,109
1/20/2017,BRK,29,37,43,34,0,143,NOP,32,22,30,30,0,114
1/21/2017,BRK,14,32,35,24,0,105,CHO,28,32,21,31,0,112
1/23/2017,SAS,27,25,39,21,0,112,BRK,26,16,27,17,0,86
1/25/2017,MIA,34,21,16,38,0,109,BRK,30,36,23,17,0,106
1/27/2017,BRK,25,22,26,43,0,116,CLE,27,28,39,30,0,124
1/28/2017,BRK,26,29,23,31,0,109,MIN,33,30,29,37,0,129
1/30/2017,BRK,32,20,25,19,0,96,MIA,28,28,28,20,0,104
2/1/2017,NYK,15,23,26,31,0,95,BRK,27,18,24,21,0,90
2/3/2017,IND,27,29,24,26,0,106,BRK,16,30,28,23,0,97
2/5/2017,TOR,26,29,20,28,0,103,BRK,24,19,20,32,0,95
2/7/2017,BRK,16,21,35,35,0,107,CHO,24,30,27,30,0,111
2/8/2017,WAS,31,28,20,21,14,114,BRK,22,27,23,28,10,110
2/10/2017,MIA,20,29,25,34,0,108,BRK,22,31,19,27,0,99
2/13/2017,MEM,27,25,27,33,0,112,BRK,19,23,30,31,0,103
2/15/2017,MIL,39,23,33,34,0,129,BRK,33,27,22,43,0,125
2/24/2017,BRK,25,28,22,34,0,109,DEN,30,34,37,28,0,129
2/25/2017,BRK,28,23,25,19,0,95,GSW,32,30,29,21,0,112
3/1/2017,BRK,35,22,24,28,0,109,SAC,31,23,18,28,0,100
3/3/2017,BRK,26,25,19,27,0,97,UTA,38,22,28,24,0,112
3/4/2017,BRK,27,30,25,34,0,116,POR,37,21,32,40,0,130
3/6/2017,BRK,36,20,32,34,0,122,MEM,34,23,34,18,0,109
3/8/2017,BRK,27,23,30,25,0,105,ATL,23,23,35,29,0,110
3/10/2017,BRK,26,23,24,23,0,96,DAL,23,23,28,31,0,105
3/12/2017,NYK,26,23,31,32,0,112,BRK,39,28,24,29,0,120
3/14/2017,OKC,32,30,29,31,0,122,BRK,32,30,21,21,0,104
3/16/2017,BRK,28,26,38,29,0,121,NYK,33,28,26,23,0,110
3/17/2017,BOS,21,24,26,27,0,98,BRK,16,21,28,30,0,95
3/19/2017,DAL,32,25,25,29,0,111,BRK,26,17,29,32,0,104
3/21/2017,DET,31,13,21,31,0,96,BRK,22,28,24,24,0,98
3/23/2017,PHO,32,18,15,33,0,98,BRK,22,30,32,42,0,126
3/24/2017,BRK,22,20,39,27,0,108,WAS,31,32,34,32,0,129
3/26/2017,BRK,32,23,23,29,0,107,ATL,20,28,20,24,0,92
3/28/2017,PHI,31,27,21,27,0,106,BRK,24,33,21,23,0,101
3/30/2017,BRK,18,21,24,26,0,89,DET,16,19,24,31,0,90
4/1/2017,ORL,33,20,36,22,0,111,BRK,33,27,29,32,0,121
4/2/2017,ATL,24,19,18,21,0,82,BRK,29,17,24,21,0,91
4/4/2017,BRK,40,41,30,30,0,141,PHI,27,26,24,41,0,118
4/6/2017,BRK,25,25,21,36,0,107,ORL,22,28,36,29,0,115
4/8/2017,CHI,25,20,37,24,0,106,BRK,32,19,24,32,0,107
4/10/2017,BRK,13,27,37,28,0,105,BOS,28,30,32,24,0,114
4/12/2017,BRK,13,19,24,17,0,73,CHI,27,23,25,37,0,112
10/27/2016,LAC,28,30,24,32,0,114,POR,27,22,33,24,0,106
10/30/2016,UTA,22,13,21,19,0,75,LAC,19,23,27,19,0,88
10/31/2016,PHO,24,12,34,28,0,98,LAC,24,24,34,34,0,116
11/2/2016,OKC,23,26,16,20,0,85,LAC,24,17,25,17,0,83
11/4/2016,LAC,23,30,23,23,0,99,MEM,20,15,22,31,0,88
11/5/2016,LAC,39,34,16,27,0,116,SAS,24,31,17,20,0,92
11/7/2016,DET,15,17,21,29,0,82,LAC,33,29,29,23,0,114
11/9/2016,POR,16,16,18,30,0,80,LAC,36,25,32,18,0,111
11/11/2016,LAC,16,34,32,28,0,110,OKC,24,26,24,34,0,108
11/12/2016,LAC,34,26,28,31,0,119,MIN,21,30,22,32,0,105
11/14/2016,BRK,14,33,18,30,0,95,LAC,39,32,28,28,0,127
11/16/2016,MEM,26,35,22,28,0,111,LAC,28,18,30,31,0,107
11/18/2016,LAC,40,33,31,17,0,121,SAC,24,30,31,30,0,115
11/19/2016,CHI,33,19,25,18,0,95,LAC,23,24,25,30,0,102
11/21/2016,TOR,19,26,34,36,0,115,LAC,23,31,34,35,0,123
11/23/2016,LAC,32,36,25,31,0,124,DAL,26,19,25,34,0,104
11/25/2016,LAC,23,25,32,17,0,97,DET,35,22,25,26,0,108
11/27/2016,LAC,20,20,18,12,0,70,IND,23,27,26,15,0,91
11/29/2016,LAC,28,37,21,21,11,122,BRK,24,29,20,34,11,127
12/1/2016,LAC,24,34,27,28,0,113,CLE,28,22,15,29,0,94
12/2/2016,LAC,25,35,29,25,0,114,NOP,30,27,19,20,0,96
12/4/2016,IND,17,31,35,28,0,111,LAC,28,24,17,33,0,102
12/7/2016,GSW,37,25,29,24,0,115,LAC,19,30,26,23,0,98
12/10/2016,NOP,31,24,25,25,0,105,LAC,35,26,37,35,0,133
12/12/2016,POR,27,33,26,34,0,120,LAC,38,18,33,32,0,121
12/14/2016,LAC,30,30,27,26,0,113,ORL,25,26,36,21,0,108
12/16/2016,LAC,31,29,19,23,0,102,MIA,27,19,23,29,0,98
12/18/2016,LAC,27,28,32,23,0,110,WAS,28,24,33,32,0,117
12/20/2016,DEN,26,27,19,30,0,102,LAC,36,32,27,24,0,119
12/22/2016,SAS,22,23,28,28,0,101,LAC,27,30,24,25,0,106
12/23/2016,DAL,21,29,18,22,0,90,LAC,24,27,21,16,0,88
12/25/2016,LAC,31,27,16,28,0,102,LAL,27,28,34,22,0,111
12/26/2016,DEN,23,40,16,27,0,106,LAC,23,23,31,25,0,102
12/28/2016,LAC,27,29,21,21,0,98,NOP,19,30,27,26,0,102
12/30/2016,LAC,23,34,41,18,0,116,HOU,37,37,34,32,0,140
12/31/2016,LAC,12,28,28,20,0,88,OKC,33,36,27,18,0,114
1/2/2017,PHO,26,32,18,22,0,98,LAC,27,37,25,20,0,109
1/4/2017,MEM,29,34,22,21,0,106,LAC,30,23,36,26,0,115
1/6/2017,LAC,19,34,22,31,0,106,SAC,29,12,32,25,0,98
1/8/2017,MIA,19,20,27,20,0,86,LAC,20,32,28,18,0,98
1/11/2017,ORL,33,18,24,21,0,96,LAC,28,28,17,32,0,105
1/14/2017,LAL,15,24,29,29,0,97,LAC,26,32,26,29,0,113
1/16/2017,OKC,25,22,28,23,0,98,LAC,34,30,32,24,0,120
1/19/2017,MIN,25,19,33,27,0,104,LAC,22,29,28,22,0,101
1/21/2017,LAC,18,27,26,27,0,98,DEN,27,32,36,28,0,123
1/23/2017,LAC,30,28,27,30,0,115,ATL,21,19,35,30,0,105
1/24/2017,LAC,29,39,21,21,0,110,PHI,27,32,30,32,0,121
1/28/2017,LAC,22,29,23,24,0,98,GSW,31,41,45,27,0,144
2/1/2017,LAC,38,24,30,32,0,124,PHO,31,28,29,26,0,114
2/2/2017,GSW,33,32,39,29,0,133,LAC,22,33,32,33,0,120
2/5/2017,LAC,19,28,20,35,0,102,BOS,29,27,25,26,0,107
2/6/2017,LAC,31,29,22,27,0,109,TOR,35,35,27,21,0,118
2/8/2017,LAC,36,32,20,31,0,119,NYK,36,31,28,20,0,115
2/11/2017,LAC,29,24,24,30,0,107,CHO,27,24,19,32,0,102
2/13/2017,LAC,18,27,31,12,0,88,UTA,19,15,15,23,0,72
2/15/2017,ATL,22,18,24,20,0,84,LAC,21,33,29,16,0,99
2/23/2017,LAC,24,37,26,26,0,113,GSW,31,18,50,24,0,123
2/24/2017,SAS,18,29,30,28,0,105,LAC,13,29,31,24,0,97
2/26/2017,CHO,24,27,29,33,8,121,LAC,32,27,25,29,11,124
3/1/2017,HOU,34,36,38,14,0,122,LAC,37,21,20,25,0,103
3/3/2017,LAC,19,28,29,25,0,101,MIL,34,32,19,27,0,112
3/4/2017,LAC,23,32,27,19,0,101,CHI,29,32,12,18,0,91
3/6/2017,BOS,25,21,25,31,0,102,LAC,22,21,32,41,0,116
3/8/2017,LAC,19,36,13,23,0,91,MIN,31,27,24,25,0,107
3/9/2017,LAC,26,28,31,29,0,114,MEM,21,24,20,33,0,98
3/11/2017,PHI,30,27,22,21,0,100,LAC,32,24,19,37,0,112
3/13/2017,LAC,28,28,30,22,0,108,UTA,23,26,40,25,0,114
3/15/2017,MIL,28,18,21,30,0,97,LAC,20,26,23,27,0,96
3/16/2017,LAC,19,27,34,34,0,114,DEN,27,32,44,26,0,129
3/18/2017,CLE,16,15,27,20,0,78,LAC,14,33,29,32,0,108
3/20/2017,NYK,23,30,19,33,0,105,LAC,29,34,34,17,0,114
3/21/2017,LAC,33,37,38,25,0,133,LAL,24,16,34,35,0,109
3/23/2017,LAC,24,30,21,20,0,95,DAL,29,19,29,20,0,97
3/25/2017,UTA,14,27,29,25,0,95,LAC,28,21,23,36,0,108
3/26/2017,SAC,24,18,23,33,0,98,LAC,24,20,32,21,0,97
3/29/2017,WAS,31,32,35,26,0,124,LAC,39,35,36,23,0,133
3/30/2017,LAC,31,36,26,31,0,124,PHO,35,24,33,26,0,118
4/1/2017,LAL,22,28,22,32,0,104,LAC,28,27,38,22,0,115
4/5/2017,DAL,24,25,24,28,0,101,LAC,35,27,28,22,0,112
4/8/2017,LAC,22,30,30,16,0,98,SAS,23,20,27,17,0,87
4/10/2017,HOU,35,22,12,27,0,96,LAC,35,26,36,28,0,125
4/12/2017,SAC,23,24,26,22,0,95,LAC,30,23,34,28,0,115
10/25/2016,UTA,26,20,37,21,0,104,POR,26,28,23,36,0,113
10/27/2016,LAC,28,30,24,32,0,114,POR,27,22,33,24,0,106
10/29/2016,POR,33,29,19,23,11,115,DEN,28,26,34,16,9,113
11/1/2016,GSW,34,25,41,27,0,127,POR,25,28,20,31,0,104
11/2/2016,POR,28,25,20,30,12,115,PHO,28,29,19,27,15,118
11/4/2016,POR,26,29,24,26,0,105,DAL,26,26,24,19,0,95
11/6/2016,POR,25,22,29,24,0,100,MEM,22,29,26,17,0,94
11/8/2016,PHO,25,30,27,39,0,121,POR,42,21,26,35,0,124
11/9/2016,POR,16,16,18,30,0,80,LAC,36,25,32,18,0,111
11/11/2016,SAC,31,26,26,23,14,120,POR,35,27,22,22,16,122
11/13/2016,DEN,28,29,15,33,0,105,POR,20,30,36,26,0,112
11/15/2016,CHI,35,21,27,30,0,113,POR,14,23,26,25,0,88
11/17/2016,POR,29,33,21,26,0,109,HOU,41,21,38,26,0,126
11/18/2016,POR,28,23,24,26,0,101,NOP,31,33,24,25,0,113
11/20/2016,POR,32,38,29,30,0,129,BRK,29,35,20,25,0,109
11/22/2016,POR,33,25,23,22,0,103,NYK,28,32,21,26,0,107
11/23/2016,POR,31,29,32,33,0,125,CLE,46,35,31,25,0,137
11/25/2016,NOP,34,23,26,21,0,104,POR,32,34,34,19,0,119
11/27/2016,HOU,35,30,31,34,0,130,POR,35,27,31,21,0,114
11/30/2016,IND,23,35,25,26,0,109,POR,31,42,36,22,0,131
12/3/2016,MIA,29,20,22,21,0,92,POR,21,34,18,26,0,99
12/5/2016,POR,29,36,21,26,0,112,CHI,32,25,30,23,0,110
12/7/2016,POR,28,30,18,31,0,107,MIL,28,23,34,30,0,115
12/8/2016,POR,22,28,19,17,0,86,MEM,14,29,18,27,0,88
12/10/2016,POR,44,27,27,13,0,111,IND,31,33,26,28,0,118
12/12/2016,POR,27,33,26,34,0,120,LAC,38,18,33,32,0,121
12/13/2016,OKC,31,21,19,24,0,95,POR,32,36,24,22,0,114
12/15/2016,POR,28,28,29,35,0,120,DEN,38,36,26,32,0,132
12/17/2016,POR,21,24,27,18,0,90,GSW,39,31,38,27,0,135
12/20/2016,POR,35,37,27,22,0,121,SAC,27,33,33,33,0,126
12/21/2016,DAL,30,32,19,15,0,96,POR,20,18,33,24,0,95
12/23/2016,SAS,27,30,30,23,0,110,POR,27,18,27,18,0,90
12/26/2016,TOR,21,22,30,22,0,95,POR,24,18,26,23,0,91
12/28/2016,SAC,21,23,19,26,0,89,POR,30,30,15,27,0,102
12/30/2016,POR,32,20,21,21,0,94,SAS,22,25,33,30,0,110
1/1/2017,POR,24,13,32,26,0,95,MIN,23,26,15,25,0,89
1/4/2017,POR,34,37,21,25,0,117,GSW,40,29,30,26,0,125
1/5/2017,LAL,24,38,22,25,0,109,POR,29,24,31,34,0,118
1/8/2017,DET,31,22,27,26,8,125,POR,30,26,31,19,8,124
1/10/2017,POR,25,30,23,30,0,108,LAL,26,31,12,18,0,87
1/11/2017,CLE,20,21,20,25,0,86,POR,27,22,24,29,0,102
1/13/2017,ORL,36,18,28,33,0,115,POR,23,26,29,31,0,109
1/16/2017,POR,21,29,27,24,0,101,WAS,37,38,26,19,0,120
1/18/2017,POR,26,20,26,13,0,85,CHO,23,31,25,28,0,107
1/20/2017,POR,33,23,15,21,0,92,PHI,22,21,27,23,0,93
1/21/2017,POR,26,30,32,25,14,127,BOS,28,37,21,27,10,123
1/25/2017,LAL,31,27,17,23,0,98,POR,30,29,24,22,0,105
1/27/2017,MEM,24,32,28,25,0,109,POR,28,34,23,27,0,112
1/29/2017,GSW,33,20,31,29,0,113,POR,24,26,24,37,0,111
1/31/2017,CHO,23,27,18,30,0,98,POR,28,28,30,29,0,115
2/3/2017,DAL,35,25,24,24,0,108,POR,22,25,29,28,0,104
2/5/2017,POR,16,36,21,26,0,99,OKC,24,22,25,34,0,105
2/7/2017,POR,32,32,22,28,0,114,DAL,27,26,29,31,0,113
2/9/2017,BOS,22,27,28,43,0,120,POR,32,23,21,35,0,111
2/13/2017,ATL,21,21,33,22,12,109,POR,28,20,26,23,7,104
2/15/2017,POR,17,20,25,26,0,88,UTA,18,22,34,37,0,111
2/23/2017,POR,23,23,31,35,0,112,ORL,25,30,30,18,0,103
2/26/2017,POR,28,24,28,26,0,106,TOR,25,28,29,30,0,112
2/28/2017,POR,27,22,30,30,4,113,DET,19,25,31,34,11,120
3/2/2017,OKC,24,36,25,24,0,109,POR,26,31,24,33,0,114
3/4/2017,BRK,27,30,25,34,0,116,POR,37,21,32,40,0,130
3/7/2017,POR,29,32,38,27,0,126,OKC,40,27,25,29,0,121
3/9/2017,PHI,17,35,26,19,11,108,POR,27,30,19,21,17,114
3/11/2017,WAS,30,19,33,30,13,125,POR,36,34,21,21,12,124
3/12/2017,POR,33,33,16,28,0,110,PHO,18,32,29,22,0,101
3/14/2017,POR,16,20,18,23,0,77,NOP,23,27,27,23,0,100
3/15/2017,POR,28,26,28,28,0,110,SAS,29,26,25,26,0,106
3/18/2017,POR,40,23,22,28,0,113,ATL,18,28,27,24,0,97
3/19/2017,POR,28,24,33,30,0,115,MIA,29,22,28,25,0,104
3/21/2017,MIL,18,30,19,26,0,93,POR,21,14,28,27,0,90
3/23/2017,NYK,23,23,22,27,0,95,POR,37,30,18,25,0,110
3/25/2017,MIN,21,25,28,26,0,100,POR,27,33,34,18,0,112
3/26/2017,POR,22,18,37,20,0,97,LAL,17,15,24,25,0,81
3/28/2017,DEN,35,29,21,28,0,113,POR,32,34,29,27,0,122
3/30/2017,HOU,31,25,29,22,0,107,POR,32,33,31,21,0,117
4/1/2017,PHO,21,32,34,30,0,117,POR,37,26,34,33,0,130
4/3/2017,POR,23,34,26,26,0,109,MIN,29,20,37,24,0,110
4/4/2017,POR,17,24,23,23,0,87,UTA,24,23,28,31,0,106
4/6/2017,MIN,34,27,26,11,0,98,POR,20,33,27,25,0,105
4/8/2017,UTA,20,22,18,26,0,86,POR,34,14,29,24,0,101
4/10/2017,SAS,28,15,33,22,0,98,POR,31,16,24,28,0,99
4/12/2017,NOP,22,31,25,25,0,103,POR,30,23,32,15,0,100
10/26/2016,DAL,21,31,33,30,6,121,IND,33,26,35,21,15,130
10/28/2016,IND,27,21,31,15,0,94,BRK,20,32,20,31,0,103
10/29/2016,IND,20,21,26,34,0,101,CHI,24,38,30,26,0,118
11/1/2016,LAL,18,33,28,29,0,108,IND,27,35,22,31,0,115
11/3/2016,IND,30,27,22,28,0,107,MIL,29,34,27,35,0,125
11/5/2016,CHI,15,28,21,30,0,94,IND,31,31,26,23,0,111
11/7/2016,IND,34,21,23,22,0,100,CHO,43,32,24,23,0,122
11/9/2016,PHI,26,34,24,25,6,115,IND,31,23,30,25,13,122
11/11/2016,IND,27,25,20,28,5,105,PHI,21,30,25,24,9,109
11/12/2016,BOS,24,24,31,26,0,105,IND,31,14,31,23,0,99
11/14/2016,ORL,19,18,20,12,0,69,IND,16,25,30,17,0,88
11/16/2016,CLE,19,26,23,25,0,93,IND,30,20,30,23,0,103
11/18/2016,PHO,27,30,32,27,0,116,IND,18,31,33,14,0,96
11/20/2016,IND,30,28,21,24,12,115,OKC,21,33,16,33,8,111
11/21/2016,GSW,34,27,39,20,0,120,IND,21,21,29,12,0,83
11/23/2016,ATL,31,18,25,22,0,96,IND,24,20,22,19,0,85
11/25/2016,BRK,23,20,22,32,0,97,IND,28,30,34,26,0,118
11/27/2016,LAC,20,20,18,12,0,70,IND,23,27,26,15,0,91
11/30/2016,IND,23,35,25,26,0,109,POR,31,42,36,22,0,131
12/4/2016,IND,17,31,35,28,0,111,LAC,28,24,17,33,0,102
12/5/2016,IND,27,23,33,23,0,106,GSW,38,42,36,26,0,142
12/7/2016,IND,23,26,33,27,0,109,PHO,22,31,27,14,0,94
12/9/2016,IND,27,25,25,26,0,103,DAL,25,29,31,26,0,111
12/10/2016,POR,44,27,27,13,0,111,IND,31,33,26,28,0,118
12/12/2016,CHO,20,23,30,21,0,94,IND,25,20,31,34,0,110
12/14/2016,IND,21,31,27,10,0,89,MIA,20,33,25,17,0,95
12/15/2016,IND,20,30,24,21,0,95,NOP,24,22,25,31,0,102
12/17/2016,IND,27,28,28,22,0,105,DET,26,18,25,21,0,90
12/19/2016,WAS,36,21,22,26,0,105,IND,29,28,31,19,0,107
12/20/2016,IND,24,35,28,24,0,111,NYK,20,34,30,34,0,118
12/22/2016,BOS,22,29,26,32,0,109,IND,31,9,27,35,0,102
12/26/2016,IND,19,22,20,24,0,85,CHI,28,23,12,27,0,90
12/28/2016,IND,25,23,26,31,0,105,WAS,23,35,27,26,0,111
12/30/2016,CHI,22,28,23,28,0,101,IND,28,34,22,27,0,111
1/1/2017,ORL,17,34,22,31,0,104,IND,27,35,27,28,0,117
1/3/2017,IND,36,30,26,29,0,121,DET,28,32,32,24,0,116
1/5/2017,BRK,27,25,32,25,0,109,IND,34,25,38,24,0,121
1/7/2017,NYK,29,14,27,39,0,109,IND,33,29,34,27,0,123
1/12/2017,IND,29,27,20,36,0,112,DEN,30,37,39,34,0,140
1/16/2017,NOP,18,34,18,25,0,95,IND,32,22,22,22,0,98
1/18/2017,IND,21,20,30,35,0,106,SAC,34,26,19,21,0,100
1/20/2017,IND,24,29,22,20,0,95,LAL,27,24,35,22,0,108
1/21/2017,IND,21,29,22,28,0,100,UTA,34,26,25,24,0,109
1/23/2017,NYK,22,40,24,23,0,109,IND,34,24,17,28,0,103
1/26/2017,IND,25,27,24,33,0,109,MIN,20,26,24,33,0,103
1/27/2017,SAC,30,34,23,17,7,111,IND,27,28,26,23,11,115
1/29/2017,HOU,20,23,27,31,0,101,IND,33,24,33,30,0,120
2/1/2017,IND,28,28,24,18,0,98,ORL,23,24,27,14,0,88
2/3/2017,IND,27,29,24,26,0,106,BRK,16,30,28,23,0,97
2/4/2017,DET,32,26,14,12,0,84,IND,30,26,26,23,0,105
2/6/2017,OKC,25,27,18,20,0,90,IND,20,21,32,20,0,93
2/8/2017,CLE,25,32,40,35,0,132,IND,36,27,18,36,0,117
2/10/2017,IND,27,32,22,26,0,107,WAS,33,26,27,26,0,112
2/11/2017,MIL,29,33,26,28,0,116,IND,22,30,22,26,0,100
2/13/2017,SAS,26,23,34,27,0,110,IND,31,18,30,27,0,106
2/15/2017,IND,32,22,26,24,0,104,CLE,28,29,26,30,0,113
2/16/2017,WAS,34,28,28,21,0,111,IND,27,25,25,21,0,98
2/24/2017,MEM,26,23,19,24,0,92,IND,25,36,28,13,0,102
2/25/2017,IND,23,31,25,16,0,95,MIA,18,35,30,30,0,113
2/27/2017,IND,20,39,29,29,0,117,HOU,31,27,22,28,0,108
3/1/2017,IND,28,21,27,23,0,99,SAS,29,18,26,27,0,100
3/5/2017,IND,19,31,31,16,0,97,ATL,30,20,24,22,0,96
3/6/2017,IND,16,21,29,22,0,88,CHO,27,31,16,26,0,100
3/8/2017,DET,23,27,23,25,0,98,IND,30,28,32,25,0,115
3/10/2017,IND,27,23,18,17,0,85,MIL,23,22,29,25,0,99
3/12/2017,MIA,22,31,22,23,0,98,IND,32,28,23,19,0,102
3/14/2017,IND,24,28,12,17,0,81,NYK,18,24,20,25,0,87
3/15/2017,CHO,22,20,16,19,0,77,IND,24,18,33,23,0,98
3/19/2017,IND,24,21,28,18,0,91,TOR,32,30,29,25,0,116
3/20/2017,UTA,23,23,24,30,0,100,IND,28,23,29,27,0,107
3/22/2017,IND,19,23,32,26,0,100,BOS,21,28,39,21,0,109
3/24/2017,DEN,34,30,30,31,0,125,IND,26,27,22,42,0,117
3/26/2017,PHI,18,27,24,25,0,94,IND,27,24,30,26,0,107
3/28/2017,MIN,26,33,28,28,0,115,IND,25,32,33,24,0,114
3/29/2017,IND,24,29,26,18,0,97,MEM,38,34,24,14,0,110
3/31/2017,IND,25,23,20,32,0,100,TOR,28,18,34,31,0,111
4/2/2017,IND,27,26,24,27,10,130,CLE,26,34,23,21,10,135
4/4/2017,TOR,26,25,24,15,0,90,IND,18,22,37,31,0,108
4/6/2017,MIL,21,29,23,16,0,89,IND,25,31,29,19,0,104
4/8/2017,IND,39,29,31,28,0,127,ORL,38,21,23,30,0,112
4/10/2017,IND,35,29,26,30,0,120,PHI,20,34,25,32,0,111
4/12/2017,ATL,15,28,25,18,0,86,IND,22,28,34,20,0,104
10/25/2016,SAS,31,33,33,32,0,129,GSW,20,26,31,23,0,100
10/27/2016,SAS,27,26,23,26,0,102,SAC,29,28,14,23,0,94
10/29/2016,NOP,23,22,15,19,0,79,SAS,28,27,28,15,0,98
10/30/2016,SAS,24,28,25,29,0,106,MIA,19,25,28,27,0,99
11/1/2016,UTA,38,16,19,33,0,106,SAS,28,22,21,20,0,91
11/4/2016,SAS,27,26,29,18,0,100,UTA,17,24,25,20,0,86
11/5/2016,LAC,39,34,16,27,0,116,SAS,24,31,17,20,0,92
11/9/2016,HOU,33,30,22,16,0,101,SAS,24,36,20,19,0,99
11/11/2016,DET,26,26,15,19,0,86,SAS,28,21,26,21,0,96
11/12/2016,SAS,26,23,33,24,0,106,HOU,22,18,30,30,0,100
11/14/2016,MIA,19,21,20,30,0,90,SAS,25,30,16,23,0,94
11/16/2016,SAS,27,30,27,26,0,110,SAC,22,24,25,34,0,105
11/18/2016,SAS,26,26,39,25,0,116,LAL,16,36,24,31,0,107
11/21/2016,DAL,28,21,24,18,0,91,SAS,24,24,25,23,0,96
11/23/2016,SAS,30,29,25,35,0,119,CHO,28,32,24,30,0,114
11/25/2016,SAS,22,24,29,34,0,109,BOS,32,16,26,29,0,103
11/26/2016,SAS,23,31,36,22,0,112,WAS,22,22,32,24,0,100
11/29/2016,ORL,16,29,30,20,0,95,SAS,20,23,21,19,0,83
11/30/2016,SAS,21,22,18,33,0,94,DAL,17,23,26,21,0,87
12/2/2016,WAS,28,32,14,31,0,105,SAS,24,33,23,27,0,107
12/5/2016,SAS,26,9,36,26,0,97,MIL,24,24,25,23,0,96
12/6/2016,SAS,19,24,29,33,0,105,MIN,22,24,18,27,0,91
12/8/2016,SAS,17,15,31,28,0,91,CHI,21,24,27,23,0,95
12/10/2016,BRK,26,26,18,31,0,101,SAS,41,26,36,27,0,130
12/14/2016,BOS,23,24,26,28,0,101,SAS,32,24,21,31,0,108
12/15/2016,SAS,23,28,23,33,0,107,PHO,20,23,28,21,0,92
12/18/2016,NOP,26,23,22,29,0,100,SAS,30,31,31,21,0,113
12/20/2016,SAS,26,26,19,31,0,102,HOU,24,21,33,22,0,100
12/22/2016,SAS,22,23,28,28,0,101,LAC,27,30,24,25,0,106
12/23/2016,SAS,27,30,30,23,0,110,POR,27,18,27,18,0,90
12/25/2016,CHI,25,25,26,24,0,100,SAS,36,19,32,32,0,119
12/28/2016,PHO,27,37,18,16,0,98,SAS,30,28,31,30,0,119
12/30/2016,POR,32,20,21,21,0,94,SAS,22,25,33,30,0,110
1/1/2017,SAS,27,19,28,26,12,112,ATL,25,19,25,31,14,114
1/3/2017,TOR,18,23,17,24,0,82,SAS,29,31,28,22,0,110
1/5/2017,SAS,29,29,32,37,0,127,DEN,33,20,24,22,0,99
1/7/2017,CHO,24,26,14,21,0,85,SAS,24,23,26,29,0,102
1/10/2017,MIL,23,30,30,26,0,109,SAS,23,36,30,18,0,107
1/12/2017,LAL,24,30,21,19,0,94,SAS,36,36,34,28,0,134
1/14/2017,SAS,25,33,27,20,0,105,PHO,25,26,29,28,0,108
1/17/2017,MIN,30,41,19,24,0,114,SAS,30,37,25,30,0,122
1/19/2017,DEN,23,35,23,23,0,104,SAS,28,31,33,26,0,118
1/21/2017,SAS,22,35,27,23,11,118,CLE,33,25,31,18,8,115
1/23/2017,SAS,27,25,39,21,0,112,BRK,26,16,27,17,0,86
1/24/2017,SAS,29,32,18,29,0,108,TOR,25,29,25,27,0,106
1/27/2017,SAS,20,37,27,19,0,103,NOP,23,25,37,34,0,119
1/29/2017,DAL,27,22,28,28,0,105,SAS,28,31,22,20,0,101
1/31/2017,OKC,17,25,33,19,0,94,SAS,31,21,27,29,0,108
2/2/2017,PHI,21,32,20,13,0,86,SAS,24,24,31,23,0,102
2/4/2017,DEN,27,23,22,25,0,97,SAS,30,26,35,30,0,121
2/6/2017,SAS,14,26,25,9,0,74,MEM,17,23,29,20,0,89
2/8/2017,SAS,29,29,24,29,0,111,PHI,23,28,24,28,0,103
2/10/2017,SAS,27,33,23,20,0,103,DET,19,22,25,26,0,92
2/12/2017,SAS,21,27,17,25,0,90,NYK,18,24,27,25,0,94
2/13/2017,SAS,26,23,34,27,0,110,IND,31,18,30,27,0,106
2/15/2017,SAS,30,24,31,22,0,107,ORL,16,21,27,15,0,79
2/24/2017,SAS,18,29,30,28,0,105,LAC,13,29,31,24,0,97
2/26/2017,SAS,36,25,35,23,0,119,LAL,20,21,29,28,0,98
3/1/2017,IND,28,21,27,23,0,99,SAS,29,18,26,27,0,100
3/3/2017,SAS,27,22,18,22,12,101,NOP,30,18,18,23,9,98
3/4/2017,MIN,26,29,15,13,7,90,SAS,14,29,19,21,14,97
3/6/2017,HOU,39,15,28,28,0,110,SAS,23,24,34,31,0,112
3/8/2017,SAC,37,26,23,18,0,104,SAS,15,33,34,32,0,114
3/9/2017,SAS,28,21,22,21,0,92,OKC,29,27,26,20,0,102
3/11/2017,GSW,22,22,19,22,0,85,SAS,33,31,22,21,0,107
3/13/2017,ATL,18,25,30,26,0,99,SAS,28,26,27,26,0,107
3/15/2017,POR,28,26,28,28,0,110,SAS,29,26,25,26,0,106
3/18/2017,SAS,18,25,30,23,0,96,MEM,29,15,31,29,0,104
3/19/2017,SAC,27,22,25,28,0,102,SAS,21,37,41,19,0,118
3/21/2017,SAS,25,17,31,27,0,100,MIN,23,28,16,26,0,93
3/23/2017,MEM,22,20,27,21,0,90,SAS,27,24,23,23,0,97
3/25/2017,NYK,23,20,31,24,0,98,SAS,33,28,17,28,0,106
3/27/2017,CLE,18,22,18,16,0,74,SAS,28,36,17,22,0,103
3/29/2017,GSW,17,37,30,26,0,110,SAS,33,24,20,21,0,98
3/31/2017,SAS,16,25,30,29,0,100,OKC,25,29,22,19,0,95
4/2/2017,UTA,28,24,26,25,0,103,SAS,33,21,34,21,0,109
4/4/2017,MEM,16,19,16,33,5,89,SAS,14,19,27,24,11,95
4/5/2017,LAL,31,22,23,26,0,102,SAS,14,27,29,25,0,95
4/7/2017,SAS,21,29,25,27,0,102,DAL,26,35,8,20,0,89
4/8/2017,LAC,22,30,30,16,0,98,SAS,23,20,27,17,0,87
4/10/2017,SAS,28,15,33,22,0,98,POR,31,16,24,28,0,99
4/12/2017,SAS,23,23,26,25,0,97,UTA,32,21,29,19,0,101
10/26/2016,HOU,38,33,25,18,0,114,LAL,38,25,27,30,0,120
10/28/2016,HOU,24,28,25,29,0,106,DAL,24,26,17,31,0,98
10/30/2016,DAL,25,28,17,22,0,92,HOU,34,29,17,13,0,93
11/1/2016,HOU,35,24,25,36,0,120,CLE,29,34,22,43,0,128
11/2/2016,HOU,33,35,32,18,0,118,NYK,25,26,27,21,0,99
11/5/2016,HOU,30,29,25,13,0,97,ATL,30,35,28,19,0,112
11/7/2016,HOU,23,33,28,30,0,114,WAS,30,17,36,23,0,106
11/9/2016,HOU,33,30,22,16,0,101,SAS,24,36,20,19,0,99
11/12/2016,SAS,26,23,33,24,0,106,HOU,22,18,30,30,0,100
11/14/2016,PHI,26,26,16,20,0,88,HOU,38,27,28,22,0,115
11/16/2016,HOU,32,31,27,13,0,103,OKC,38,27,20,20,0,105
11/17/2016,POR,29,33,21,26,0,109,HOU,41,21,38,26,0,126
11/19/2016,UTA,22,22,26,32,0,102,HOU,28,27,26,30,0,111
11/21/2016,HOU,18,33,28,20,0,99,DET,25,21,29,21,0,96
11/23/2016,TOR,24,30,36,25,0,115,HOU,20,19,35,28,0,102
11/25/2016,HOU,38,30,22,27,0,117,SAC,19,31,24,30,0,104
11/27/2016,HOU,35,30,31,34,0,130,POR,35,27,31,21,0,114
11/29/2016,HOU,29,21,23,28,0,101,UTA,38,24,23,35,0,120
12/1/2016,HOU,32,32,22,27,10,132,GSW,30,29,23,31,10,127
12/2/2016,HOU,42,31,26,29,0,128,DEN,33,30,21,26,0,110
12/5/2016,BOS,17,31,35,23,0,106,HOU,26,32,19,30,0,107
12/7/2016,LAL,27,28,22,18,0,95,HOU,43,24,39,28,0,134
12/9/2016,HOU,25,30,31,16,0,102,OKC,23,26,28,22,0,99
12/10/2016,DAL,27,22,20,18,0,87,HOU,36,24,26,23,0,109
12/12/2016,BRK,24,19,42,33,0,118,HOU,29,24,37,32,0,122
12/14/2016,SAC,25,18,24,31,0,98,HOU,36,28,38,30,0,132
12/16/2016,NOP,24,26,29,21,0,100,HOU,35,37,25,25,0,122
12/17/2016,HOU,28,16,23,28,16,111,MIN,24,33,23,15,14,109
12/20/2016,SAS,26,26,19,31,0,102,HOU,24,21,33,22,0,100
12/21/2016,HOU,30,31,30,34,0,125,PHO,26,29,29,27,0,111
12/23/2016,HOU,31,18,26,34,0,109,MEM,25,29,23,38,0,115
12/26/2016,PHO,23,20,37,35,0,115,HOU,39,30,38,24,0,131
12/27/2016,HOU,31,35,32,25,0,123,DAL,31,16,27,33,0,107
12/30/2016,LAC,23,34,41,18,0,116,HOU,37,37,34,32,0,140
12/31/2016,NYK,32,23,37,30,0,122,HOU,27,42,30,30,0,129
1/2/2017,WAS,29,24,17,21,0,91,HOU,14,27,37,23,0,101
1/5/2017,OKC,38,18,27,33,0,116,HOU,33,34,30,21,0,118
1/6/2017,HOU,19,25,35,21,0,100,ORL,22,30,23,18,0,93
1/8/2017,HOU,27,34,34,34,0,129,TOR,37,26,36,23,0,122
1/10/2017,CHO,26,21,32,35,0,114,HOU,32,35,29,25,0,121
1/11/2017,HOU,23,31,23,28,0,105,MIN,30,25,34,30,0,119
1/13/2017,MEM,25,26,32,27,0,110,HOU,31,33,21,20,0,105
1/15/2017,HOU,37,37,30,33,0,137,BRK,36,30,24,22,0,112
1/17/2017,HOU,32,21,26,24,0,103,MIA,27,26,26,30,0,109
1/18/2017,MIL,27,12,26,27,0,92,HOU,22,30,27,32,0,111
1/20/2017,GSW,32,30,37,26,0,125,HOU,29,28,22,29,0,108
1/21/2017,HOU,32,26,33,28,0,119,MEM,22,27,23,23,0,95
1/23/2017,HOU,33,31,27,23,0,114,MIL,33,35,25,34,0,127
1/25/2017,HOU,27,31,28,23,0,109,BOS,24,28,36,32,0,120
1/27/2017,HOU,31,30,33,29,0,123,PHI,28,33,21,36,0,118
1/29/2017,HOU,20,23,27,31,0,101,IND,33,24,33,30,0,120
1/31/2017,SAC,24,11,22,26,0,83,HOU,29,25,28,23,0,105
2/2/2017,ATL,26,21,26,40,0,113,HOU,32,18,36,22,0,108
2/3/2017,CHI,26,23,32,27,9,117,HOU,24,36,19,29,13,121
2/7/2017,ORL,28,26,30,20,0,104,HOU,35,35,24,34,0,128
2/9/2017,HOU,23,27,36,21,0,107,CHO,29,25,22,19,0,95
2/11/2017,PHO,24,29,24,25,0,102,HOU,38,39,34,22,0,133
2/15/2017,MIA,34,24,30,29,0,117,HOU,28,17,28,36,0,109
2/23/2017,HOU,30,36,34,29,0,129,NOP,28,22,17,32,0,99
2/25/2017,MIN,28,30,30,42,0,130,HOU,35,31,40,36,0,142
2/27/2017,IND,20,39,29,29,0,117,HOU,31,27,22,28,0,108
3/1/2017,HOU,34,36,38,14,0,122,LAC,37,21,20,25,0,103
3/4/2017,MEM,24,27,27,30,0,108,HOU,27,28,38,30,0,123
3/6/2017,HOU,39,15,28,28,0,110,SAS,23,24,34,31,0,112
3/8/2017,UTA,30,34,20,31,0,115,HOU,22,31,24,31,0,108
3/10/2017,HOU,23,33,36,23,0,115,CHI,33,16,14,31,0,94
3/12/2017,CLE,26,41,19,26,0,112,HOU,33,25,32,27,0,117
3/15/2017,LAL,26,26,23,25,0,100,HOU,37,29,27,46,0,139
3/17/2017,HOU,23,27,31,31,0,112,NOP,36,32,31,29,0,128
3/18/2017,HOU,26,25,29,29,0,109,DEN,26,30,18,31,0,105
3/20/2017,DEN,28,37,32,27,0,124,HOU,35,27,32,31,0,125
3/24/2017,NOP,33,17,29,28,0,107,HOU,28,21,31,37,0,117
3/26/2017,OKC,31,28,29,37,0,125,HOU,37,42,34,24,0,137
3/28/2017,GSW,37,23,26,27,0,113,HOU,20,32,23,31,0,106
3/30/2017,HOU,31,25,29,22,0,107,POR,32,33,31,21,0,117
3/31/2017,HOU,25,36,24,13,0,98,GSW,23,33,27,24,0,107
4/2/2017,HOU,31,28,31,33,0,123,PHO,21,33,29,33,0,116
4/5/2017,DEN,25,25,29,25,0,104,HOU,36,23,26,25,0,110
4/7/2017,DET,24,28,23,39,0,114,HOU,30,24,33,22,0,109
4/9/2017,HOU,42,36,29,28,0,135,SAC,27,35,27,39,0,128
4/10/2017,HOU,35,22,12,27,0,96,LAC,35,26,36,28,0,125
4/12/2017,MIN,32,28,21,37,0,118,HOU,33,27,35,28,0,123
10/26/2016,OKC,23,28,18,34,0,103,PHI,24,27,24,22,0,97
10/28/2016,PHO,40,13,30,19,8,110,OKC,25,24,28,25,11,113
10/30/2016,LAL,24,22,25,25,0,96,OKC,30,28,19,36,0,113
11/2/2016,OKC,23,26,16,20,0,85,LAC,24,17,25,17,0,83
11/3/2016,OKC,32,11,27,26,0,96,GSW,31,37,30,24,0,122
11/5/2016,MIN,25,28,19,20,0,92,OKC,32,27,31,22,0,112
11/7/2016,MIA,28,19,14,24,0,85,OKC,39,16,28,14,0,97
11/9/2016,TOR,20,42,26,24,0,112,OKC,27,28,20,27,0,102
11/11/2016,LAC,16,34,32,28,0,110,OKC,24,26,24,34,0,108
11/13/2016,ORL,27,30,25,37,0,119,OKC,13,34,37,33,0,117
11/14/2016,OKC,25,22,21,20,0,88,DET,28,31,19,26,0,104
11/16/2016,HOU,32,31,27,13,0,103,OKC,38,27,20,20,0,105
11/18/2016,BRK,40,21,21,23,0,105,OKC,34,30,32,28,0,124
11/20/2016,IND,30,28,21,24,12,115,OKC,21,33,16,33,8,111
11/22/2016,OKC,16,32,26,35,0,109,LAL,29,20,31,31,0,111
11/23/2016,OKC,27,21,27,26,0,101,SAC,27,24,36,29,0,116
11/25/2016,OKC,31,31,22,38,10,132,DEN,30,33,26,33,7,129
11/26/2016,DET,19,27,22,20,0,88,OKC,29,27,21,29,0,106
11/28/2016,OKC,24,34,30,24,0,112,NYK,29,26,26,22,0,103
11/30/2016,WAS,19,34,31,21,10,115,OKC,32,28,24,21,21,126
12/4/2016,NOP,26,15,25,26,0,92,OKC,29,20,29,23,0,101
12/5/2016,OKC,23,32,28,19,0,102,ATL,21,33,15,30,0,99
12/9/2016,HOU,25,30,31,16,0,102,OKC,23,26,28,22,0,99
12/11/2016,BOS,24,19,28,25,0,96,OKC,21,18,28,32,0,99
12/13/2016,OKC,31,21,19,24,0,95,POR,32,36,24,22,0,114
12/14/2016,OKC,21,20,27,21,0,89,UTA,26,29,25,29,0,109
12/17/2016,PHO,20,19,30,32,0,101,OKC,30,24,35,25,0,114
12/19/2016,ATL,22,26,33,29,0,110,OKC,16,37,25,30,0,108
12/21/2016,OKC,34,29,24,34,0,121,NOP,28,30,26,26,0,110
12/23/2016,OKC,25,33,30,29,0,117,BOS,28,26,25,33,0,112
12/25/2016,MIN,27,26,22,25,0,100,OKC,23,34,29,26,0,112
12/27/2016,OKC,33,28,26,19,0,106,MIA,19,29,21,25,0,94
12/29/2016,OKC,21,18,22,19,0,80,MEM,27,28,23,36,0,114
12/31/2016,LAC,12,28,28,20,0,88,OKC,33,36,27,18,0,114
1/2/2017,OKC,30,26,16,22,0,94,MIL,22,28,29,19,0,98
1/4/2017,OKC,22,33,33,24,0,112,CHO,27,33,27,36,0,123
1/5/2017,OKC,38,18,27,33,0,116,HOU,33,34,30,21,0,118
1/7/2017,DEN,22,38,20,26,0,106,OKC,24,36,28,33,0,121
1/9/2017,OKC,26,35,28,20,0,109,CHI,20,26,21,27,0,94
1/11/2017,MEM,22,22,23,28,0,95,OKC,28,27,20,28,0,103
1/13/2017,OKC,28,22,18,18,0,86,MIN,30,15,29,22,0,96
1/15/2017,OKC,28,31,29,34,0,122,SAC,23,23,33,39,0,118
1/16/2017,OKC,25,22,28,23,0,98,LAC,34,30,32,24,0,120
1/18/2017,OKC,31,25,22,22,0,100,GSW,30,26,37,28,0,121
1/23/2017,OKC,27,29,11,30,0,97,UTA,26,27,19,23,0,95
1/25/2017,OKC,33,31,28,22,0,114,NOP,20,25,37,23,0,105
1/26/2017,DAL,26,29,18,25,0,98,OKC,23,30,34,22,0,109
1/29/2017,OKC,24,21,20,26,0,91,CLE,21,37,22,27,0,107
1/31/2017,OKC,17,25,33,19,0,94,SAS,31,21,27,29,0,108
2/1/2017,CHI,21,34,39,34,0,128,OKC,20,27,26,27,0,100
2/3/2017,MEM,23,25,34,20,0,102,OKC,21,37,22,34,0,114
2/5/2017,POR,16,36,21,26,0,99,OKC,24,22,25,34,0,105
2/6/2017,OKC,25,27,18,20,0,90,IND,20,21,32,20,0,93
2/9/2017,CLE,21,36,25,27,0,109,OKC,29,26,31,32,0,118
2/11/2017,GSW,30,43,32,25,0,130,OKC,24,26,37,27,0,114
2/13/2017,OKC,32,22,19,25,0,98,WAS,38,29,34,19,0,120
2/15/2017,NYK,39,21,20,25,0,105,OKC,27,35,26,28,0,116
2/24/2017,LAL,23,28,19,23,0,93,OKC,29,29,28,24,0,110
2/26/2017,NOP,35,24,25,26,0,110,OKC,32,27,28,31,0,118
2/28/2017,UTA,25,28,22,31,0,106,OKC,31,30,25,23,0,109
3/2/2017,OKC,24,36,25,24,0,109,POR,26,31,24,33,0,114
3/3/2017,OKC,28,27,24,32,0,111,PHO,23,35,29,31,0,118
3/5/2017,OKC,27,23,21,18,0,89,DAL,28,32,28,16,0,104
3/7/2017,POR,29,32,38,27,0,126,OKC,40,27,25,29,0,121
3/9/2017,SAS,28,21,22,21,0,92,OKC,29,27,26,20,0,102
3/11/2017,UTA,23,25,28,28,0,104,OKC,29,33,29,21,0,112
3/14/2017,OKC,32,30,29,31,0,122,BRK,32,30,21,21,0,104
3/16/2017,OKC,29,29,39,26,0,123,TOR,24,24,22,32,0,102
3/18/2017,SAC,19,22,24,29,0,94,OKC,29,34,22,25,0,110
3/20/2017,GSW,25,34,33,19,0,111,OKC,22,17,27,29,0,95
3/22/2017,PHI,22,28,20,27,0,97,OKC,29,34,32,27,0,122
3/26/2017,OKC,31,28,29,37,0,125,HOU,37,42,34,24,0,137
3/27/2017,OKC,25,10,22,35,0,92,DAL,26,24,19,22,0,91
3/29/2017,OKC,20,24,28,30,12,114,ORL,18,31,33,20,4,106
3/31/2017,SAS,16,25,30,29,0,100,OKC,25,29,22,19,0,95
4/2/2017,CHO,31,28,25,29,0,113,OKC,22,32,16,31,0,101
4/4/2017,MIL,20,19,20,20,0,79,OKC,28,35,26,21,0,110
4/5/2017,OKC,34,23,22,24,0,103,MEM,27,23,24,26,0,100
4/7/2017,OKC,19,29,24,27,0,99,PHO,32,39,24,25,0,120
4/9/2017,OKC,27,25,29,25,0,106,DEN,26,27,38,14,0,105
4/11/2017,OKC,33,23,15,29,0,100,MIN,16,27,29,26,0,98
4/12/2017,DEN,25,31,30,25,0,111,OKC,26,38,21,20,0,105
10/26/2016,DET,23,23,25,20,0,91,TOR,33,25,28,23,0,109
10/28/2016,CLE,28,22,21,23,0,94,TOR,23,17,27,24,0,91
10/31/2016,DEN,24,25,35,18,0,102,TOR,33,29,26,17,0,105
11/2/2016,TOR,27,27,30,29,0,113,WAS,29,27,19,28,0,103
11/4/2016,MIA,27,19,26,15,0,87,TOR,25,27,23,21,0,96
11/6/2016,SAC,20,24,24,28,0,96,TOR,23,27,16,25,0,91
11/9/2016,TOR,20,42,26,24,0,112,OKC,27,28,20,27,0,102
11/11/2016,TOR,28,30,21,34,0,113,CHO,27,17,38,29,0,111
11/12/2016,NYK,28,28,29,22,0,107,TOR,24,29,34,31,0,118
11/15/2016,TOR,25,32,27,33,0,117,CLE,30,31,30,30,0,121
11/16/2016,GSW,34,32,29,32,0,127,TOR,38,15,33,35,0,121
11/18/2016,TOR,29,23,25,25,11,113,DEN,19,38,25,20,9,111
11/20/2016,TOR,28,35,18,18,0,99,SAC,36,22,28,16,0,102
11/21/2016,TOR,19,26,34,36,0,115,LAC,23,31,34,35,0,123
11/23/2016,TOR,24,30,36,25,0,115,HOU,20,19,35,28,0,102
11/25/2016,TOR,27,20,26,32,0,105,MIL,24,18,25,32,0,99
11/28/2016,PHI,26,23,22,24,0,95,TOR,33,27,31,31,0,122
11/30/2016,MEM,28,29,25,23,0,105,TOR,25,30,34,31,0,120
12/2/2016,LAL,22,26,14,18,0,80,TOR,28,41,15,29,0,113
12/3/2016,ATL,22,25,23,14,0,84,TOR,32,30,24,42,0,128
12/5/2016,CLE,30,32,28,26,0,116,TOR,27,34,20,31,0,112
12/8/2016,MIN,32,27,30,21,0,110,TOR,22,37,29,36,0,124
12/9/2016,TOR,25,17,33,26,0,101,BOS,28,22,18,26,0,94
12/12/2016,MIL,23,26,33,18,0,100,TOR,33,36,23,30,0,122
12/14/2016,TOR,22,38,32,31,0,123,PHI,25,29,20,40,0,114
12/16/2016,ATL,35,34,26,30,0,125,TOR,27,25,30,39,0,121
12/18/2016,TOR,23,32,29,25,0,109,ORL,30,21,13,15,0,79
12/20/2016,BRK,23,23,26,32,0,104,TOR,29,35,27,25,0,116
12/23/2016,TOR,28,28,16,32,0,104,UTA,29,22,23,24,0,98
12/26/2016,TOR,21,22,30,22,0,95,POR,24,18,26,23,0,91
12/28/2016,TOR,17,38,32,24,0,111,GSW,42,30,32,17,0,121
12/29/2016,TOR,18,22,22,29,0,91,PHO,16,26,34,23,0,99
1/1/2017,TOR,27,31,27,38,0,123,LAL,33,24,26,31,0,114
1/3/2017,TOR,18,23,17,24,0,82,SAS,29,31,28,22,0,110
1/5/2017,UTA,27,25,21,20,0,93,TOR,18,30,23,30,0,101
1/7/2017,TOR,28,33,25,21,11,118,CHI,29,19,26,33,16,123
1/8/2017,HOU,27,34,34,34,0,129,TOR,37,26,36,23,0,122
1/10/2017,BOS,18,37,29,22,0,106,TOR,23,23,34,34,0,114
1/13/2017,BRK,27,26,36,24,0,113,TOR,30,24,36,42,0,132
1/15/2017,NYK,26,28,8,39,0,101,TOR,27,42,27,20,0,116
1/17/2017,TOR,26,32,34,27,0,119,BRK,29,32,24,24,0,109
1/18/2017,TOR,21,23,21,24,0,89,PHI,25,21,22,26,0,94
1/20/2017,TOR,18,30,15,15,0,78,CHO,26,29,33,25,0,113
1/22/2017,PHO,28,29,25,33,0,115,TOR,31,29,25,18,0,103
1/24/2017,SAS,29,32,18,29,0,108,TOR,25,29,25,27,0,106
1/25/2017,TOR,34,23,20,22,0,99,MEM,32,24,31,14,0,101
1/27/2017,MIL,19,20,31,16,0,86,TOR,36,17,24,25,0,102
1/29/2017,ORL,27,33,22,32,0,114,TOR,36,15,27,35,0,113
1/31/2017,NOP,25,35,15,21,10,106,TOR,23,23,31,19,12,108
2/1/2017,TOR,30,32,23,19,0,104,BOS,28,23,26,32,0,109
2/3/2017,TOR,24,30,12,28,0,94,ORL,28,24,21,29,0,102
2/5/2017,TOR,26,29,20,28,0,103,BRK,24,19,20,32,0,95
2/6/2017,LAC,31,29,22,27,0,109,TOR,35,35,27,21,0,118
2/8/2017,TOR,33,30,25,21,0,109,MIN,25,28,30,29,0,112
2/12/2017,DET,25,20,21,36,0,102,TOR,27,24,31,19,0,101
2/14/2017,TOR,18,21,25,30,0,94,CHI,24,34,20,27,0,105
2/15/2017,CHO,20,21,34,10,0,85,TOR,31,13,14,32,0,90
2/24/2017,BOS,29,26,22,20,0,97,TOR,18,27,29,33,0,107
2/26/2017,POR,28,24,28,26,0,106,TOR,25,28,29,30,0,112
2/27/2017,TOR,21,19,23,29,0,92,NYK,25,28,14,24,0,91
3/1/2017,WAS,24,38,20,23,0,105,TOR,26,20,14,36,0,96
3/3/2017,TOR,35,27,17,35,0,114,WAS,27,26,25,28,0,106
3/4/2017,TOR,19,23,25,27,0,94,MIL,12,41,27,21,0,101
3/8/2017,TOR,22,23,23,26,0,94,NOP,26,20,18,23,0,87
3/10/2017,TOR,19,29,27,24,0,99,ATL,18,31,25,31,0,105
3/11/2017,TOR,26,15,22,26,0,89,MIA,32,27,26,19,0,104
3/13/2017,DAL,26,20,20,12,0,78,TOR,25,25,29,21,0,100
3/16/2017,OKC,29,29,39,26,0,123,TOR,24,24,22,32,0,102
3/17/2017,TOR,16,24,20,27,0,87,DET,13,25,28,9,0,75
3/19/2017,IND,24,21,28,18,0,91,TOR,32,30,29,25,0,116
3/21/2017,CHI,31,28,35,19,7,120,TOR,27,27,25,34,9,122
3/23/2017,TOR,23,22,30,26,0,101,MIA,33,14,21,16,0,84
3/25/2017,TOR,30,24,20,20,0,94,DAL,22,22,20,22,0,86
3/27/2017,ORL,34,23,32,23,0,112,TOR,35,38,26,32,0,131
3/29/2017,CHO,22,28,16,44,0,110,TOR,19,28,27,32,0,106
3/31/2017,IND,25,23,20,32,0,100,TOR,28,18,34,31,0,111
4/2/2017,PHI,29,20,27,29,0,105,TOR,28,31,27,27,0,113
4/4/2017,TOR,26,25,24,15,0,90,IND,18,22,37,31,0,108
4/5/2017,TOR,15,31,22,37,0,105,DET,33,23,24,22,0,102
4/7/2017,MIA,19,24,22,29,0,94,TOR,26,27,17,26,0,96
4/9/2017,TOR,23,29,24,34,0,110,NYK,29,26,20,22,0,97
4/12/2017,TOR,26,27,22,23,0,98,CLE,21,13,24,25,0,83
10/26/2016,MIA,23,27,30,28,0,108,ORL,27,26,16,27,0,96
10/28/2016,ORL,22,9,20,31,0,82,DET,24,30,32,22,0,108
10/29/2016,ORL,20,25,17,37,0,99,CLE,33,29,18,25,0,105
11/1/2016,ORL,24,19,41,19,0,103,PHI,29,28,30,14,0,101
11/3/2016,SAC,29,21,28,16,0,94,ORL,23,33,28,18,0,102
11/5/2016,WAS,24,26,20,16,0,86,ORL,20,20,21,27,0,88
11/7/2016,ORL,24,28,11,17,0,80,CHI,37,24,27,24,0,112
11/9/2016,MIN,39,35,23,26,0,123,ORL,17,30,30,30,0,107
11/11/2016,UTA,23,19,18,27,0,87,ORL,17,21,26,10,0,74
11/13/2016,ORL,27,30,25,37,0,119,OKC,13,34,37,33,0,117
11/14/2016,ORL,19,18,20,12,0,69,IND,16,25,30,17,0,88
11/16/2016,NOP,19,21,23,19,0,82,ORL,21,31,13,24,0,89
11/19/2016,DAL,16,29,24,18,0,87,ORL,17,27,22,29,0,95
11/21/2016,ORL,27,17,30,15,0,89,MIL,20,29,20,24,0,93
11/23/2016,PHO,24,22,22,24,0,92,ORL,22,22,22,21,0,87
11/25/2016,WAS,26,22,24,22,0,94,ORL,14,24,30,23,0,91
11/27/2016,MIL,36,22,21,25,0,104,ORL,29,23,20,24,0,96
11/29/2016,ORL,16,29,30,20,0,95,SAS,20,23,21,19,0,83
12/1/2016,ORL,28,21,19,26,0,94,MEM,30,20,15,30,0,95
12/2/2016,ORL,21,29,32,23,0,105,PHI,14,28,19,27,0,88
12/4/2016,ORL,23,35,20,20,0,98,DET,27,23,23,19,0,92
12/6/2016,ORL,25,40,31,28,0,124,WAS,24,28,29,35,0,116
12/7/2016,BOS,26,23,36,32,0,117,ORL,27,23,23,14,0,87
12/9/2016,ORL,21,25,24,18,0,88,CHO,20,32,39,18,0,109
12/10/2016,DEN,32,33,27,29,0,121,ORL,29,29,37,18,0,113
12/13/2016,ORL,35,37,27,32,0,131,ATL,34,28,34,24,0,120
12/14/2016,LAC,30,30,27,26,0,113,ORL,25,26,36,21,0,108
12/16/2016,BRK,28,24,30,29,0,111,ORL,25,28,30,35,0,118
12/18/2016,TOR,23,32,29,25,0,109,ORL,30,21,13,15,0,79
12/20/2016,ORL,27,30,28,24,9,136,MIA,28,36,25,20,9,130
12/22/2016,ORL,19,28,25,23,0,95,NYK,27,30,24,25,0,106
12/23/2016,LAL,14,26,29,21,0,90,ORL,30,27,29,23,0,109
12/26/2016,MEM,18,25,28,31,0,102,ORL,36,32,28,16,0,112
12/28/2016,CHO,32,30,35,23,0,120,ORL,28,27,13,33,0,101
1/1/2017,ORL,17,34,22,31,0,104,IND,27,35,27,28,0,117
1/2/2017,ORL,33,34,25,23,0,115,NYK,32,27,21,23,0,103
1/4/2017,ATL,23,29,26,33,0,111,ORL,26,21,18,27,0,92
1/6/2017,HOU,19,25,35,21,0,100,ORL,22,30,23,18,0,93
1/8/2017,ORL,34,26,9,26,0,95,LAL,40,22,19,30,0,111
1/11/2017,ORL,33,18,24,21,0,96,LAC,28,28,17,32,0,105
1/13/2017,ORL,36,18,28,33,0,115,POR,23,26,29,31,0,109
1/14/2017,ORL,42,23,18,24,0,107,UTA,29,35,20,30,0,114
1/16/2017,ORL,36,25,22,29,0,112,DEN,39,30,31,25,0,125
1/18/2017,ORL,29,23,21,25,0,98,NOP,32,33,27,26,0,118
1/20/2017,MIL,23,32,19,22,0,96,ORL,25,34,29,24,0,112
1/22/2017,GSW,28,22,42,26,0,118,ORL,22,28,24,24,0,98
1/24/2017,CHI,20,32,26,22,0,100,ORL,22,27,24,19,0,92
1/27/2017,ORL,24,24,17,33,0,98,BOS,39,29,36,24,0,128
1/29/2017,ORL,27,33,22,32,0,114,TOR,36,15,27,35,0,113
1/30/2017,ORL,23,28,28,19,7,105,MIN,26,26,28,18,13,111
2/1/2017,IND,28,28,24,18,0,98,ORL,23,24,27,14,0,88
2/3/2017,TOR,24,30,12,28,0,94,ORL,28,24,21,29,0,102
2/4/2017,ORL,24,15,26,21,0,86,ATL,35,30,26,22,0,113
2/7/2017,ORL,28,26,30,20,0,104,HOU,35,35,24,34,0,128
2/9/2017,PHI,20,35,30,27,0,112,ORL,25,23,36,27,0,111
2/11/2017,ORL,23,12,17,28,0,80,DAL,29,32,23,28,0,112
2/13/2017,ORL,36,24,27,29,0,116,MIA,28,29,30,20,0,107
2/15/2017,SAS,30,24,31,22,0,107,ORL,16,21,27,15,0,79
2/23/2017,POR,23,23,31,35,0,112,ORL,25,30,30,18,0,103
2/25/2017,ATL,19,27,19,21,0,86,ORL,22,27,31,25,0,105
3/1/2017,NYK,31,29,19,22,0,101,ORL,24,27,16,23,0,90
3/3/2017,MIA,25,28,20,26,0,99,ORL,33,27,25,25,0,110
3/5/2017,ORL,28,33,29,24,0,114,WAS,25,20,34,36,0,115
3/6/2017,NYK,20,31,34,28,0,113,ORL,28,26,38,13,0,105
3/8/2017,CHI,22,31,24,14,0,91,ORL,19,24,34,21,0,98
3/10/2017,ORL,24,16,22,19,0,81,CHO,37,21,30,33,0,121
3/11/2017,CLE,24,35,28,29,0,116,ORL,25,26,28,25,0,104
3/13/2017,ORL,23,35,26,31,0,115,SAC,24,34,35,27,0,120
3/16/2017,ORL,20,30,21,21,0,92,GSW,34,33,36,19,0,122
3/17/2017,ORL,30,30,24,25,0,109,PHO,22,36,27,18,0,103
3/20/2017,PHI,26,30,27,15,11,109,ORL,25,16,33,24,14,112
3/22/2017,CHO,21,27,29,32,0,109,ORL,27,27,28,20,0,102
3/24/2017,DET,18,21,23,25,0,87,ORL,22,35,35,23,0,115
3/27/2017,ORL,34,23,32,23,0,112,TOR,35,38,26,32,0,131
3/29/2017,OKC,20,24,28,30,12,114,ORL,18,31,33,20,4,106
3/31/2017,ORL,29,35,26,26,0,116,BOS,31,26,35,25,0,117
4/1/2017,ORL,33,20,36,22,0,111,BRK,33,27,29,32,0,121
4/4/2017,ORL,31,24,20,27,0,102,CLE,28,25,43,26,0,122
4/6/2017,BRK,25,25,21,36,0,107,ORL,22,28,36,29,0,115
4/8/2017,IND,39,29,31,28,0,127,ORL,38,21,23,30,0,112
4/10/2017,ORL,13,24,22,16,0,75,CHI,34,30,28,30,0,122
4/12/2017,DET,17,32,32,28,0,109,ORL,38,21,28,26,0,113
