date,rest_days,away_team,away_q1,away_q2,away_q3,away_q4,away_OT,away_final,home_team,home_q1,home_q2,home_q3,home_q4,home_OT,home_final
2017-10-17,10,BOS,19,19,33,28,0,99,CLE,29,25,18,30,0,102
2017-10-20,3,CLE,25,30,31,30,0,116,MIL,25,24,24,24,0,97
2017-10-21,1,ORL,36,20,32,26,0,114,CLE,18,27,20,28,0,93
2017-10-24,3,CHI,38,30,24,20,0,112,CLE,28,37,26,28,0,119
2017-10-25,1,CLE,23,29,21,34,0,107,BRK,26,29,29,28,0,112
2017-10-28,3,CLE,22,30,31,18,0,101,NOP,35,30,24,34,0,123
2017-10-29,1,NYK,29,33,30,22,0,114,CLE,19,35,21,20,0,95
2017-11-01,3,IND,30,32,30,32,0,124,CLE,28,33,24,22,0,107
2017-11-03,2,CLE,42,32,30,26,0,130,WAS,36,30,27,29,0,122
2017-11-05,2,ATL,37,17,37,26,0,117,CLE,28,17,33,37,0,115
2017-11-07,2,MIL,28,39,23,29,0,119,CLE,39,26,29,30,0,124
2017-11-09,2,CLE,25,42,26,20,0,113,HOU,36,29,35,17,0,117
2017-11-11,2,CLE,29,20,34,28,0,111,DAL,23,29,22,30,0,104
2017-11-13,2,CLE,25,13,23,43,0,104,NYK,22,29,25,25,0,101
2017-11-15,2,CLE,36,25,27,27,0,115,CHO,30,37,17,23,0,107
2017-11-17,2,LAC,27,29,25,24,8,113,CLE,24,32,22,27,13,118
2017-11-20,3,CLE,36,37,28,15,0,116,DET,23,23,16,26,0,88
2017-11-22,2,BRK,17,29,31,32,0,109,CLE,20,25,32,42,0,119
2017-11-24,2,CHO,28,29,25,17,0,99,CLE,27,27,29,17,0,100
2017-11-27,3,CLE,29,24,33,27,0,113,PHI,22,23,28,18,0,91
2017-11-28,1,MIA,24,25,25,23,0,97,CLE,35,40,18,15,0,108
2017-11-30,2,CLE,42,21,36,22,0,121,ATL,35,32,23,24,0,114
2017-12-02,2,MEM,32,20,30,29,0,111,CLE,28,38,27,23,0,116
2017-12-04,2,CLE,29,32,25,27,0,113,CHI,22,23,26,20,0,91
2017-12-06,2,SAC,22,35,21,17,0,95,CLE,19,29,25,28,0,101
2017-12-08,2,CLE,33,30,23,16,0,102,IND,32,25,32,17,0,106
2017-12-09,1,PHI,24,22,27,25,0,98,CLE,23,29,26,27,0,105
2017-12-12,3,ATL,31,17,29,37,0,114,CLE,31,31,32,29,0,123
2017-12-14,2,LAL,26,34,26,26,0,112,CLE,24,39,31,27,0,121
2017-12-16,2,UTA,24,24,25,27,0,100,CLE,23,28,29,29,0,109
2017-12-17,1,CLE,27,33,23,23,0,106,WAS,23,37,23,16,0,99
2017-12-19,2,CLE,34,24,25,33,0,116,MIL,30,39,29,21,0,119
2017-12-21,2,CHI,27,29,23,33,0,112,CLE,29,29,24,33,0,115
2017-12-25,4,CLE,28,16,23,25,0,92,GSW,24,22,25,28,0,99
2017-12-27,2,CLE,27,28,25,15,0,95,SAC,28,34,23,24,0,109
2017-12-30,3,CLE,32,21,16,32,0,101,UTA,22,26,28,28,0,104
2018-01-02,3,POR,28,28,31,23,0,110,CLE,28,25,38,36,0,127
2018-01-03,1,CLE,21,26,21,20,0,88,BOS,32,23,26,21,0,102
2018-01-06,3,CLE,31,36,40,24,0,131,ORL,30,34,23,40,0,127
2018-01-08,2,CLE,18,24,25,32,0,99,MIN,32,37,33,25,0,127
2018-01-11,3,CLE,24,16,32,27,0,99,TOR,30,35,35,33,0,133
2018-01-12,1,CLE,34,24,16,21,0,95,IND,12,32,32,21,0,97
2018-01-15,3,GSW,35,22,36,25,0,118,CLE,37,27,27,17,0,108
2018-01-18,3,ORL,20,27,33,23,0,103,CLE,36,31,17,20,0,104
2018-01-20,2,OKC,43,33,38,34,0,148,CLE,24,36,34,30,0,124
2018-01-23,3,CLE,29,26,26,21,0,102,SAS,25,38,26,25,0,114
2018-01-26,3,IND,31,29,20,28,0,108,CLE,38,35,24,18,0,115
2018-01-28,2,DET,28,33,26,17,0,104,CLE,33,25,32,31,0,121
2018-01-30,2,CLE,27,36,21,30,0,114,DET,33,26,30,36,0,125
2018-01-31,1,MIA,21,29,22,17,0,89,CLE,27,21,24,19,0,91
2018-02-03,3,HOU,32,33,32,23,0,120,CLE,20,19,30,19,0,88
2018-02-06,3,CLE,43,24,22,9,0,98,ORL,31,20,41,24,0,116
2018-02-07,1,MIN,29,37,33,30,9,138,CLE,31,33,37,28,11,140
2018-02-09,2,CLE,31,30,36,26,0,123,ATL,27,29,26,25,0,107
2018-02-11,2,CLE,31,33,31,26,0,121,BOS,32,20,22,25,0,99
2018-02-13,2,CLE,29,33,29,29,0,120,OKC,28,29,30,25,0,112
2018-02-22,9,WAS,22,35,25,28,0,110,CLE,31,23,25,24,0,103
2018-02-23,1,CLE,20,34,31,27,0,112,MEM,27,22,22,18,0,89
2018-02-25,2,SAS,25,25,26,34,0,110,CLE,20,33,21,20,0,94
2018-02-27,2,BRK,29,32,30,32,0,123,CLE,25,35,34,35,0,129
2018-03-01,2,PHI,32,27,18,31,0,108,CLE,29,27,15,26,0,97
2018-03-03,2,DEN,37,36,30,23,0,126,CLE,31,31,35,20,0,117
2018-03-05,2,DET,28,21,21,20,0,90,CLE,26,28,36,22,0,112
2018-03-07,2,CLE,38,32,19,24,0,113,DEN,23,35,29,21,0,108
2018-03-09,2,CLE,17,30,30,25,0,102,LAC,35,26,24,31,0,116
2018-03-11,2,CLE,29,31,22,31,0,113,LAL,33,32,33,29,0,127
2018-03-13,2,CLE,38,30,34,27,0,129,PHO,18,34,28,27,0,107
2018-03-15,2,CLE,29,25,23,28,0,105,POR,29,30,29,25,0,113
2018-03-17,2,CLE,32,37,16,29,0,114,CHI,31,21,29,28,0,109
2018-03-19,2,MIL,25,32,28,32,0,117,CLE,26,38,29,31,0,124
2018-03-21,2,TOR,38,41,20,30,0,129,CLE,42,22,34,34,0,132
2018-03-23,2,PHO,27,18,26,24,0,95,CLE,23,39,31,27,0,120
2018-03-25,2,CLE,28,32,27,34,0,121,BRK,30,32,27,25,0,114
2018-03-27,2,CLE,18,16,25,20,0,79,MIA,29,25,21,23,0,98
2018-03-28,1,CLE,22,42,31,23,0,118,CHO,26,28,24,27,0,105
2018-03-30,2,NOP,29,28,22,23,0,102,CLE,29,18,33,27,0,107
2018-04-01,2,DAL,25,22,30,10,0,87,CLE,18,30,25,25,0,98
2018-04-03,2,TOR,24,28,26,28,0,106,CLE,28,32,26,26,0,112
2018-04-05,2,WAS,26,28,36,25,0,115,CLE,39,20,23,37,0,119
2018-04-06,1,CLE,28,27,43,32,0,130,PHI,41,37,27,27,0,132
2018-04-09,3,CLE,26,35,29,33,0,123,NYK,25,24,28,32,0,109
2018-04-11,2,NYK,20,37,27,26,0,110,CLE,20,17,34,27,0,98
2017-10-17,10,BOS,19,19,33,28,0,99,CLE,29,25,18,30,0,102
2017-10-18,1,MIL,24,34,18,32,0,108,BOS,26,27,27,20,0,100
2017-10-20,2,BOS,24,22,23,33,0,102,PHI,21,29,22,20,0,92
2017-10-24,4,NYK,17,16,27,29,0,89,BOS,30,24,23,33,0,110
2017-10-26,2,BOS,28,15,29,24,0,96,MIL,23,21,25,20,0,89
2017-10-28,2,BOS,21,26,27,22,0,96,MIA,26,19,18,27,0,90
2017-10-30,2,SAS,26,23,18,27,0,94,BOS,30,24,26,28,0,108
2017-11-01,2,SAC,24,21,15,26,0,86,BOS,27,31,31,24,0,113
2017-11-03,2,BOS,18,19,30,34,0,101,OKC,31,24,16,23,0,94
2017-11-05,2,BOS,22,27,28,27,0,104,ORL,20,18,31,19,0,88
2017-11-06,1,BOS,26,28,28,28,0,110,ATL,25,29,21,32,0,107
2017-11-08,2,LAL,16,36,29,15,0,96,BOS,33,28,26,20,0,107
2017-11-10,2,CHO,26,31,19,11,0,87,BOS,11,30,23,26,0,90
2017-11-12,2,TOR,24,25,27,18,0,94,BOS,24,20,33,18,0,95
2017-11-14,2,BOS,30,22,28,29,0,109,BRK,21,31,19,31,0,102
2017-11-16,2,GSW,28,19,21,20,0,88,BOS,18,24,26,24,0,92
2017-11-18,2,BOS,20,24,36,30,0,110,ATL,35,15,27,22,0,99
2017-11-20,2,BOS,34,19,16,27,14,110,DAL,22,27,28,19,6,102
2017-11-22,2,BOS,16,25,22,35,0,98,MIA,27,27,25,25,0,104
2017-11-24,2,ORL,26,21,22,34,0,103,BOS,40,33,26,19,0,118
2017-11-25,1,BOS,27,18,37,26,0,108,IND,32,22,16,28,0,98
2017-11-27,2,DET,31,29,26,32,0,118,BOS,23,34,29,22,0,108
2017-11-30,3,PHI,22,22,27,26,0,97,BOS,28,26,22,32,0,108
2017-12-02,2,PHO,22,32,25,32,0,111,BOS,31,29,29,27,0,116
2017-12-04,2,MIL,26,23,32,19,0,100,BOS,34,28,26,23,0,111
2017-12-06,2,DAL,26,31,16,17,0,90,BOS,24,23,23,27,0,97
2017-12-08,2,BOS,31,24,27,20,0,102,SAS,26,30,21,28,0,105
2017-12-10,2,BOS,29,15,29,18,0,91,DET,21,16,22,22,0,81
2017-12-11,1,BOS,29,13,21,22,0,85,CHI,28,28,22,30,0,108
2017-12-13,2,DEN,31,28,33,26,0,118,BOS,30,38,29,27,0,124
2017-12-15,2,UTA,21,25,33,28,0,107,BOS,26,13,28,28,0,95
2017-12-16,1,BOS,31,17,23,31,0,102,MEM,12,28,33,20,0,93
2017-12-18,2,BOS,38,24,23,27,0,112,IND,21,26,31,33,0,111
2017-12-20,2,MIA,15,21,26,28,0,90,BOS,24,20,15,30,0,89
2017-12-21,1,BOS,15,25,28,25,0,93,NYK,25,19,24,34,0,102
2017-12-23,2,CHI,31,27,18,16,0,92,BOS,33,27,38,19,0,117
2017-12-25,2,WAS,30,22,28,31,0,111,BOS,24,26,26,27,0,103
2017-12-27,2,BOS,28,32,16,26,0,102,CHO,16,28,31,16,0,91
2017-12-28,1,HOU,32,30,16,20,0,98,BOS,12,26,31,30,0,99
2017-12-31,3,BRK,28,31,17,29,0,105,BOS,38,23,21,26,0,108
2018-01-03,3,CLE,21,26,21,20,0,88,BOS,32,23,26,21,0,102
2018-01-05,2,MIN,19,19,24,22,0,84,BOS,19,22,25,25,0,91
2018-01-06,1,BOS,16,23,25,23,0,87,BRK,22,19,20,24,0,85
2018-01-11,5,BOS,23,25,37,29,0,114,PHI,28,29,22,24,0,103
2018-01-16,5,NOP,32,26,29,17,12,116,BOS,25,23,32,24,9,113
2018-01-18,2,PHI,21,18,32,18,0,89,BOS,19,13,21,27,0,80
2018-01-21,3,ORL,28,30,32,13,0,103,BOS,29,30,12,24,0,95
2018-01-23,2,BOS,21,32,21,33,0,107,LAL,15,30,31,32,0,108
2018-01-24,1,BOS,25,37,29,22,0,113,LAC,22,33,22,25,0,102
2018-01-27,3,BOS,37,17,19,32,0,105,GSW,27,23,30,29,0,109
2018-01-29,2,BOS,32,24,24,31,0,111,DEN,21,24,37,28,0,110
2018-01-31,2,NYK,24,21,20,8,0,73,BOS,27,23,31,22,0,103
2018-02-02,2,ATL,32,23,20,35,0,110,BOS,26,27,41,25,0,119
2018-02-04,2,POR,26,28,19,23,0,96,BOS,19,19,31,28,0,97
2018-02-06,2,BOS,18,19,23,31,0,91,TOR,22,36,25,28,0,111
2018-02-08,2,BOS,26,23,26,23,12,110,WAS,27,24,19,28,6,104
2018-02-09,1,IND,30,29,17,21,0,97,BOS,16,22,34,19,0,91
2018-02-11,2,CLE,31,33,31,26,0,121,BOS,32,20,22,25,0,99
2018-02-14,3,LAC,34,27,32,36,0,129,BOS,25,32,34,28,0,119
2018-02-23,9,BOS,23,38,25,24,0,110,DET,28,21,28,21,0,98
2018-02-24,1,BOS,23,36,29,33,0,121,NYK,24,32,25,31,0,112
2018-02-26,2,MEM,24,17,28,29,0,98,BOS,33,34,19,23,0,109
2018-02-28,2,CHO,31,28,20,27,0,106,BOS,37,30,36,31,0,134
2018-03-03,3,BOS,32,32,25,31,0,120,HOU,30,28,28,37,0,123
2018-03-05,2,BOS,35,20,31,19,0,105,CHI,16,13,24,36,0,89
2018-03-08,3,BOS,35,25,26,31,0,117,MIN,28,18,28,35,0,109
2018-03-11,3,IND,24,16,34,25,0,99,BOS,25,25,20,27,0,97
2018-03-14,3,WAS,23,29,29,25,9,125,BOS,37,22,21,26,9,124
2018-03-16,2,BOS,25,23,27,17,0,92,ORL,16,15,21,31,0,83
2018-03-18,2,BOS,28,21,27,13,0,89,NOP,20,27,35,26,0,108
2018-03-20,2,OKC,26,22,27,24,0,99,BOS,18,27,28,27,0,100
2018-03-23,3,BOS,23,24,20,38,0,105,POR,26,26,25,23,0,100
2018-03-25,2,BOS,24,28,28,24,0,104,SAC,27,33,18,15,0,93
2018-03-26,1,BOS,31,17,29,25,0,102,PHO,15,30,20,29,0,94
2018-03-28,2,BOS,18,30,19,30,0,97,UTA,24,15,32,23,0,94
2018-03-31,3,TOR,33,22,29,15,0,99,BOS,31,22,29,28,0,110
2018-04-03,3,BOS,31,25,15,31,0,102,MIL,26,32,21,27,0,106
2018-04-04,1,BOS,20,13,20,25,0,78,TOR,14,29,24,29,0,96
2018-04-06,2,CHI,30,28,18,28,0,104,BOS,30,25,24,32,0,111
2018-04-08,2,ATL,24,25,27,36,0,112,BOS,31,27,24,24,0,106
2018-04-10,2,BOS,30,24,18,29,0,101,WAS,22,30,27,34,0,113
2018-04-11,1,BRK,22,21,27,27,0,97,BOS,27,26,30,27,0,110
2017-10-18,10,PHI,23,36,23,33,0,115,WAS,32,24,34,30,0,120
2017-10-20,2,DET,31,34,16,30,0,111,WAS,29,29,33,24,0,115
2017-10-23,3,WAS,29,27,22,31,0,109,DEN,29,26,22,27,0,104
2017-10-25,2,WAS,18,31,30,13,7,99,LAL,23,22,24,23,10,102
2017-10-27,2,WAS,34,33,30,20,0,117,GSW,27,26,34,33,0,120
2017-10-29,2,WAS,35,28,25,22,0,110,SAC,16,16,28,23,0,83
2017-11-01,3,PHO,15,37,35,35,0,122,WAS,32,32,26,26,0,116
2017-11-03,2,CLE,42,32,30,26,0,130,WAS,36,30,27,29,0,122
2017-11-05,2,WAS,32,30,22,23,0,107,TOR,17,29,30,20,0,96
2017-11-07,2,DAL,36,28,26,23,0,113,WAS,34,19,23,23,0,99
2017-11-09,2,LAL,34,22,21,18,0,95,WAS,37,32,22,20,0,111
2017-11-11,2,ATL,19,23,25,27,0,94,WAS,20,29,27,37,0,113
2017-11-13,2,SAC,32,19,20,21,0,92,WAS,25,32,29,24,0,110
2017-11-15,2,WAS,30,31,10,31,0,102,MIA,19,30,25,19,0,93
2017-11-17,2,MIA,26,24,16,25,0,91,WAS,17,12,28,31,0,88
2017-11-19,2,WAS,28,27,21,15,0,91,TOR,28,32,19,21,0,100
2017-11-20,1,WAS,27,20,26,26,0,99,MIL,19,27,20,22,0,88
2017-11-22,2,WAS,26,33,29,26,10,124,CHO,25,30,29,30,15,129
2017-11-25,3,POR,27,14,32,35,0,108,WAS,30,22,31,22,0,105
2017-11-28,3,WAS,23,20,25,24,0,92,MIN,30,21,20,18,0,89
2017-11-29,1,WAS,18,22,25,48,0,113,PHI,28,30,26,34,0,118
2017-12-01,2,DET,26,26,15,24,0,91,WAS,26,20,35,28,0,109
2017-12-04,3,WAS,15,15,22,17,0,69,UTA,29,35,24,28,0,116
2017-12-05,1,WAS,24,27,28,27,0,106,POR,22,15,29,26,0,92
2017-12-07,2,WAS,26,31,28,24,0,109,PHO,28,24,32,15,0,99
2017-12-09,2,WAS,27,22,32,31,0,112,LAC,30,32,23,28,0,113
2017-12-12,3,WAS,22,29,27,20,0,98,BRK,30,21,28,24,0,103
2017-12-13,1,MEM,12,17,28,30,0,87,WAS,22,19,19,33,0,93
2017-12-15,2,LAC,18,25,21,27,0,91,WAS,25,23,27,25,0,100
2017-12-17,2,CLE,27,33,23,23,0,106,WAS,23,37,23,16,0,99
2017-12-19,2,NOP,19,36,15,36,0,106,WAS,36,25,32,23,0,116
2017-12-22,3,WAS,23,20,18,23,0,84,BRK,26,27,35,31,0,119
2017-12-23,1,ORL,29,19,35,20,0,103,WAS,37,35,28,30,0,130
2017-12-25,2,WAS,30,22,28,31,0,111,BOS,24,26,26,27,0,103
2017-12-27,2,WAS,29,28,19,23,0,99,ATL,29,26,23,35,0,113
2017-12-29,2,HOU,23,25,30,25,0,103,WAS,27,32,28,34,0,121
2017-12-31,2,CHI,38,25,26,21,0,110,WAS,30,29,24,31,0,114
2018-01-03,3,NYK,32,31,14,26,0,103,WAS,33,31,26,31,0,121
2018-01-05,2,WAS,33,25,29,15,0,102,MEM,24,26,22,28,0,100
2018-01-06,1,MIL,24,29,29,28,0,110,WAS,32,21,32,18,0,103
2018-01-10,4,UTA,25,21,37,24,0,107,WAS,32,18,27,27,0,104
2018-01-12,2,ORL,33,30,35,21,0,119,WAS,34,31,33,27,0,125
2018-01-13,1,BRK,18,21,35,33,6,113,WAS,33,26,24,24,12,119
2018-01-15,2,MIL,28,25,25,26,0,104,WAS,30,21,21,23,0,95
2018-01-17,2,WAS,36,25,18,30,0,109,CHO,38,39,25,31,0,133
2018-01-19,2,WAS,19,27,45,31,0,122,DET,29,17,28,38,0,112
2018-01-22,3,WAS,22,15,17,21,0,75,DAL,22,31,18,27,0,98
2018-01-25,3,WAS,20,20,34,38,0,112,OKC,25,29,28,39,0,121
2018-01-27,2,WAS,27,34,31,37,0,129,ATL,18,27,26,33,0,104
2018-01-30,3,OKC,25,29,22,20,0,96,WAS,30,23,22,27,0,102
2018-02-01,2,TOR,34,28,25,32,0,119,WAS,27,28,33,34,0,122
2018-02-03,2,WAS,31,25,31,28,0,115,ORL,25,22,22,29,0,98
2018-02-05,2,WAS,28,30,28,25,0,111,IND,23,26,25,28,0,102
2018-02-06,1,WAS,20,35,29,18,0,102,PHI,37,28,29,21,0,115
2018-02-08,2,BOS,26,23,26,23,12,110,WAS,27,24,19,28,6,104
2018-02-10,2,WAS,30,26,26,19,0,101,CHI,22,24,24,20,0,90
2018-02-14,4,WAS,26,25,39,28,0,118,NYK,39,33,15,26,0,113
2018-02-22,8,WAS,22,35,25,28,0,110,CLE,31,23,25,24,0,103
2018-02-23,1,CHO,36,31,27,28,0,122,WAS,26,29,27,23,0,105
2018-02-25,2,PHI,28,20,25,21,0,94,WAS,30,37,20,22,0,109
2018-02-27,2,WAS,40,24,20,23,0,107,MIL,22,28,31,23,0,104
2018-02-28,1,GSW,36,22,27,24,0,109,WAS,21,35,14,31,0,101
2018-03-02,2,TOR,19,32,26,25,0,102,WAS,27,20,27,21,0,95
2018-03-04,2,IND,30,25,25,18,0,98,WAS,20,25,20,30,0,95
2018-03-06,2,MIA,26,24,30,25,8,113,WAS,31,28,27,19,12,117
2018-03-09,3,WAS,22,31,30,33,0,116,NOP,19,19,24,35,0,97
2018-03-10,1,WAS,20,28,28,26,0,102,MIA,26,34,43,26,0,129
2018-03-13,3,MIN,25,28,29,34,0,116,WAS,26,33,31,21,0,111
2018-03-14,1,WAS,23,29,29,25,9,125,BOS,37,22,21,26,9,124
2018-03-17,3,IND,20,25,26,31,0,102,WAS,25,32,29,23,0,109
2018-03-21,4,WAS,18,26,16,30,0,90,SAS,18,32,27,21,0,98
2018-03-23,2,DEN,23,32,23,30,0,108,WAS,16,27,33,24,0,100
2018-03-25,2,NYK,19,42,16,24,0,101,WAS,21,32,18,26,0,97
2018-03-27,2,SAS,24,21,21,40,0,106,WAS,21,38,29,28,0,116
2018-03-29,2,WAS,24,25,17,26,0,92,DET,23,26,32,22,0,103
2018-03-31,2,CHO,27,24,23,19,0,93,WAS,30,20,37,20,0,107
2018-04-01,1,WAS,27,32,16,19,0,94,CHI,36,32,19,26,0,113
2018-04-03,2,WAS,24,25,26,29,0,104,HOU,35,36,24,25,0,120
2018-04-05,2,WAS,26,28,36,25,0,115,CLE,39,20,23,37,0,119
2018-04-06,1,ATL,21,31,29,22,0,103,WAS,22,26,29,20,0,97
2018-04-10,4,BOS,30,24,18,29,0,101,WAS,22,30,27,34,0,113
2018-04-11,1,WAS,23,22,30,17,0,92,ORL,26,29,21,25,0,101
2017-10-18,10,CHO,27,18,25,20,0,90,DET,29,27,26,20,0,102
2017-10-20,2,ATL,28,28,17,18,0,91,CHO,18,31,35,25,0,109
2017-10-23,3,CHO,25,29,23,17,0,94,MIL,18,35,30,20,0,103
2017-10-25,2,DEN,23,16,29,25,0,93,CHO,27,35,23,25,0,110
2017-10-27,2,HOU,27,29,22,31,0,109,CHO,30,16,28,19,0,93
2017-10-29,2,ORL,24,25,37,27,0,113,CHO,27,34,32,27,0,120
2017-10-30,1,CHO,31,20,22,31,0,104,MEM,31,26,25,17,0,99
2017-11-01,2,MIL,32,25,31,33,0,121,CHO,25,35,28,38,0,126
2017-11-03,2,CHO,19,26,26,30,0,101,SAS,25,24,31,28,0,108
2017-11-05,2,CHO,28,23,28,15,0,94,MIN,28,40,29,15,0,112
2017-11-07,2,CHO,41,28,25,19,0,113,NYK,32,26,25,35,0,118
2017-11-10,3,CHO,26,31,19,11,0,87,BOS,11,30,23,26,0,90
2017-11-15,5,CLE,36,25,27,27,0,115,CHO,30,37,17,23,0,107
2017-11-17,2,CHO,27,33,32,28,0,120,CHI,26,34,23,40,0,123
2017-11-18,1,LAC,24,22,25,16,0,87,CHO,25,30,18,29,0,102
2017-11-20,2,MIN,24,28,28,22,0,102,CHO,26,29,29,34,0,118
2017-11-22,2,WAS,26,33,29,26,10,124,CHO,25,30,29,30,15,129
2017-11-24,2,CHO,28,29,25,17,0,99,CLE,27,27,29,17,0,100
2017-11-25,1,SAS,14,26,32,34,0,106,CHO,15,14,29,28,0,86
2017-11-29,4,CHO,25,27,33,28,0,113,TOR,32,39,22,33,0,126
2017-12-01,2,CHO,30,19,26,25,0,100,MIA,22,28,29,26,0,105
2017-12-04,3,ORL,23,22,29,20,0,94,CHO,26,28,21,29,0,104
2017-12-06,2,GSW,26,27,26,22,0,101,CHO,18,20,30,19,0,87
2017-12-08,2,CHI,31,21,23,31,13,119,CHO,25,27,27,27,5,111
2017-12-09,1,LAL,28,24,24,34,0,110,CHO,29,27,19,24,0,99
2017-12-11,2,CHO,34,18,40,24,0,116,OKC,26,26,22,29,0,103
2017-12-13,2,CHO,23,26,20,27,0,96,HOU,38,25,28,17,0,108
2017-12-15,2,MIA,24,29,26,25,0,104,CHO,19,28,24,27,0,98
2017-12-16,1,POR,24,25,25,19,0,93,CHO,20,17,30,24,0,91
2017-12-18,2,NYK,23,19,22,27,0,91,CHO,29,31,28,21,0,109
2017-12-20,2,TOR,22,41,36,30,0,129,CHO,26,21,32,32,0,111
2017-12-22,2,CHO,23,36,26,19,0,104,MIL,26,26,31,26,0,109
2017-12-23,1,MIL,23,31,31,21,0,106,CHO,24,29,28,30,0,111
2017-12-27,4,BOS,28,32,16,26,0,102,CHO,16,28,31,16,0,91
2017-12-29,2,CHO,32,21,26,32,0,111,GSW,29,24,22,25,0,100
2017-12-31,2,CHO,22,30,14,32,0,98,LAC,29,13,33,31,0,106
2018-01-02,2,CHO,32,40,28,31,0,131,SAC,25,27,29,30,0,111
2018-01-05,3,CHO,28,35,30,15,0,108,LAL,24,24,28,18,0,94
2018-01-10,5,DAL,20,39,24,32,0,115,CHO,28,24,25,34,0,111
2018-01-12,2,UTA,25,21,26,16,0,88,CHO,25,27,22,25,0,99
2018-01-13,1,OKC,31,24,18,28,0,101,CHO,28,31,17,15,0,91
2018-01-15,2,CHO,27,23,34,34,0,118,DET,27,29,24,27,0,107
2018-01-17,2,WAS,36,25,18,30,0,109,CHO,38,39,25,31,0,133
2018-01-20,3,MIA,31,26,16,33,0,106,CHO,27,21,35,22,0,105
2018-01-22,2,SAC,33,22,20,32,0,107,CHO,35,32,25,20,0,112
2018-01-24,2,NOP,32,24,20,25,0,101,CHO,21,32,20,23,0,96
2018-01-26,2,ATL,26,26,34,24,0,110,CHO,30,31,29,31,0,121
2018-01-27,1,CHO,26,22,30,13,0,91,MIA,22,32,17,24,0,95
2018-01-29,2,CHO,23,28,27,18,0,96,IND,23,29,29,24,0,105
2018-01-31,2,CHO,35,29,33,26,0,123,ATL,28,24,32,26,0,110
2018-02-02,2,IND,37,20,34,35,0,126,CHO,49,22,25,37,0,133
2018-02-04,2,CHO,25,23,38,29,0,115,PHO,31,28,35,16,0,110
2018-02-05,1,CHO,25,37,22,20,0,104,DEN,36,27,34,24,0,121
2018-02-08,3,CHO,18,27,20,32,6,103,POR,29,20,30,18,12,109
2018-02-09,1,CHO,24,22,31,17,0,94,UTA,28,27,29,22,0,106
2018-02-11,2,TOR,30,32,28,33,0,123,CHO,26,29,19,29,0,103
2018-02-14,3,CHO,20,34,31,19,0,104,ORL,26,27,25,24,0,102
2018-02-22,8,BRK,28,25,21,22,0,96,CHO,32,23,25,31,0,111
2018-02-23,1,CHO,36,31,27,28,0,122,WAS,26,29,27,23,0,105
2018-02-25,2,DET,19,27,25,27,0,98,CHO,32,38,26,18,0,114
2018-02-27,2,CHI,29,22,27,25,0,103,CHO,26,25,36,31,0,118
2018-02-28,1,CHO,31,28,20,27,0,106,BOS,37,30,36,31,0,134
2018-03-02,2,CHO,30,26,24,19,0,99,PHI,27,21,26,36,0,110
2018-03-04,2,CHO,21,22,26,29,0,98,TOR,26,26,30,21,0,103
2018-03-06,2,PHI,32,39,30,27,0,128,CHO,29,30,32,23,0,114
2018-03-08,2,BRK,35,30,31,29,0,125,CHO,29,30,26,26,0,111
2018-03-10,2,PHO,25,26,21,43,0,115,CHO,32,27,35,28,0,122
2018-03-13,3,CHO,32,33,27,23,0,115,NOP,37,35,20,27,0,119
2018-03-15,2,CHO,33,30,34,32,0,129,ATL,23,32,24,38,0,117
2018-03-17,2,CHO,24,26,17,34,0,101,NYK,22,35,42,25,0,124
2018-03-19,2,CHO,18,38,14,24,0,94,PHI,21,28,32,27,0,108
2018-03-21,2,CHO,22,21,32,36,0,111,BRK,34,28,25,18,0,105
2018-03-22,1,MEM,14,28,15,22,0,79,CHO,37,38,37,28,0,140
2018-03-24,2,CHO,22,32,25,23,0,102,DAL,27,21,22,28,0,98
2018-03-26,2,NYK,22,27,33,35,11,128,CHO,27,35,25,30,20,137
2018-03-28,2,CLE,22,42,31,23,0,118,CHO,26,28,24,27,0,105
2018-03-31,3,CHO,27,24,23,19,0,93,WAS,30,20,37,20,0,107
2018-04-01,1,PHI,28,32,31,28,0,119,CHO,29,22,27,24,0,102
2018-04-03,2,CHO,22,25,32,35,0,114,CHI,19,34,33,34,0,120
2018-04-06,3,CHO,43,29,31,34,0,137,ORL,25,24,26,25,0,100
2018-04-08,2,IND,31,39,25,28,0,123,CHO,25,32,24,36,0,117
2018-04-10,2,CHO,37,26,24,32,0,119,IND,25,30,16,22,0,93
2017-10-18,10,MIN,25,24,28,22,0,99,SAS,32,21,34,20,0,107
2017-10-20,2,UTA,16,26,23,32,0,97,MIN,19,27,24,30,0,100
2017-10-22,2,MIN,28,33,27,27,0,115,OKC,23,31,21,38,0,113
2017-10-24,2,IND,33,28,37,32,0,130,MIN,20,41,23,23,0,107
2017-10-25,1,MIN,26,18,29,28,0,101,DET,23,40,28,31,0,122
2017-10-27,2,OKC,33,26,30,27,0,116,MIN,26,33,31,29,0,119
2017-10-30,3,MIN,23,37,19,31,15,125,MIA,32,30,20,28,12,122
2017-11-01,2,MIN,31,34,18,21,0,104,NOP,28,26,23,21,0,98
2017-11-04,3,DAL,18,31,20,30,0,99,MIN,27,32,34,19,0,112
2017-11-05,1,CHO,28,23,28,15,0,94,MIN,28,40,29,15,0,112
2017-11-08,3,MIN,22,28,26,25,0,101,GSW,22,29,44,30,0,125
2017-11-11,3,MIN,28,32,28,22,0,110,PHO,19,37,29,33,0,118
2017-11-13,2,MIN,33,24,31,21,0,109,UTA,14,28,23,33,0,98
2017-11-15,2,SAS,24,19,22,21,0,86,MIN,18,39,18,23,0,98
2017-11-17,2,MIN,24,19,31,37,0,111,DAL,29,26,17,15,0,87
2017-11-19,2,DET,22,27,22,29,0,100,MIN,24,29,27,17,0,97
2017-11-20,1,MIN,24,28,28,22,0,102,CHO,26,29,29,34,0,118
2017-11-22,2,ORL,35,27,18,38,0,118,MIN,30,35,41,18,0,124
2017-11-24,2,MIA,28,30,23,28,0,109,MIN,24,24,22,27,0,97
2017-11-26,2,PHO,27,31,22,28,0,108,MIN,33,30,30,26,0,119
2017-11-28,2,WAS,23,20,25,24,0,92,MIN,30,21,20,18,0,89
2017-11-29,1,MIN,28,34,31,27,0,120,NOP,29,20,27,26,0,102
2017-12-01,2,MIN,33,21,25,28,0,107,OKC,42,22,21,26,0,111
2017-12-03,2,LAC,27,28,21,30,0,106,MIN,31,29,18,34,0,112
2017-12-04,1,MIN,26,27,22,17,0,92,MEM,29,27,20,19,0,95
2017-12-06,2,MIN,29,33,26,25,0,113,LAC,22,27,31,27,0,107
2017-12-10,4,DAL,24,24,21,23,0,92,MIN,23,24,24,26,0,97
2017-12-12,2,PHI,20,28,26,26,18,118,MIN,27,24,25,24,12,112
2017-12-14,2,SAC,22,33,16,25,0,96,MIN,32,32,31,24,0,119
2017-12-16,2,PHO,22,20,35,31,0,108,MIN,25,25,31,25,0,106
2017-12-18,2,POR,24,30,31,22,0,107,MIN,24,27,25,32,0,108
2017-12-20,2,MIN,17,33,30,32,0,112,DEN,24,28,32,20,0,104
2017-12-23,3,MIN,33,31,22,29,0,115,PHO,24,19,37,26,0,106
2017-12-25,2,MIN,29,24,30,38,0,121,LAL,20,32,28,24,0,104
2017-12-27,2,DEN,23,35,24,32,11,125,MIN,35,36,17,26,14,128
2017-12-28,1,MIN,26,30,28,12,0,96,MIL,16,30,29,27,0,102
2017-12-31,3,MIN,23,26,38,20,0,107,IND,13,25,20,32,0,90
2018-01-01,1,LAL,18,30,28,20,0,96,MIN,30,30,31,23,0,114
2018-01-03,2,MIN,22,21,30,24,0,97,BRK,24,24,23,27,0,98
2018-01-05,2,MIN,19,19,24,22,0,84,BOS,19,22,25,25,0,91
2018-01-06,1,NOP,24,24,23,27,0,98,MIN,36,33,29,18,0,116
2018-01-08,2,CLE,18,24,25,32,0,99,MIN,32,37,33,25,0,127
2018-01-10,2,OKC,23,24,18,23,0,88,MIN,23,24,29,28,0,104
2018-01-12,2,NYK,27,30,29,22,0,108,MIN,24,31,32,31,0,118
2018-01-14,2,POR,33,10,31,29,0,103,MIN,31,26,34,29,0,120
2018-01-16,2,MIN,25,23,27,27,0,102,ORL,25,22,26,35,0,108
2018-01-18,2,MIN,17,33,20,28,0,98,HOU,26,37,26,27,0,116
2018-01-20,2,TOR,28,34,21,26,0,109,MIN,26,28,33,28,0,115
2018-01-22,2,MIN,30,31,31,34,0,126,LAC,26,31,33,28,0,118
2018-01-24,2,MIN,29,25,30,30,0,114,POR,25,29,43,26,0,123
2018-01-25,1,MIN,29,33,31,20,0,113,GSW,38,36,32,20,0,126
2018-01-27,2,BRK,11,31,23,32,0,97,MIN,30,24,24,33,0,111
2018-01-29,2,MIN,32,26,21,21,0,100,ATL,27,28,21,29,0,105
2018-01-30,1,MIN,27,30,23,24,0,104,TOR,19,32,27,31,0,109
2018-02-01,2,MIL,17,22,22,28,0,89,MIN,23,37,19,29,0,108
2018-02-03,2,NOP,29,24,28,26,0,107,MIN,37,29,29,23,0,118
2018-02-07,4,MIN,29,37,33,30,9,138,CLE,31,33,37,28,11,140
2018-02-09,2,MIN,27,40,19,27,0,113,CHI,30,26,33,25,0,114
2018-02-11,2,SAC,29,25,26,26,0,106,MIN,23,33,19,36,0,111
2018-02-13,2,HOU,23,31,30,42,0,126,MIN,31,19,30,28,0,108
2018-02-15,2,LAL,39,26,26,20,0,111,MIN,35,27,22,35,0,119
2018-02-23,8,MIN,32,22,21,27,0,102,HOU,26,29,33,32,0,120
2018-02-24,1,CHI,24,38,20,22,0,104,MIN,31,29,26,36,0,122
2018-02-26,2,MIN,29,34,34,21,0,118,SAC,29,31,17,23,0,100
2018-03-01,3,MIN,24,25,29,21,0,99,POR,19,25,31,33,0,108
2018-03-02,1,MIN,24,21,32,31,0,108,UTA,23,33,29,31,0,116
2018-03-08,6,BOS,35,25,26,31,0,117,MIN,28,18,28,35,0,109
2018-03-11,3,GSW,24,38,22,19,0,103,MIN,34,21,29,25,0,109
2018-03-13,2,MIN,25,28,29,34,0,116,WAS,26,33,31,21,0,111
2018-03-17,4,MIN,24,26,31,20,0,101,SAS,23,38,29,27,0,117
2018-03-18,1,HOU,38,39,30,22,0,129,MIN,23,33,35,29,0,120
2018-03-20,2,LAC,32,26,25,26,0,109,MIN,28,31,36,28,0,123
2018-03-23,3,MIN,31,26,27,24,0,108,NYK,22,26,34,22,0,104
2018-03-24,1,MIN,24,28,19,37,0,108,PHI,32,27,39,22,0,120
2018-03-26,2,MEM,26,33,19,23,0,101,MIN,25,34,23,11,0,93
2018-03-28,2,ATL,32,25,31,26,0,114,MIN,34,31,33,28,0,126
2018-03-30,2,MIN,16,28,23,26,0,93,DAL,20,26,18,28,0,92
2018-04-01,2,UTA,28,33,26,34,0,121,MIN,26,24,21,26,0,97
2018-04-05,4,MIN,24,30,18,24,0,96,DEN,27,24,28,21,0,100
2018-04-06,1,MIN,30,21,29,33,0,113,LAL,26,32,15,23,0,96
2018-04-09,3,MEM,26,27,22,19,0,94,MIN,20,36,27,30,0,113
2018-04-11,2,DEN,26,28,27,20,5,106,MIN,29,33,24,15,11,112
2017-10-18,10,ATL,27,31,24,35,0,117,DAL,24,23,35,29,0,111
2017-10-20,2,SAC,19,27,25,22,0,93,DAL,23,23,14,28,0,88
2017-10-21,1,DAL,20,19,19,33,0,91,HOU,33,29,30,15,0,107
2017-10-23,2,GSW,40,25,34,34,0,133,DAL,24,38,22,19,0,103
2017-10-25,2,MEM,18,31,23,22,0,94,DAL,32,25,22,24,0,103
2017-10-26,1,DAL,14,21,33,23,0,91,MEM,28,26,22,20,0,96
2017-10-28,2,PHI,32,25,32,23,0,112,DAL,23,33,22,32,0,110
2017-10-30,2,DAL,27,26,15,21,0,89,UTA,21,23,32,28,0,104
2017-11-01,2,DAL,29,19,29,21,0,98,LAC,32,34,29,24,0,119
2017-11-03,2,NOP,28,27,20,24,0,99,DAL,25,21,17,31,0,94
2017-11-04,1,DAL,18,31,20,30,0,99,MIN,27,32,34,19,0,112
2017-11-07,3,DAL,36,28,26,23,0,113,WAS,34,19,23,23,0,99
2017-11-11,4,CLE,29,20,34,28,0,111,DAL,23,29,22,30,0,104
2017-11-12,1,DAL,20,22,25,32,0,99,OKC,18,26,39,29,0,112
2017-11-14,2,SAS,17,27,18,35,0,97,DAL,16,23,21,31,0,91
2017-11-17,3,MIN,24,19,31,37,0,111,DAL,29,26,17,15,0,87
2017-11-18,1,MIL,24,20,17,18,0,79,DAL,33,23,26,29,0,111
2017-11-20,2,BOS,34,19,16,27,14,110,DAL,22,27,28,19,6,102
2017-11-22,2,DAL,12,27,35,21,0,95,MEM,27,29,16,22,0,94
2017-11-25,3,OKC,24,13,18,26,0,81,DAL,25,27,26,19,0,97
2017-11-27,2,DAL,23,30,22,33,0,108,SAS,21,25,31,38,0,115
2017-11-29,2,BRK,21,27,32,29,0,109,DAL,27,20,29,28,0,104
2017-12-02,3,LAC,17,21,28,16,0,82,DAL,24,35,27,22,0,108
2017-12-04,2,DEN,23,24,35,23,0,105,DAL,39,25,29,29,0,122
2017-12-06,2,DAL,26,31,16,17,0,90,BOS,24,23,23,27,0,97
2017-12-08,2,DAL,25,29,24,24,0,102,MIL,22,27,28,32,0,109
2017-12-10,2,DAL,24,24,21,23,0,92,MIN,23,24,24,26,0,97
2017-12-12,2,SAS,23,21,25,20,0,89,DAL,30,16,21,28,0,95
2017-12-14,2,DAL,28,20,25,24,0,97,GSW,24,24,32,32,0,112
2017-12-16,2,DAL,31,22,27,16,0,96,SAS,18,25,28,27,0,98
2017-12-18,2,PHO,25,24,19,29,0,97,DAL,22,28,25,16,0,91
2017-12-20,2,DET,25,28,13,27,0,93,DAL,22,43,24,21,0,110
2017-12-22,2,DAL,23,30,20,28,0,101,MIA,32,21,29,31,0,113
2017-12-23,1,DAL,25,28,27,27,0,107,ATL,25,23,31,33,0,112
2017-12-26,3,TOR,23,30,24,16,0,93,DAL,31,26,28,13,0,98
2017-12-27,1,DAL,22,31,18,27,0,98,IND,29,25,20,20,0,94
2017-12-29,2,DAL,36,41,32,19,0,128,NOP,21,39,41,19,0,120
2017-12-31,2,DAL,35,22,27,32,0,116,OKC,32,31,22,28,0,113
2018-01-03,3,GSW,35,32,24,34,0,125,DAL,26,35,28,33,0,122
2018-01-05,2,CHI,34,23,23,47,0,127,DAL,28,25,35,36,0,124
2018-01-07,2,NYK,33,23,19,25,0,100,DAL,25,27,19,25,0,96
2018-01-09,2,ORL,19,29,27,24,0,99,DAL,25,18,39,32,0,114
2018-01-10,1,DAL,20,39,24,32,0,115,CHO,28,24,25,34,0,111
2018-01-13,3,LAL,31,15,24,25,12,107,DAL,20,32,21,22,6,101
2018-01-16,3,DAL,27,21,21,33,0,102,DEN,30,31,25,19,0,105
2018-01-20,4,DAL,20,25,34,29,0,108,POR,33,29,29,26,0,117
2018-01-22,2,WAS,22,15,17,21,0,75,DAL,22,31,18,27,0,98
2018-01-24,2,HOU,38,13,34,19,0,104,DAL,28,17,22,30,0,97
2018-01-26,2,POR,17,35,23,32,0,107,DAL,25,19,24,25,0,93
2018-01-27,1,DAL,26,16,32,15,0,89,DEN,30,20,16,25,0,91
2018-01-29,2,MIA,22,29,24,20,0,95,DAL,26,20,15,27,0,88
2018-01-31,2,DAL,17,29,15,27,0,88,PHO,36,21,24,21,0,102
2018-02-03,3,DAL,27,29,25,25,0,106,SAC,28,26,31,14,0,99
2018-02-05,2,DAL,28,27,27,19,0,101,LAC,32,26,20,26,0,104
2018-02-08,3,DAL,33,27,25,18,0,103,GSW,23,37,33,28,0,121
2018-02-10,2,LAL,36,30,29,28,0,123,DAL,34,31,35,30,0,130
2018-02-11,1,DAL,19,36,20,22,0,97,HOU,27,30,30,17,0,104
2018-02-13,2,SAC,29,36,23,26,0,114,DAL,16,28,27,38,0,109
2018-02-23,10,DAL,17,24,35,26,0,102,LAL,32,31,32,29,0,124
2018-02-24,1,DAL,23,27,21,19,0,90,UTA,35,18,21,23,0,97
2018-02-26,2,IND,23,20,22,38,0,103,DAL,23,26,19,41,0,109
2018-02-28,2,OKC,32,22,23,23,11,111,DAL,21,22,33,24,10,110
2018-03-02,2,DAL,32,17,36,15,0,100,CHI,24,23,31,30,0,108
2018-03-04,2,NOP,33,32,26,35,0,126,DAL,25,24,29,31,0,109
2018-03-06,2,DEN,25,37,23,22,0,107,DAL,29,29,38,22,0,118
2018-03-10,4,MEM,13,17,33,17,0,80,DAL,31,25,28,30,0,114
2018-03-11,1,HOU,25,23,32,25,0,105,DAL,14,33,16,19,0,82
2018-03-13,2,DAL,29,28,26,27,0,110,NYK,31,29,12,25,0,97
2018-03-16,3,DAL,27,33,24,22,9,115,TOR,29,25,24,28,16,122
2018-03-17,1,DAL,24,32,33,17,0,106,BRK,30,29,29,26,0,114
2018-03-20,3,DAL,30,22,28,25,0,105,NOP,29,25,26,35,0,115
2018-03-22,2,UTA,37,28,31,23,0,119,DAL,34,24,23,31,0,112
2018-03-24,2,CHO,22,32,25,23,0,102,DAL,27,21,22,28,0,98
2018-03-27,3,DAL,25,28,22,28,0,103,SAC,20,25,25,27,0,97
2018-03-28,1,DAL,34,22,25,12,0,93,LAL,32,23,27,21,0,103
2018-03-30,2,MIN,16,28,23,26,0,93,DAL,20,26,18,28,0,92
2018-04-01,2,DAL,25,22,30,10,0,87,CLE,18,30,25,25,0,98
2018-04-03,2,POR,22,27,29,31,0,109,DAL,22,28,32,33,0,115
2018-04-04,1,DAL,22,29,23,26,0,100,ORL,33,23,21,28,0,105
2018-04-06,2,DAL,24,30,21,26,5,106,DET,22,31,25,23,12,113
2018-04-08,2,DAL,20,28,28,21,0,97,PHI,28,33,24,24,0,109
2018-04-10,2,PHO,29,15,39,41,0,124,DAL,26,28,22,21,0,97
2017-10-18,10,MIL,24,34,18,32,0,108,BOS,26,27,27,20,0,100
2017-10-20,2,CLE,25,30,31,30,0,116,MIL,25,24,24,24,0,97
2017-10-21,1,POR,26,29,25,30,0,110,MIL,24,36,24,29,0,113
2017-10-23,2,CHO,25,29,23,17,0,94,MIL,18,35,30,20,0,103
2017-10-26,3,BOS,28,15,29,24,0,96,MIL,23,21,25,20,0,89
2017-10-29,3,MIL,28,33,31,25,0,117,ATL,16,32,25,33,0,106
2017-10-31,2,OKC,31,29,25,25,0,110,MIL,23,19,22,27,0,91
2017-11-01,1,MIL,32,25,31,33,0,121,CHO,25,35,28,38,0,126
2017-11-03,2,MIL,26,22,24,24,0,96,DET,28,31,23,23,0,105
2017-11-07,4,MIL,28,39,23,29,0,119,CLE,39,26,29,30,0,124
2017-11-10,3,MIL,25,21,30,18,0,94,SAS,27,20,23,17,0,87
2017-11-11,1,LAL,17,32,18,23,0,90,MIL,24,27,26,21,0,98
2017-11-13,2,MEM,29,36,12,26,0,103,MIL,34,26,24,26,0,110
2017-11-15,2,DET,23,18,21,33,0,95,MIL,26,15,34,24,0,99
2017-11-18,3,MIL,24,20,17,18,0,79,DAL,33,23,26,29,0,111
2017-11-20,2,WAS,27,20,26,26,0,99,MIL,19,27,20,22,0,88
2017-11-22,2,MIL,33,21,30,21,8,113,PHO,23,21,31,30,2,107
2017-11-25,3,MIL,30,27,28,23,0,108,UTA,31,33,31,26,0,121
2017-11-28,3,MIL,32,29,31,20,0,112,SAC,26,11,22,28,0,87
2017-11-30,2,MIL,33,27,27,16,0,103,POR,21,24,21,25,0,91
2017-12-02,2,SAC,25,27,24,28,0,104,MIL,33,30,25,21,0,109
2017-12-04,2,MIL,26,23,32,19,0,100,BOS,34,28,26,23,0,111
2017-12-06,2,DET,27,24,25,24,0,100,MIL,30,30,16,28,0,104
2017-12-08,2,DAL,25,29,24,24,0,102,MIL,22,27,28,32,0,109
2017-12-09,1,UTA,19,23,24,34,0,100,MIL,29,22,32,34,0,117
2017-12-13,4,MIL,37,26,22,23,0,108,NOP,32,30,25,28,0,115
2017-12-15,2,CHI,33,26,23,33,0,115,MIL,30,28,24,27,0,109
2017-12-16,1,MIL,25,30,24,32,0,111,HOU,28,27,29,31,0,115
2017-12-19,3,CLE,34,24,25,33,0,116,MIL,30,39,29,21,0,119
2017-12-22,3,CHO,23,36,26,19,0,104,MIL,26,26,31,26,0,109
2017-12-23,1,MIL,23,31,31,21,0,106,CHO,24,29,28,30,0,111
2017-12-26,3,CHI,22,34,27,32,0,115,MIL,31,22,30,23,0,106
2017-12-28,2,MIN,26,30,28,12,0,96,MIL,16,30,29,27,0,102
2017-12-29,1,MIL,38,20,15,24,0,97,OKC,18,26,23,28,0,95
2018-01-01,3,MIL,30,26,28,30,13,127,TOR,35,25,28,26,17,131
2018-01-03,2,IND,26,26,24,25,0,101,MIL,34,28,31,29,0,122
2018-01-05,2,TOR,33,28,43,25,0,129,MIL,24,35,19,32,0,110
2018-01-06,1,MIL,24,29,29,28,0,110,WAS,32,21,32,18,0,103
2018-01-08,2,MIL,16,22,27,31,0,96,IND,37,27,24,21,0,109
2018-01-10,2,ORL,29,17,23,34,0,103,MIL,30,23,36,21,0,110
2018-01-12,2,GSW,36,27,17,28,0,108,MIL,27,22,33,12,0,94
2018-01-14,2,MIL,23,20,16,20,0,79,MIA,21,20,30,26,0,97
2018-01-15,1,MIL,28,25,25,26,0,104,WAS,30,21,21,23,0,95
2018-01-17,2,MIA,30,22,26,28,0,106,MIL,25,32,22,22,0,101
2018-01-20,3,MIL,29,26,25,14,0,94,PHI,37,24,23,32,0,116
2018-01-22,2,PHO,26,27,26,26,0,105,MIL,30,23,23,33,0,109
2018-01-26,4,BRK,15,20,37,19,0,91,MIL,33,25,23,35,0,116
2018-01-28,2,MIL,26,35,25,24,0,110,CHI,20,22,30,24,0,96
2018-01-29,1,PHI,30,23,22,20,0,95,MIL,28,27,28,24,0,107
2018-02-01,3,MIL,17,22,22,28,0,89,MIN,23,37,19,29,0,108
2018-02-02,1,NYK,29,26,19,16,0,90,MIL,28,27,19,18,0,92
2018-02-04,2,MIL,36,26,21,26,0,109,BRK,22,19,31,22,0,94
2018-02-06,2,MIL,25,25,26,27,0,103,NYK,26,20,17,26,0,89
2018-02-09,3,MIL,23,23,8,31,0,85,MIA,19,23,30,19,0,91
2018-02-10,1,MIL,24,26,28,33,0,111,ORL,29,25,20,30,0,104
2018-02-13,3,ATL,24,19,18,31,0,92,MIL,21,20,33,23,0,97
2018-02-15,2,DEN,35,39,33,27,0,134,MIL,28,34,26,35,0,123
2018-02-23,8,MIL,23,42,31,14,12,122,TOR,29,28,31,22,9,119
2018-02-25,2,NOP,21,28,38,27,9,123,MIL,32,34,19,29,7,121
2018-02-27,2,WAS,40,24,20,23,0,107,MIL,22,28,31,23,0,104
2018-02-28,1,MIL,32,12,26,17,0,87,DET,32,21,32,25,0,110
2018-03-02,2,IND,18,27,33,25,0,103,MIL,21,25,21,29,0,96
2018-03-04,2,PHI,43,29,14,24,0,110,MIL,31,29,33,25,0,118
2018-03-05,1,MIL,17,29,23,20,0,89,IND,20,24,29,19,0,92
2018-03-07,2,HOU,24,34,29,23,0,110,MIL,22,24,30,23,0,99
2018-03-09,2,NYK,22,33,34,23,0,112,MIL,26,34,31,29,0,120
2018-03-12,3,MIL,32,32,26,31,0,121,MEM,24,26,23,30,0,103
2018-03-14,2,MIL,20,32,28,37,0,117,ORL,36,25,30,35,0,126
2018-03-17,3,ATL,31,19,37,30,0,117,MIL,26,30,39,27,0,122
2018-03-19,2,MIL,25,32,28,32,0,117,CLE,26,38,29,31,0,124
2018-03-21,2,LAC,38,26,33,30,0,127,MIL,24,33,26,37,0,120
2018-03-23,2,MIL,24,37,29,28,0,118,CHI,34,27,21,23,0,105
2018-03-25,2,SAS,15,32,28,28,0,103,MIL,27,20,41,18,0,106
2018-03-27,2,MIL,29,27,26,16,0,98,LAC,35,27,16,27,0,105
2018-03-29,2,MIL,29,29,34,24,0,116,GSW,27,22,23,35,0,107
2018-03-30,1,MIL,39,29,29,15,12,124,LAL,34,23,26,29,10,122
2018-04-01,2,MIL,34,20,38,19,14,125,DEN,22,41,16,32,17,128
2018-04-03,2,BOS,31,25,15,31,0,102,MIL,26,32,21,27,0,106
2018-04-05,2,BRK,30,22,31,36,0,119,MIL,24,21,36,30,0,111
2018-04-07,2,MIL,31,22,27,35,0,115,NYK,28,27,22,25,0,102
2018-04-09,2,ORL,21,21,25,19,0,86,MIL,31,14,29,28,0,102
2018-04-11,2,MIL,18,26,31,20,0,95,PHI,46,34,25,25,0,130
2017-10-18,10,PHI,23,36,23,33,0,115,WAS,32,24,34,30,0,120
2017-10-20,2,BOS,24,22,23,33,0,102,PHI,21,29,22,20,0,92
2017-10-21,1,PHI,19,30,22,23,0,94,TOR,36,26,40,26,0,128
2017-10-23,2,PHI,31,25,19,22,0,97,DET,22,21,24,19,0,86
2017-10-25,2,HOU,31,25,23,26,0,105,PHI,33,21,26,24,0,104
2017-10-28,3,PHI,32,25,32,23,0,112,DAL,23,33,22,32,0,110
2017-10-30,2,PHI,37,21,34,23,0,115,HOU,27,29,24,27,0,107
2017-11-01,2,ATL,25,32,36,16,0,109,PHI,34,25,34,26,0,119
2017-11-03,2,IND,28,35,26,21,0,110,PHI,30,26,36,29,0,121
2017-11-07,4,PHI,32,14,34,24,0,104,UTA,21,23,27,26,0,97
2017-11-09,2,PHI,26,31,24,27,0,108,SAC,26,38,20,25,0,109
2017-11-11,2,PHI,28,36,21,29,0,114,GSW,32,33,36,34,0,135
2017-11-13,2,PHI,36,19,22,32,0,109,LAC,28,25,26,26,0,105
2017-11-15,2,PHI,29,29,25,32,0,115,LAL,26,28,30,25,0,109
2017-11-18,3,GSW,28,24,47,25,0,124,PHI,47,27,15,27,0,116
2017-11-20,2,UTA,15,21,27,23,0,86,PHI,25,22,28,32,0,107
2017-11-22,2,POR,14,23,20,24,0,81,PHI,26,24,20,31,0,101
2017-11-25,3,ORL,28,27,30,26,0,111,PHI,31,39,31,29,0,130
2017-11-27,2,CLE,29,24,33,27,0,113,PHI,22,23,28,18,0,91
2017-11-29,2,WAS,18,22,25,48,0,113,PHI,28,30,26,34,0,118
2017-11-30,1,PHI,22,22,27,26,0,97,BOS,28,26,22,32,0,108
2017-12-02,2,DET,25,22,33,23,0,103,PHI,32,31,17,28,0,108
2017-12-04,2,PHO,28,32,29,26,0,115,PHI,28,19,32,22,0,101
2017-12-07,3,LAL,32,25,22,28,0,107,PHI,25,24,21,34,0,104
2017-12-09,2,PHI,24,22,27,25,0,98,CLE,23,29,26,27,0,105
2017-12-10,1,PHI,26,29,40,29,0,124,NOP,32,34,21,44,0,131
2017-12-12,2,PHI,20,28,26,26,18,118,MIN,27,24,25,24,12,112
2017-12-15,3,OKC,28,27,26,13,8,119,PHI,23,24,30,17,8,117
2017-12-18,3,PHI,25,34,28,28,0,115,CHI,30,37,22,28,0,117
2017-12-19,1,SAC,30,18,23,30,0,101,PHI,27,30,21,17,0,95
2017-12-21,2,TOR,30,22,34,28,0,114,PHI,31,34,23,21,0,109
2017-12-23,2,PHI,27,19,17,23,0,86,TOR,27,28,26,21,0,102
2017-12-25,2,PHI,21,29,29,26,0,105,NYK,24,24,27,23,0,98
2017-12-28,3,PHI,30,21,34,25,0,110,POR,27,25,20,42,0,114
2017-12-30,2,PHI,31,27,25,24,0,107,DEN,29,32,19,22,0,102
2017-12-31,1,PHI,38,25,29,31,0,123,PHO,32,17,40,21,0,110
2018-01-03,3,SAS,22,27,35,22,0,106,PHI,27,33,28,24,0,112
2018-01-05,2,DET,15,17,29,17,0,78,PHI,32,30,35,17,0,114
2018-01-11,6,BOS,23,25,37,29,0,114,PHI,28,29,22,24,0,103
2018-01-15,4,TOR,23,26,26,36,0,111,PHI,32,27,34,24,0,117
2018-01-18,3,PHI,21,18,32,18,0,89,BOS,19,13,21,27,0,80
2018-01-20,2,MIL,29,26,25,14,0,94,PHI,37,24,23,32,0,116
2018-01-22,2,PHI,30,25,28,18,0,101,MEM,19,30,25,31,0,105
2018-01-24,2,CHI,16,25,26,34,0,101,PHI,25,30,30,30,0,115
2018-01-26,2,PHI,25,25,31,16,0,97,SAS,13,18,30,17,0,78
2018-01-28,2,PHI,29,29,25,29,0,112,OKC,31,26,35,30,0,122
2018-01-29,1,PHI,30,23,22,20,0,95,MIL,28,27,28,24,0,107
2018-01-31,2,PHI,34,31,23,20,0,108,BRK,30,34,27,25,0,116
2018-02-02,2,MIA,23,18,19,37,0,97,PHI,24,27,35,17,0,103
2018-02-03,1,PHI,27,30,18,17,0,92,IND,33,29,14,24,0,100
2018-02-06,3,WAS,20,35,29,18,0,102,PHI,37,28,29,21,0,115
2018-02-09,3,NOP,14,27,11,30,0,82,PHI,32,24,28,16,0,100
2018-02-10,1,LAC,28,27,23,20,0,98,PHI,37,32,16,27,0,112
2018-02-12,2,NYK,21,34,24,13,0,92,PHI,31,26,29,22,0,108
2018-02-14,2,MIA,29,33,19,21,0,102,PHI,20,19,34,31,0,104
2018-02-22,8,PHI,33,34,26,23,0,116,CHI,29,40,22,24,0,115
2018-02-24,2,ORL,18,22,31,34,0,105,PHI,27,31,29,29,0,116
2018-02-25,1,PHI,28,20,25,21,0,94,WAS,30,37,20,22,0,109
2018-02-27,2,PHI,24,24,27,26,0,101,MIA,17,28,28,29,0,102
2018-03-01,2,PHI,32,27,18,31,0,108,CLE,29,27,15,26,0,97
2018-03-02,1,CHO,30,26,24,19,0,99,PHI,27,21,26,36,0,110
2018-03-04,2,PHI,43,29,14,24,0,110,MIL,31,29,33,25,0,118
2018-03-06,2,PHI,32,39,30,27,0,128,CHO,29,30,32,23,0,114
2018-03-08,2,PHI,28,21,25,25,0,99,MIA,29,24,20,35,0,108
2018-03-11,3,PHI,37,33,26,24,0,120,BRK,25,35,23,14,0,97
2018-03-13,2,IND,33,24,26,18,0,101,PHI,23,30,26,19,0,98
2018-03-15,2,PHI,32,28,23,35,0,118,NYK,32,36,23,19,0,110
2018-03-16,1,BRK,33,25,23,35,0,116,PHI,30,25,31,34,0,120
2018-03-19,3,CHO,18,38,14,24,0,94,PHI,21,28,32,27,0,108
2018-03-21,2,MEM,19,25,25,36,0,105,PHI,26,32,41,20,0,119
2018-03-22,1,PHI,32,38,25,23,0,118,ORL,23,26,16,33,0,98
2018-03-24,2,MIN,24,28,19,37,0,108,PHI,32,27,39,22,0,120
2018-03-26,2,DEN,27,32,15,30,0,104,PHI,23,28,34,38,0,123
2018-03-28,2,NYK,28,35,17,21,0,101,PHI,37,30,26,25,0,118
2018-03-30,2,PHI,30,17,39,15,0,101,ATL,27,14,18,32,0,91
2018-04-01,2,PHI,28,32,31,28,0,119,CHO,29,22,27,24,0,102
2018-04-03,2,BRK,22,27,22,24,0,95,PHI,28,33,32,28,0,121
2018-04-04,1,PHI,36,29,23,27,0,115,DET,28,21,22,37,0,108
2018-04-06,2,CLE,28,27,43,32,0,130,PHI,41,37,27,27,0,132
2018-04-08,2,DAL,20,28,28,21,0,97,PHI,28,33,24,24,0,109
2018-04-10,2,PHI,27,34,28,32,0,121,ATL,32,23,24,34,0,113
2018-04-11,1,MIL,18,26,31,20,0,95,PHI,46,34,25,25,0,130
2017-10-18,10,POR,29,31,38,26,0,124,PHO,21,14,20,21,0,76
2017-10-20,2,LAL,40,30,36,26,0,132,PHO,36,37,26,31,0,130
2017-10-21,1,PHO,18,26,20,24,0,88,LAC,23,35,32,40,0,130
2017-10-23,2,SAC,17,34,25,39,0,115,PHO,36,23,28,30,0,117
2017-10-25,2,UTA,13,28,18,29,0,88,PHO,23,25,23,26,0,97
2017-10-28,3,PHO,24,33,32,18,0,107,POR,29,32,31,22,0,114
2017-10-31,3,PHO,30,29,28,35,0,122,BRK,24,29,35,26,0,114
2017-11-01,1,PHO,15,37,35,35,0,122,WAS,32,32,26,26,0,116
2017-11-03,2,PHO,19,31,26,31,0,107,NYK,32,33,27,28,0,120
2017-11-05,2,PHO,20,35,13,27,0,95,SAS,28,23,34,27,0,112
2017-11-06,1,BRK,28,19,25,26,0,98,PHO,19,22,27,24,0,92
2017-11-08,2,MIA,36,33,25,32,0,126,PHO,27,27,32,29,0,115
2017-11-10,2,ORL,36,28,33,31,0,128,PHO,32,31,20,29,0,112
2017-11-11,1,MIN,28,32,28,22,0,110,PHO,19,37,29,33,0,118
2017-11-13,2,LAL,21,22,31,26,0,100,PHO,20,24,29,20,0,93
2017-11-16,3,HOU,45,45,30,22,0,142,PHO,23,42,26,25,0,116
2017-11-17,1,PHO,29,36,24,33,0,122,LAL,28,25,29,31,0,113
2017-11-19,2,CHI,37,19,28,21,0,105,PHO,30,31,24,28,0,113
2017-11-22,3,MIL,33,21,30,21,8,113,PHO,23,21,31,30,2,107
2017-11-24,2,NOP,33,39,22,21,0,115,PHO,21,21,20,29,0,91
2017-11-26,2,PHO,27,31,22,28,0,108,MIN,33,30,30,26,0,119
2017-11-28,2,PHO,28,18,27,31,0,104,CHI,29,14,27,29,0,99
2017-11-29,1,PHO,19,22,29,37,0,107,DET,36,33,35,27,0,131
2017-12-02,3,PHO,22,32,25,32,0,111,BOS,31,29,29,27,0,116
2017-12-04,2,PHO,28,32,29,26,0,115,PHI,28,19,32,22,0,101
2017-12-05,1,PHO,23,23,33,34,0,113,TOR,36,19,42,29,0,126
2017-12-07,2,WAS,26,31,28,24,0,109,PHO,28,24,32,15,0,99
2017-12-09,2,SAS,28,24,27,25,0,104,PHO,17,22,32,30,0,101
2017-12-12,3,PHO,23,28,23,18,0,92,SAC,21,28,25,25,0,99
2017-12-13,1,TOR,37,21,34,23,0,115,PHO,31,21,27,30,0,109
2017-12-16,3,PHO,22,20,35,31,0,108,MIN,25,25,31,25,0,106
2017-12-18,2,PHO,25,24,19,29,0,97,DAL,22,28,25,16,0,91
2017-12-20,2,PHO,15,20,31,29,0,95,LAC,23,30,28,27,0,108
2017-12-21,1,MEM,25,26,30,14,0,95,PHO,26,34,19,18,0,97
2017-12-23,2,MIN,33,31,22,29,0,115,PHO,24,19,37,26,0,106
2017-12-26,3,MEM,19,34,23,21,0,97,PHO,29,28,19,23,0,99
2017-12-29,3,PHO,35,20,33,23,0,111,SAC,25,21,37,18,0,101
2017-12-31,2,PHI,38,25,29,31,0,123,PHO,32,17,40,21,0,110
2018-01-02,2,ATL,27,21,32,23,0,103,PHO,19,30,24,31,0,104
2018-01-03,1,PHO,26,41,18,26,0,111,DEN,34,27,37,36,0,134
2018-01-05,2,PHO,26,16,30,17,0,89,SAS,26,23,31,23,0,103
2018-01-07,2,OKC,23,30,29,18,0,100,PHO,28,34,28,24,0,114
2018-01-12,5,HOU,27,30,33,22,0,112,PHO,23,21,24,27,0,95
2018-01-14,2,IND,30,34,32,24,0,120,PHO,16,28,22,31,0,97
2018-01-16,2,PHO,31,20,21,39,0,111,POR,36,30,26,26,0,118
2018-01-19,3,PHO,29,31,25,23,0,108,DEN,31,19,23,27,0,100
2018-01-22,3,PHO,26,27,26,26,0,105,MIL,30,23,23,33,0,109
2018-01-24,2,PHO,18,26,21,36,0,101,IND,32,31,36,17,0,116
2018-01-26,2,NYK,33,20,28,26,0,107,PHO,23,26,18,18,0,85
2018-01-28,2,PHO,24,29,24,25,0,102,HOU,28,32,32,21,0,113
2018-01-29,1,PHO,26,21,27,35,0,109,MEM,22,42,26,30,0,120
2018-01-31,2,DAL,17,29,15,27,0,88,PHO,36,21,24,21,0,102
2018-02-02,2,UTA,28,34,32,35,0,129,PHO,23,17,33,24,0,97
2018-02-04,2,CHO,25,23,38,29,0,115,PHO,31,28,35,16,0,110
2018-02-06,2,PHO,28,29,22,14,0,93,LAL,33,24,31,24,0,112
2018-02-07,1,SAS,28,41,28,32,0,129,PHO,9,22,19,31,0,81
2018-02-10,3,DEN,28,34,32,29,0,123,PHO,23,37,29,24,0,113
2018-02-12,2,PHO,24,21,26,12,0,83,GSW,25,37,37,30,0,129
2018-02-14,2,PHO,23,18,30,26,0,97,UTA,27,23,22,35,0,107
2018-02-23,9,LAC,40,39,16,33,0,128,PHO,18,32,28,39,0,117
2018-02-24,1,POR,28,27,16,35,0,106,PHO,24,26,31,23,0,104
2018-02-26,2,PHO,36,29,24,27,0,116,NOP,26,32,38,29,0,125
2018-02-28,2,PHO,21,36,25,28,0,110,MEM,27,27,18,30,0,102
2018-03-02,2,OKC,32,28,37,27,0,124,PHO,37,30,32,17,0,116
2018-03-04,2,PHO,23,33,31,25,0,112,ATL,29,27,30,27,0,113
2018-03-05,1,PHO,27,21,32,23,0,103,MIA,30,31,32,32,0,125
2018-03-08,3,PHO,23,15,29,20,0,87,OKC,26,23,39,27,0,115
2018-03-10,2,PHO,25,26,21,43,0,115,CHO,32,27,35,28,0,122
2018-03-13,3,CLE,38,30,34,27,0,129,PHO,18,34,28,27,0,107
2018-03-15,2,PHO,23,20,23,22,0,88,UTA,20,36,25,35,0,116
2018-03-17,2,GSW,30,22,42,30,0,124,PHO,34,26,25,24,0,109
2018-03-20,3,DET,19,25,36,35,0,115,PHO,19,19,26,24,0,88
2018-03-23,3,PHO,27,18,26,24,0,95,CLE,23,39,31,27,0,120
2018-03-24,1,PHO,23,23,28,25,0,99,ORL,26,12,39,28,0,105
2018-03-26,2,BOS,31,17,29,25,0,102,PHO,15,30,20,29,0,94
2018-03-28,2,LAC,27,31,27,26,0,111,PHO,32,24,26,17,0,99
2018-03-30,2,PHO,25,32,29,17,0,103,HOU,22,18,35,29,0,104
2018-04-01,2,PHO,24,35,18,30,0,107,GSW,22,36,36,23,0,117
2018-04-03,2,SAC,22,18,29,25,0,94,PHO,22,24,27,24,0,97
2018-04-06,3,NOP,39,24,23,36,0,122,PHO,21,25,24,33,0,103
2018-04-08,2,GSW,33,31,27,26,0,117,PHO,29,21,22,28,0,100
2018-04-10,2,PHO,29,15,39,41,0,124,DAL,26,28,22,21,0,97
2017-10-19,10,LAC,27,26,34,21,0,108,LAL,19,23,21,29,0,92
2017-10-20,1,LAL,40,30,36,26,0,132,PHO,36,37,26,31,0,130
2017-10-22,2,NOP,34,34,26,25,0,119,LAL,22,33,28,29,0,112
2017-10-25,3,WAS,18,31,30,13,7,99,LAL,23,22,24,23,10,102
2017-10-27,2,TOR,19,26,27,29,0,101,LAL,26,25,20,21,0,92
2017-10-28,1,LAL,16,29,19,17,0,81,UTA,31,25,19,21,0,96
2017-10-31,3,DET,22,23,27,21,0,93,LAL,25,33,29,26,0,113
2017-11-02,2,LAL,25,37,23,25,0,110,POR,41,25,21,26,0,113
2017-11-03,1,BRK,29,26,29,28,0,112,LAL,30,34,31,29,0,124
2017-11-05,2,MEM,24,30,16,32,0,102,LAL,27,35,26,19,0,107
2017-11-08,3,LAL,16,36,29,15,0,96,BOS,33,28,26,20,0,107
2017-11-09,1,LAL,34,22,21,18,0,95,WAS,37,32,22,20,0,111
2017-11-11,2,LAL,17,32,18,23,0,90,MIL,24,27,26,21,0,98
2017-11-13,2,LAL,21,22,31,26,0,100,PHO,20,24,29,20,0,93
2017-11-15,2,PHI,29,29,25,32,0,115,LAL,26,28,30,25,0,109
2017-11-17,2,PHO,29,36,24,33,0,122,LAL,28,25,29,31,0,113
2017-11-19,2,DEN,26,22,36,25,0,109,LAL,32,38,29,28,0,127
2017-11-21,2,CHI,27,29,19,19,0,94,LAL,23,19,30,31,0,103
2017-11-22,1,LAL,19,22,26,35,0,102,SAC,31,23,22,37,0,113
2017-11-27,5,LAL,32,30,27,26,0,115,LAC,34,26,27,33,0,120
2017-11-29,2,GSW,30,20,34,25,18,127,LAL,20,34,30,25,14,123
2017-12-02,3,LAL,29,30,21,20,0,100,DEN,34,21,23,37,0,115
2017-12-03,1,HOU,27,34,24,33,0,118,LAL,27,19,27,22,0,95
2017-12-07,4,LAL,32,25,22,28,0,107,PHI,25,24,21,34,0,104
2017-12-09,2,LAL,28,24,24,34,0,110,CHO,29,27,19,24,0,99
2017-12-12,3,LAL,29,22,28,20,10,109,NYK,25,25,26,23,14,113
2017-12-14,2,LAL,26,34,26,26,0,112,CLE,24,39,31,27,0,121
2017-12-18,4,GSW,32,25,26,19,14,116,LAL,24,29,29,20,12,114
2017-12-20,2,LAL,37,26,31,28,0,122,HOU,22,37,30,27,0,116
2017-12-22,2,LAL,24,20,28,34,0,106,GSW,27,34,23,29,0,113
2017-12-23,1,POR,17,27,26,25,0,95,LAL,24,25,21,22,0,92
2017-12-25,2,MIN,29,24,30,38,0,121,LAL,20,32,28,24,0,104
2017-12-27,2,MEM,24,30,22,33,0,109,LAL,18,29,29,23,0,99
2017-12-29,2,LAC,35,27,29,30,0,121,LAL,22,26,28,30,0,106
2017-12-31,2,LAL,37,35,29,21,11,142,HOU,44,21,25,32,11,148
2018-01-01,1,LAL,18,30,28,20,0,96,MIN,30,30,31,23,0,114
2018-01-03,2,OKC,26,37,33,37,0,133,LAL,26,18,26,26,0,96
2018-01-05,2,CHO,28,35,30,15,0,108,LAL,24,24,28,18,0,94
2018-01-07,2,ATL,27,21,32,33,0,113,LAL,29,37,30,36,0,132
2018-01-09,2,SAC,27,25,22,12,0,86,LAL,31,22,31,15,0,99
2018-01-11,2,SAS,15,23,24,19,0,81,LAL,20,29,19,25,0,93
2018-01-13,2,LAL,31,15,24,25,12,107,DAL,20,32,21,22,6,101
2018-01-15,2,LAL,27,23,27,37,0,114,MEM,34,26,37,26,0,123
2018-01-17,2,LAL,25,29,18,18,0,90,OKC,33,27,33,21,0,114
2018-01-19,2,IND,25,14,27,20,0,86,LAL,18,29,27,25,0,99
2018-01-21,2,NYK,29,34,26,18,0,107,LAL,30,37,30,30,0,127
2018-01-23,2,BOS,21,32,21,33,0,107,LAL,15,30,31,32,0,108
2018-01-26,3,LAL,32,30,22,24,0,108,CHI,25,32,15,31,0,103
2018-01-28,2,LAL,21,28,28,34,0,111,TOR,28,31,32,32,0,123
2018-01-31,3,LAL,25,26,30,24,0,105,ORL,29,29,43,26,0,127
2018-02-02,2,LAL,24,35,26,17,0,102,BRK,26,31,28,14,0,99
2018-02-04,2,LAL,25,26,31,26,0,108,OKC,22,27,30,25,0,104
2018-02-06,2,PHO,28,29,22,14,0,93,LAL,33,24,31,24,0,112
2018-02-08,2,OKC,27,19,20,15,0,81,LAL,30,22,31,23,0,106
2018-02-10,2,LAL,36,30,29,28,0,123,DAL,34,31,35,30,0,130
2018-02-14,4,LAL,33,33,25,26,0,117,NOP,46,33,24,36,0,139
2018-02-15,1,LAL,39,26,26,20,0,111,MIN,35,27,22,35,0,119
2018-02-23,8,DAL,17,24,35,26,0,102,LAL,32,31,32,29,0,124
2018-02-24,1,LAL,25,25,37,26,0,113,SAC,29,29,25,25,0,108
2018-02-26,2,LAL,28,36,32,27,0,123,ATL,22,24,29,29,0,104
2018-03-01,3,LAL,33,40,31,27,0,131,MIA,36,26,32,19,0,113
2018-03-03,2,LAL,23,30,27,36,0,116,SAS,30,30,31,21,0,112
2018-03-05,2,POR,27,31,15,35,0,108,LAL,24,31,25,23,0,103
2018-03-07,2,ORL,32,19,28,28,0,107,LAL,23,33,25,27,0,108
2018-03-09,2,LAL,28,34,34,20,0,116,DEN,37,28,29,31,0,125
2018-03-11,2,CLE,29,31,22,31,0,113,LAL,33,32,33,29,0,127
2018-03-13,2,DEN,22,25,35,21,0,103,LAL,35,13,29,35,0,112
2018-03-14,1,LAL,23,32,27,24,0,106,GSW,26,29,34,28,0,117
2018-03-16,2,MIA,25,25,24,18,0,92,LAL,24,26,21,20,0,91
2018-03-19,3,LAL,37,22,21,20,0,100,IND,29,28,35,18,0,110
2018-03-22,3,LAL,44,29,35,17,0,125,NOP,40,31,26,31,0,128
2018-03-24,2,LAL,17,35,19,29,0,100,MEM,28,29,14,22,0,93
2018-03-26,2,LAL,29,26,21,30,0,106,DET,26,27,28,31,0,112
2018-03-28,2,DAL,34,22,25,12,0,93,LAL,32,23,27,21,0,103
2018-03-30,2,MIL,39,29,29,15,12,124,LAL,34,23,26,29,10,122
2018-04-01,2,SAC,19,24,17,24,0,84,LAL,22,21,21,19,0,83
2018-04-03,2,LAL,31,29,29,21,0,110,UTA,24,41,30,22,0,117
2018-04-04,1,SAS,30,31,26,21,4,112,LAL,29,29,23,27,14,122
2018-04-06,2,MIN,30,21,29,33,0,113,LAL,26,32,15,23,0,96
2018-04-08,2,UTA,30,20,32,30,0,112,LAL,21,23,23,30,0,97
2018-04-10,2,HOU,23,33,26,23,0,105,LAL,16,32,27,24,0,99
2018-04-11,1,LAL,39,25,28,23,0,115,LAC,32,21,21,26,0,100
2017-10-18,10,DEN,30,28,25,13,0,96,UTA,21,28,29,28,0,106
2017-10-20,2,UTA,16,26,23,32,0,97,MIN,19,27,24,30,0,100
2017-10-21,1,OKC,14,20,23,30,0,87,UTA,21,23,29,23,0,96
2017-10-24,3,UTA,20,21,15,28,0,84,LAC,27,15,33,27,0,102
2017-10-25,1,UTA,13,28,18,29,0,88,PHO,23,25,23,26,0,97
2017-10-28,3,LAL,16,29,19,17,0,81,UTA,31,25,19,21,0,96
2017-10-30,2,DAL,27,26,15,21,0,89,UTA,21,23,32,28,0,104
2017-11-01,2,POR,20,19,30,25,9,103,UTA,22,17,25,30,18,112
2017-11-03,2,TOR,29,24,36,20,0,109,UTA,26,28,28,18,0,100
2017-11-05,2,UTA,28,21,36,25,0,110,HOU,39,28,48,22,0,137
2017-11-07,2,PHI,32,14,34,24,0,104,UTA,21,23,27,26,0,97
2017-11-10,3,MIA,25,12,20,27,0,84,UTA,22,27,8,17,0,74
2017-11-11,1,BRK,25,20,30,31,0,106,UTA,25,36,24,29,0,114
2017-11-13,2,MIN,33,24,31,21,0,109,UTA,14,28,23,33,0,98
2017-11-15,2,UTA,30,30,22,19,0,101,NYK,27,23,27,29,0,106
2017-11-17,2,UTA,25,24,31,27,0,107,BRK,39,26,24,29,0,118
2017-11-18,1,UTA,29,34,34,28,0,125,ORL,26,22,19,18,0,85
2017-11-20,2,UTA,15,21,27,23,0,86,PHI,25,22,28,32,0,107
2017-11-22,2,CHI,24,22,23,11,0,80,UTA,25,30,32,23,0,110
2017-11-25,3,MIL,30,27,28,23,0,108,UTA,31,33,31,26,0,121
2017-11-28,3,DEN,24,25,17,11,0,77,UTA,26,22,28,30,0,106
2017-11-30,2,UTA,26,35,33,32,0,126,LAC,27,34,26,20,0,107
2017-12-01,1,NOP,29,26,29,24,0,108,UTA,27,16,37,34,0,114
2017-12-04,3,WAS,15,15,22,17,0,69,UTA,29,35,24,28,0,116
2017-12-05,1,UTA,28,19,33,14,0,94,OKC,19,20,29,32,0,100
2017-12-07,2,HOU,25,26,37,24,0,112,UTA,20,26,20,35,0,101
2017-12-09,2,UTA,19,23,24,34,0,100,MIL,29,22,32,34,0,117
2017-12-13,4,UTA,24,24,26,26,0,100,CHI,30,19,28,26,0,103
2017-12-15,2,UTA,21,25,33,28,0,107,BOS,26,13,28,28,0,95
2017-12-16,1,UTA,24,24,25,27,0,100,CLE,23,28,29,29,0,109
2017-12-18,2,UTA,26,24,34,15,0,99,HOU,25,26,28,41,0,120
2017-12-20,2,UTA,9,28,23,19,0,79,OKC,25,28,34,20,0,107
2017-12-21,1,SAS,17,21,32,19,0,89,UTA,24,26,22,28,0,100
2017-12-23,2,OKC,28,19,29,27,0,103,UTA,22,21,21,25,0,89
2017-12-26,3,UTA,20,14,25,24,0,83,DEN,28,22,26,31,0,107
2017-12-27,1,UTA,24,23,22,32,0,101,GSW,23,25,42,36,0,126
2017-12-30,3,CLE,32,21,16,32,0,101,UTA,22,26,28,28,0,104
2018-01-03,4,NOP,27,31,23,27,0,108,UTA,28,27,17,26,0,98
2018-01-05,2,UTA,26,23,16,26,0,91,DEN,23,23,38,15,0,99
2018-01-07,2,UTA,22,25,28,27,0,102,MIA,27,22,25,29,0,103
2018-01-10,3,UTA,25,21,37,24,0,107,WAS,32,18,27,27,0,104
2018-01-12,2,UTA,25,21,26,16,0,88,CHO,25,27,22,25,0,99
2018-01-15,3,IND,31,27,27,24,0,109,UTA,21,26,18,29,0,94
2018-01-17,2,UTA,23,29,36,32,0,120,SAC,21,21,31,32,0,105
2018-01-19,2,NYK,22,27,36,32,0,117,UTA,25,30,23,37,0,115
2018-01-20,1,LAC,29,30,28,26,0,113,UTA,39,37,28,21,0,125
2018-01-22,2,UTA,20,21,22,27,0,90,ATL,19,23,32,30,0,104
2018-01-24,2,UTA,24,19,22,24,9,98,DET,24,25,15,25,6,95
2018-01-26,2,UTA,30,15,30,22,0,97,TOR,24,24,21,24,0,93
2018-01-30,4,GSW,30,26,29,14,0,99,UTA,35,34,34,26,0,129
2018-02-02,3,UTA,28,34,32,35,0,129,PHO,23,17,33,24,0,97
2018-02-03,1,UTA,33,28,26,33,0,120,SAS,24,25,29,33,0,111
2018-02-05,2,UTA,34,36,29,34,0,133,NOP,23,41,22,23,0,109
2018-02-07,2,UTA,21,23,24,24,0,92,MEM,16,23,24,25,0,88
2018-02-09,2,CHO,24,22,31,17,0,94,UTA,28,27,29,22,0,106
2018-02-11,2,UTA,19,24,38,34,0,115,POR,26,18,19,33,0,96
2018-02-12,1,SAS,22,26,29,22,0,99,UTA,25,29,15,32,0,101
2018-02-14,2,PHO,23,18,30,26,0,97,UTA,27,23,22,35,0,107
2018-02-23,9,POR,31,22,27,20,0,100,UTA,30,17,17,17,0,81
2018-02-24,1,DAL,23,27,21,19,0,90,UTA,35,18,21,23,0,97
2018-02-26,2,HOU,19,20,31,26,0,96,UTA,21,23,19,22,0,85
2018-03-02,4,MIN,24,21,32,31,0,108,UTA,23,33,29,31,0,116
2018-03-03,1,UTA,25,27,23,23,0,98,SAC,17,26,23,25,0,91
2018-03-05,2,ORL,29,15,23,13,0,80,UTA,25,29,20,20,0,94
2018-03-07,2,UTA,32,22,25,25,0,104,IND,20,24,25,15,0,84
2018-03-09,2,UTA,24,26,21,24,0,95,MEM,23,15,20,20,0,78
2018-03-11,2,UTA,29,19,30,38,0,116,NOP,23,28,23,25,0,99
2018-03-13,2,DET,21,18,20,20,0,79,UTA,42,22,22,24,0,110
2018-03-15,2,PHO,23,20,23,22,0,88,UTA,20,36,25,35,0,116
2018-03-17,2,SAC,27,27,25,18,0,97,UTA,32,18,30,23,0,103
2018-03-20,3,ATL,21,20,22,36,0,99,UTA,27,15,25,27,0,94
2018-03-22,2,UTA,37,28,31,23,0,119,DAL,34,24,23,31,0,112
2018-03-23,1,UTA,21,30,22,41,6,120,SAS,29,27,21,37,10,124
2018-03-25,2,UTA,18,35,36,21,0,110,GSW,22,25,18,26,0,91
2018-03-28,3,BOS,18,30,19,30,0,97,UTA,24,15,32,23,0,94
2018-03-30,2,MEM,14,33,29,21,0,97,UTA,29,23,28,27,0,107
2018-04-01,2,UTA,28,33,26,34,0,121,MIN,26,24,21,26,0,97
2018-04-03,2,LAL,31,29,29,21,0,110,UTA,24,41,30,22,0,117
2018-04-05,2,LAC,26,23,18,28,0,95,UTA,36,29,29,23,0,117
2018-04-08,3,UTA,30,20,32,30,0,112,LAL,21,23,23,30,0,97
2018-04-10,2,GSW,16,17,23,23,0,79,UTA,33,29,31,26,0,119
2018-04-11,1,UTA,21,20,18,34,0,93,POR,28,27,25,22,0,102
2017-10-18,10,HOU,26,26,23,30,0,105,SAC,25,23,24,28,0,100
2017-10-20,2,SAC,19,27,25,22,0,93,DAL,23,23,14,28,0,88
2017-10-21,1,SAC,18,16,18,27,0,79,DEN,17,25,24,30,0,96
2017-10-23,2,SAC,17,34,25,39,0,115,PHO,36,23,28,30,0,117
2017-10-26,3,NOP,27,29,32,26,0,114,SAC,40,30,17,19,0,106
2017-10-29,3,WAS,35,28,25,22,0,110,SAC,16,16,28,23,0,83
2017-10-31,2,SAC,13,17,18,35,0,83,IND,24,31,14,32,0,101
2017-11-01,1,SAC,24,21,15,26,0,86,BOS,27,31,31,24,0,113
2017-11-04,3,SAC,26,23,25,25,0,99,DET,29,23,33,23,0,108
2017-11-07,3,OKC,25,16,16,29,0,86,SAC,10,32,25,27,0,94
2017-11-09,2,PHI,26,31,24,27,0,108,SAC,26,38,20,25,0,109
2017-11-11,2,SAC,23,26,17,25,0,91,NYK,32,32,26,28,0,118
2017-11-13,2,SAC,32,19,20,21,0,92,WAS,25,32,29,24,0,110
2017-11-15,2,SAC,16,19,26,19,0,80,ATL,24,40,28,34,0,126
2017-11-17,2,POR,20,21,19,22,0,82,SAC,19,23,18,26,0,86
2017-11-18,1,SAC,20,21,22,27,0,90,POR,21,32,27,22,0,102
2017-11-20,2,DEN,22,25,34,33,0,114,SAC,22,25,23,28,0,98
2017-11-22,2,LAL,19,22,26,35,0,102,SAC,31,23,22,37,0,113
2017-11-25,3,LAC,25,22,29,21,0,97,SAC,31,30,10,24,0,95
2017-11-27,2,SAC,27,26,30,27,0,110,GSW,27,28,27,24,0,106
2017-11-28,1,MIL,32,29,31,20,0,112,SAC,26,11,22,28,0,87
2017-12-01,3,SAC,29,32,21,25,0,107,CHI,31,29,21,25,0,106
2017-12-02,1,SAC,25,27,24,28,0,104,MIL,33,30,25,21,0,109
2017-12-06,4,SAC,22,35,21,17,0,95,CLE,19,29,25,28,0,101
2017-12-08,2,SAC,24,23,30,25,14,116,NOP,25,28,29,20,7,109
2017-12-10,2,TOR,22,32,25,23,0,102,SAC,17,29,21,20,0,87
2017-12-12,2,PHO,23,28,23,18,0,92,SAC,21,28,25,25,0,99
2017-12-14,2,SAC,22,33,16,25,0,96,MIN,32,32,31,24,0,119
2017-12-17,3,SAC,30,33,14,16,0,93,TOR,35,26,22,25,0,108
2017-12-19,2,SAC,30,18,23,30,0,101,PHI,27,30,21,17,0,95
2017-12-20,1,SAC,36,28,22,18,0,104,BRK,20,28,27,24,0,99
2017-12-23,3,SAS,33,29,22,24,0,108,SAC,33,16,27,23,0,99
2017-12-26,3,SAC,30,23,20,22,0,95,LAC,30,41,24,27,0,122
2017-12-27,1,CLE,27,28,25,15,0,95,SAC,28,34,23,24,0,109
2017-12-29,2,PHO,35,20,33,23,0,111,SAC,25,21,37,18,0,101
2017-12-31,2,MEM,36,28,26,24,0,114,SAC,22,24,17,33,0,96
2018-01-02,2,CHO,32,40,28,31,0,131,SAC,25,27,29,30,0,111
2018-01-06,4,DEN,27,14,30,27,0,98,SAC,29,17,33,27,0,106
2018-01-08,2,SAS,21,25,27,34,0,107,SAC,25,31,20,24,0,100
2018-01-09,1,SAC,27,25,22,12,0,86,LAL,31,22,31,15,0,99
2018-01-11,2,LAC,29,43,28,21,0,121,SAC,21,39,29,26,0,115
2018-01-13,2,SAC,17,28,23,37,0,105,LAC,30,34,27,35,0,126
2018-01-15,2,SAC,24,28,16,20,0,88,OKC,20,26,31,18,0,95
2018-01-17,2,UTA,23,29,36,32,0,120,SAC,21,21,31,32,0,105
2018-01-19,2,SAC,17,23,19,29,0,88,MEM,30,10,27,39,0,106
2018-01-22,3,SAC,33,22,20,32,0,107,CHO,35,32,25,20,0,112
2018-01-23,1,SAC,28,24,25,28,0,105,ORL,27,26,29,17,0,99
2018-01-25,2,SAC,19,28,24,18,0,89,MIA,17,30,25,16,0,88
2018-01-28,3,SAC,22,28,19,29,0,98,SAS,29,20,30,34,0,113
2018-01-30,2,SAC,25,36,29,24,0,114,NOP,29,33,23,18,0,103
2018-02-02,3,GSW,29,29,26,35,0,119,SAC,27,25,23,29,0,104
2018-02-03,1,DAL,27,29,25,25,0,106,SAC,28,26,31,14,0,99
2018-02-05,2,CHI,28,27,24,19,0,98,SAC,9,32,36,27,0,104
2018-02-09,4,POR,33,29,30,26,0,118,SAC,31,21,22,26,0,100
2018-02-11,2,SAC,29,25,26,26,0,106,MIN,23,33,19,36,0,111
2018-02-13,2,SAC,29,36,23,26,0,114,DAL,16,28,27,38,0,109
2018-02-14,1,SAC,25,20,18,28,0,91,HOU,20,35,17,28,0,100
2018-02-22,8,OKC,44,23,18,25,0,110,SAC,21,39,30,17,0,107
2018-02-24,2,LAL,25,25,37,26,0,113,SAC,29,29,25,25,0,108
2018-02-26,2,MIN,29,34,34,21,0,118,SAC,29,31,17,23,0,100
2018-02-27,1,SAC,26,27,27,19,0,99,POR,36,30,22,28,0,116
2018-03-01,2,BRK,31,20,28,21,11,111,SAC,22,31,20,27,16,116
2018-03-03,2,UTA,25,27,23,23,0,98,SAC,17,26,23,25,0,91
2018-03-04,1,NYK,20,26,26,27,0,99,SAC,32,19,32,19,0,102
2018-03-07,3,NOP,32,30,23,29,0,114,SAC,21,23,23,34,0,101
2018-03-09,2,ORL,14,22,26,26,0,88,SAC,22,19,33,20,0,94
2018-03-11,2,SAC,25,24,19,36,0,104,DEN,32,34,35,29,0,130
2018-03-12,1,SAC,16,24,39,22,0,101,OKC,19,27,32,28,0,106
2018-03-14,2,MIA,31,21,27,32,8,119,SAC,24,35,32,20,12,123
2018-03-16,2,SAC,29,28,18,23,0,98,GSW,36,23,16,18,0,93
2018-03-17,1,SAC,27,27,25,18,0,97,UTA,32,18,30,23,0,103
2018-03-19,2,DET,25,19,29,33,0,106,SAC,21,23,22,24,0,90
2018-03-22,3,ATL,28,16,27,19,0,90,SAC,25,24,31,25,0,105
2018-03-25,3,BOS,24,28,28,24,0,104,SAC,27,33,18,15,0,93
2018-03-27,2,DAL,25,28,22,28,0,103,SAC,20,25,25,27,0,97
2018-03-29,2,IND,28,33,18,27,0,106,SAC,28,28,23,24,0,103
2018-03-31,2,GSW,28,29,36,19,0,112,SAC,25,24,20,27,0,96
2018-04-01,1,SAC,19,24,17,24,0,84,LAL,22,21,21,19,0,83
2018-04-03,2,SAC,22,18,29,25,0,94,PHO,22,24,27,24,0,97
2018-04-06,3,SAC,25,19,24,26,0,94,MEM,22,26,15,30,0,93
2018-04-09,3,SAC,25,25,16,19,0,85,SAS,17,26,17,38,0,98
2018-04-11,2,HOU,22,22,19,20,0,83,SAC,28,24,27,17,0,96
2017-10-19,10,NYK,24,18,17,25,0,84,OKC,27,26,26,26,0,105
2017-10-21,2,DET,19,32,28,32,0,111,NYK,28,36,16,27,0,107
2017-10-24,3,NYK,17,16,27,29,0,89,BOS,30,24,23,33,0,110
2017-10-27,3,BRK,28,14,24,20,0,86,NYK,23,24,36,24,0,107
2017-10-29,2,NYK,29,33,30,22,0,114,CLE,19,35,21,20,0,95
2017-10-30,1,DEN,25,18,38,29,0,110,NYK,35,30,19,32,0,116
2017-11-01,2,HOU,24,36,40,19,0,119,NYK,27,21,26,23,0,97
2017-11-03,2,PHO,19,31,26,31,0,107,NYK,32,33,27,28,0,120
2017-11-05,2,IND,33,29,22,17,0,101,NYK,25,24,23,36,0,108
2017-11-07,2,CHO,41,28,25,19,0,113,NYK,32,26,25,35,0,118
2017-11-08,1,NYK,28,22,26,23,0,99,ORL,27,27,30,28,0,112
2017-11-11,3,SAC,23,26,17,25,0,91,NYK,32,32,26,28,0,118
2017-11-13,2,CLE,25,13,23,43,0,104,NYK,22,29,25,25,0,101
2017-11-15,2,UTA,30,30,22,19,0,101,NYK,27,23,27,29,0,106
2017-11-17,2,NYK,18,18,28,20,0,84,TOR,30,24,24,29,0,107
2017-11-20,3,LAC,20,24,24,17,0,85,NYK,20,36,27,24,0,107
2017-11-22,2,TOR,34,25,10,31,0,100,NYK,26,22,41,19,0,108
2017-11-24,2,NYK,39,28,19,18,0,104,ATL,24,35,30,27,0,116
2017-11-25,1,NYK,39,22,13,28,0,102,HOU,29,29,37,22,0,117
2017-11-27,2,POR,30,23,37,13,0,103,NYK,23,14,27,27,0,91
2017-11-29,2,MIA,22,22,20,22,0,86,NYK,33,32,23,27,0,115
2017-12-03,4,ORL,36,18,24,27,0,105,NYK,25,26,25,24,0,100
2017-12-04,1,NYK,19,21,25,32,0,97,IND,31,35,29,20,0,115
2017-12-06,2,MEM,32,17,18,21,0,88,NYK,23,26,27,23,0,99
2017-12-09,3,NYK,18,26,26,32,0,102,CHI,27,22,19,36,0,104
2017-12-10,1,ATL,21,31,23,32,0,107,NYK,24,27,25,35,0,111
2017-12-12,2,LAL,29,22,28,20,10,109,NYK,25,25,26,23,14,113
2017-12-14,2,NYK,32,31,24,24,0,111,BRK,26,24,32,22,0,104
2017-12-16,2,OKC,26,18,29,23,0,96,NYK,23,27,30,31,0,111
2017-12-18,2,NYK,23,19,22,27,0,91,CHO,29,31,28,21,0,109
2017-12-21,3,BOS,15,25,28,25,0,93,NYK,25,19,24,34,0,102
2017-12-22,1,NYK,21,23,31,26,0,101,DET,25,27,22,30,0,104
2017-12-25,3,PHI,21,29,29,26,0,105,NYK,24,24,27,23,0,98
2017-12-27,2,NYK,28,24,21,14,0,87,CHI,17,32,22,21,0,92
2017-12-28,1,NYK,24,29,26,28,0,107,SAS,32,22,32,33,0,119
2017-12-30,2,NYK,28,28,23,26,0,105,NOP,21,24,33,25,0,103
2018-01-02,3,SAS,25,27,29,19,0,100,NYK,29,20,18,24,0,91
2018-01-03,1,NYK,32,31,14,26,0,103,WAS,33,31,26,31,0,121
2018-01-05,2,NYK,25,20,26,26,6,103,MIA,26,25,24,22,10,107
2018-01-07,2,NYK,33,23,19,25,0,100,DAL,25,27,19,25,0,96
2018-01-10,3,CHI,26,22,30,27,7,122,NYK,25,27,30,23,7,119
2018-01-12,2,NYK,27,30,29,22,0,108,MIN,24,31,32,31,0,118
2018-01-14,2,NOP,13,35,34,27,14,123,NYK,29,28,39,13,9,118
2018-01-15,1,NYK,26,26,31,36,0,119,BRK,24,18,39,23,0,104
2018-01-17,2,NYK,31,22,20,26,0,99,MEM,32,29,27,17,0,105
2018-01-19,2,NYK,22,27,36,32,0,117,UTA,25,30,23,37,0,115
2018-01-21,2,NYK,29,34,26,18,0,107,LAL,30,37,30,30,0,127
2018-01-23,2,NYK,31,29,26,26,0,112,GSW,21,37,37,28,0,123
2018-01-25,2,NYK,28,32,32,26,0,118,DEN,39,34,26,31,0,130
2018-01-26,1,NYK,33,20,28,26,0,107,PHO,23,26,18,18,0,85
2018-01-30,4,BRK,22,19,28,26,0,95,NYK,30,31,25,25,0,111
2018-01-31,1,NYK,24,21,20,8,0,73,BOS,27,23,31,22,0,103
2018-02-02,2,NYK,29,26,19,16,0,90,MIL,28,27,19,18,0,92
2018-02-04,2,ATL,21,23,25,30,0,99,NYK,22,16,33,25,0,96
2018-02-06,2,MIL,25,25,26,27,0,103,NYK,26,20,17,26,0,89
2018-02-08,2,NYK,18,23,25,22,0,88,TOR,23,29,30,31,0,113
2018-02-11,3,NYK,37,25,22,29,0,113,IND,36,32,26,27,0,121
2018-02-12,1,NYK,21,34,24,13,0,92,PHI,31,26,29,22,0,108
2018-02-14,2,WAS,26,25,39,28,0,118,NYK,39,33,15,26,0,113
2018-02-22,8,NYK,31,32,30,27,0,120,ORL,41,28,21,23,0,113
2018-02-24,2,BOS,23,36,29,33,0,121,NYK,24,32,25,31,0,112
2018-02-26,2,GSW,37,26,39,23,0,125,NYK,39,25,18,29,0,111
2018-03-02,4,NYK,25,35,18,27,0,105,LAC,32,25,35,36,0,128
2018-03-04,2,NYK,20,26,26,27,0,99,SAC,32,19,32,19,0,102
2018-03-06,2,NYK,28,24,19,16,0,87,POR,35,22,30,24,0,111
2018-03-09,3,NYK,22,33,34,23,0,112,MIL,26,34,31,29,0,120
2018-03-11,2,TOR,32,33,37,30,0,132,NYK,27,30,29,20,0,106
2018-03-13,2,DAL,29,28,26,27,0,110,NYK,31,29,12,25,0,97
2018-03-15,2,PHI,32,28,23,35,0,118,NYK,32,36,23,19,0,110
2018-03-17,2,CHO,24,26,17,34,0,101,NYK,22,35,42,25,0,124
2018-03-19,2,CHI,18,19,30,25,0,92,NYK,19,28,36,27,0,110
2018-03-21,2,NYK,26,21,30,21,0,98,MIA,27,37,35,20,0,119
2018-03-23,2,MIN,31,26,27,24,0,108,NYK,22,26,34,22,0,104
2018-03-25,2,NYK,19,42,16,24,0,101,WAS,21,32,18,26,0,97
2018-03-26,1,NYK,22,27,33,35,11,128,CHO,27,35,25,30,20,137
2018-03-28,2,NYK,28,35,17,21,0,101,PHI,37,30,26,25,0,118
2018-03-31,3,DET,30,26,29,30,0,115,NYK,27,27,30,25,0,109
2018-04-03,3,ORL,27,19,22,29,0,97,NYK,25,20,16,12,0,73
2018-04-06,3,MIA,23,27,28,20,0,98,NYK,34,29,33,26,0,122
2018-04-07,1,MIL,31,22,27,35,0,115,NYK,28,27,22,25,0,102
2018-04-09,2,CLE,26,35,29,33,0,123,NYK,25,24,28,32,0,109
2018-04-11,2,NYK,20,37,27,26,0,110,CLE,20,17,34,27,0,98
2017-10-18,10,NOP,34,18,18,21,0,91,MEM,27,27,25,24,0,103
2017-10-20,2,GSW,26,35,37,30,0,128,NOP,39,25,26,30,0,120
2017-10-22,2,NOP,34,34,26,25,0,119,LAL,22,33,28,29,0,112
2017-10-24,2,NOP,19,29,25,20,0,93,POR,29,18,24,32,0,103
2017-10-26,2,NOP,27,29,32,26,0,114,SAC,40,30,17,19,0,106
2017-10-28,2,CLE,22,30,31,18,0,101,NOP,35,30,24,34,0,123
2017-10-30,2,ORL,33,27,27,28,0,115,NOP,24,40,20,15,0,99
2017-11-01,2,MIN,31,34,18,21,0,104,NOP,28,26,23,21,0,98
2017-11-03,2,NOP,28,27,20,24,0,99,DAL,25,21,17,31,0,94
2017-11-04,1,NOP,17,21,19,26,13,96,CHI,19,19,26,19,7,90
2017-11-07,3,NOP,34,27,35,21,0,117,IND,37,38,19,18,0,112
2017-11-09,2,NOP,32,28,32,26,0,118,TOR,34,32,26,30,0,122
2017-11-11,2,LAC,26,32,24,21,0,103,NOP,31,32,25,23,0,111
2017-11-13,2,ATL,32,18,30,25,0,105,NOP,23,22,33,28,0,106
2017-11-15,2,TOR,29,35,34,27,0,125,NOP,34,29,23,30,0,116
2017-11-17,2,NOP,19,37,24,34,0,114,DEN,37,27,42,40,0,146
2017-11-20,3,OKC,33,32,21,21,0,107,NOP,24,33,30,27,0,114
2017-11-22,2,SAS,29,13,17,31,0,90,NOP,19,31,37,20,0,107
2017-11-24,2,NOP,33,39,22,21,0,115,PHO,21,21,20,29,0,91
2017-11-25,1,NOP,31,22,22,20,0,95,GSW,17,36,31,26,0,110
2017-11-29,4,MIN,28,34,31,27,0,120,NOP,29,20,27,26,0,102
2017-12-01,2,NOP,29,26,29,24,0,108,UTA,27,16,37,34,0,114
2017-12-02,1,NOP,26,34,38,25,0,123,POR,33,24,25,34,0,116
2017-12-04,2,GSW,26,23,39,37,0,125,NOP,33,36,22,24,0,115
2017-12-06,2,DEN,33,33,25,23,0,114,NOP,33,34,30,26,0,123
2017-12-08,2,SAC,24,23,30,25,14,116,NOP,25,28,29,20,7,109
2017-12-10,2,PHI,26,29,40,29,0,124,NOP,32,34,21,44,0,131
2017-12-11,1,NOP,41,35,27,20,0,123,HOU,35,43,18,34,0,130
2017-12-13,2,MIL,37,26,22,23,0,108,NOP,32,30,25,28,0,115
2017-12-15,2,NOP,33,25,28,18,7,111,DEN,20,26,30,28,13,117
2017-12-19,4,NOP,19,36,15,36,0,106,WAS,36,25,32,23,0,116
2017-12-22,3,NOP,32,28,28,23,0,111,ORL,20,30,22,25,0,97
2017-12-23,1,NOP,27,29,27,26,0,109,MIA,28,25,16,25,0,94
2017-12-27,4,BRK,23,23,29,38,0,113,NOP,31,38,22,37,0,128
2017-12-29,2,DAL,36,41,32,19,0,128,NOP,21,39,41,19,0,120
2017-12-30,1,NYK,28,28,23,26,0,105,NOP,21,24,33,25,0,103
2018-01-03,4,NOP,27,31,23,27,0,108,UTA,28,27,17,26,0,98
2018-01-06,3,NOP,24,24,23,27,0,98,MIN,36,33,29,18,0,116
2018-01-08,2,DET,34,22,28,25,0,109,NOP,37,22,27,26,0,112
2018-01-10,2,NOP,38,23,9,32,0,102,MEM,29,31,17,28,0,105
2018-01-12,2,POR,25,36,25,27,0,113,NOP,31,30,27,31,0,119
2018-01-14,2,NOP,13,35,34,27,14,123,NYK,29,28,39,13,9,118
2018-01-16,2,NOP,32,26,29,17,12,116,BOS,25,23,32,24,9,113
2018-01-17,1,NOP,32,28,10,23,0,93,ATL,25,20,26,23,0,94
2018-01-20,3,MEM,18,26,37,23,0,104,NOP,34,25,24,28,0,111
2018-01-22,2,CHI,21,27,33,33,8,128,NOP,25,29,27,33,8,132
2018-01-24,2,NOP,32,24,20,25,0,101,CHO,21,32,20,23,0,96
2018-01-26,2,HOU,30,23,27,33,0,113,NOP,29,37,24,25,0,115
2018-01-28,2,LAC,26,25,29,32,0,112,NOP,34,28,15,26,0,103
2018-01-30,2,SAC,25,36,29,24,0,114,NOP,29,33,23,18,0,103
2018-02-02,3,NOP,22,32,36,24,0,114,OKC,32,26,25,17,0,100
2018-02-03,1,NOP,29,24,28,26,0,107,MIN,37,29,29,23,0,118
2018-02-05,2,UTA,34,36,29,34,0,133,NOP,23,41,22,23,0,109
2018-02-09,4,NOP,14,27,11,30,0,82,PHI,32,24,28,16,0,100
2018-02-10,1,NOP,34,38,28,16,8,138,BRK,22,30,33,31,8,128
2018-02-12,2,NOP,32,28,35,23,0,118,DET,31,21,28,23,0,103
2018-02-14,2,LAL,33,33,25,26,0,117,NOP,46,33,24,36,0,139
2018-02-23,9,MIA,27,32,30,19,15,123,NOP,22,35,27,24,16,124
2018-02-25,2,NOP,21,28,38,27,9,123,MIL,32,34,19,29,7,121
2018-02-26,1,PHO,36,29,24,27,0,116,NOP,26,32,38,29,0,125
2018-02-28,2,NOP,24,27,36,34,0,121,SAS,29,31,35,21,0,116
2018-03-04,4,NOP,33,32,26,35,0,126,DAL,25,24,29,31,0,109
2018-03-06,2,NOP,35,32,30,24,0,121,LAC,27,25,30,34,0,116
2018-03-07,1,NOP,32,30,23,29,0,114,SAC,21,23,23,34,0,101
2018-03-09,2,WAS,22,31,30,33,0,116,NOP,19,19,24,35,0,97
2018-03-11,2,UTA,29,19,30,38,0,116,NOP,23,28,23,25,0,99
2018-03-13,2,CHO,32,33,27,23,0,115,NOP,37,35,20,27,0,119
2018-03-15,2,NOP,26,32,15,20,0,93,SAS,37,23,18,20,0,98
2018-03-17,2,HOU,32,28,24,23,0,107,NOP,29,25,18,29,0,101
2018-03-18,1,BOS,28,21,27,13,0,89,NOP,20,27,35,26,0,108
2018-03-20,2,DAL,30,22,28,25,0,105,NOP,29,25,26,35,0,115
2018-03-21,1,IND,25,25,19,23,0,92,NOP,24,27,16,29,0,96
2018-03-22,1,LAL,44,29,35,17,0,125,NOP,40,31,26,31,0,128
2018-03-24,2,NOP,16,21,24,30,0,91,HOU,29,35,19,31,0,114
2018-03-27,3,POR,20,26,25,36,0,107,NOP,24,25,26,28,0,103
2018-03-30,3,NOP,29,28,22,23,0,102,CLE,29,18,33,27,0,107
2018-04-01,2,OKC,20,33,27,29,0,109,NOP,28,22,25,29,0,104
2018-04-04,3,MEM,23,30,20,22,0,95,NOP,32,33,32,26,0,123
2018-04-06,2,NOP,39,24,23,36,0,122,PHO,21,25,24,33,0,103
2018-04-07,1,NOP,40,27,21,38,0,126,GSW,32,33,27,28,0,120
2018-04-09,2,NOP,31,28,34,20,0,113,LAC,23,26,22,29,0,100
2018-04-11,2,SAS,26,17,29,26,0,98,NOP,27,34,29,32,0,122
2017-10-18,10,CHO,27,18,25,20,0,90,DET,29,27,26,20,0,102
2017-10-20,2,DET,31,34,16,30,0,111,WAS,29,29,33,24,0,115
2017-10-21,1,DET,19,32,28,32,0,111,NYK,28,36,16,27,0,107
2017-10-23,2,PHI,31,25,19,22,0,97,DET,22,21,24,19,0,86
2017-10-25,2,MIN,26,18,29,28,0,101,DET,23,40,28,31,0,122
2017-10-28,3,DET,27,18,22,28,0,95,LAC,24,31,17,15,0,87
2017-10-29,1,DET,27,25,30,33,0,115,GSW,35,22,24,26,0,107
2017-10-31,2,DET,22,23,27,21,0,93,LAL,25,33,29,26,0,113
2017-11-03,3,MIL,26,22,24,24,0,96,DET,28,31,23,23,0,105
2017-11-04,1,SAC,26,23,25,25,0,99,DET,29,23,33,23,0,108
2017-11-08,4,IND,30,22,23,22,0,97,DET,22,37,23,32,0,114
2017-11-10,2,ATL,22,19,28,35,0,104,DET,26,31,19,35,0,111
2017-11-12,2,MIA,29,29,23,22,0,103,DET,31,24,28,29,0,112
2017-11-15,3,DET,23,18,21,33,0,95,MIL,26,15,34,24,0,99
2017-11-17,2,DET,32,26,23,19,0,100,IND,23,24,24,36,0,107
2017-11-19,2,DET,22,27,22,29,0,100,MIN,24,29,27,17,0,97
2017-11-20,1,CLE,36,37,28,15,0,116,DET,23,23,16,26,0,88
2017-11-24,4,DET,25,24,24,26,0,99,OKC,29,30,18,21,0,98
2017-11-27,3,DET,31,29,26,32,0,118,BOS,23,34,29,22,0,108
2017-11-29,2,PHO,19,22,29,37,0,107,DET,36,33,35,27,0,131
2017-12-01,2,DET,26,26,15,24,0,91,WAS,26,20,35,28,0,109
2017-12-02,1,DET,25,22,33,23,0,103,PHI,32,31,17,28,0,108
2017-12-04,2,DET,29,24,20,20,0,93,SAS,28,22,19,27,0,96
2017-12-06,2,DET,27,24,25,24,0,100,MIL,30,30,16,28,0,104
2017-12-08,2,GSW,30,16,31,25,0,102,DET,24,26,17,31,0,98
2017-12-10,2,BOS,29,15,29,18,0,91,DET,21,16,22,22,0,81
2017-12-12,2,DEN,26,23,31,23,0,103,DET,18,22,20,24,0,84
2017-12-14,2,DET,30,29,26,20,0,105,ATL,31,15,18,27,0,91
2017-12-15,1,DET,27,25,34,18,0,104,IND,19,35,20,24,0,98
2017-12-17,2,ORL,23,20,36,31,0,110,DET,36,24,36,18,0,114
2017-12-20,3,DET,25,28,13,27,0,93,DAL,22,43,24,21,0,110
2017-12-22,2,NYK,21,23,31,26,0,101,DET,25,27,22,30,0,104
2017-12-26,4,IND,19,26,21,17,0,83,DET,40,18,24,25,0,107
2017-12-28,2,DET,28,22,23,16,0,89,ORL,33,17,27,25,0,102
2017-12-30,2,SAS,13,23,21,22,0,79,DET,24,15,24,30,0,93
2018-01-03,4,DET,29,23,29,23,0,104,MIA,24,32,25,30,0,111
2018-01-05,2,DET,15,17,29,17,0,78,PHI,32,30,35,17,0,114
2018-01-06,1,HOU,37,21,19,24,0,101,DET,31,26,31,20,0,108
2018-01-08,2,DET,34,22,28,25,0,109,NOP,37,22,27,26,0,112
2018-01-10,2,DET,34,29,27,24,0,114,BRK,26,15,20,19,0,80
2018-01-13,3,DET,31,30,23,21,0,105,CHI,36,24,27,20,0,107
2018-01-15,2,CHO,27,23,34,34,0,118,DET,27,29,24,27,0,107
2018-01-17,2,DET,18,33,22,18,0,91,TOR,31,23,19,23,0,96
2018-01-19,2,WAS,19,27,45,31,0,122,DET,29,17,28,38,0,112
2018-01-21,2,BRK,30,23,24,24,0,101,DET,20,28,20,32,0,100
2018-01-24,3,UTA,24,19,22,24,9,98,DET,24,25,15,25,6,95
2018-01-27,3,OKC,36,33,29,23,0,121,DET,24,33,24,27,0,108
2018-01-28,1,DET,28,33,26,17,0,104,CLE,33,25,32,31,0,121
2018-01-30,2,CLE,27,36,21,30,0,114,DET,33,26,30,36,0,125
2018-02-01,2,MEM,25,26,25,26,0,102,DET,27,24,31,22,0,104
2018-02-03,2,MIA,26,24,27,30,0,107,DET,27,27,22,35,0,111
2018-02-05,2,POR,20,23,24,24,0,91,DET,22,27,30,32,0,111
2018-02-07,2,BRK,21,29,23,33,0,106,DET,26,27,26,36,0,115
2018-02-09,2,LAC,31,21,25,31,0,108,DET,30,26,24,15,0,95
2018-02-11,2,DET,23,33,24,35,0,115,ATL,28,27,27,36,0,118
2018-02-12,1,NOP,32,28,35,23,0,118,DET,31,21,28,23,0,103
2018-02-14,2,ATL,14,19,28,37,0,98,DET,22,23,37,22,0,104
2018-02-23,9,BOS,23,38,25,24,0,110,DET,28,21,28,21,0,98
2018-02-25,2,DET,19,27,25,27,0,98,CHO,32,38,26,18,0,114
2018-02-26,1,DET,26,27,22,19,0,94,TOR,30,29,34,30,0,123
2018-02-28,2,MIL,32,12,26,17,0,87,DET,32,21,32,25,0,110
2018-03-02,2,DET,29,23,30,22,2,106,ORL,31,22,29,22,11,115
2018-03-03,1,DET,28,18,24,26,0,96,MIA,27,32,15,31,0,105
2018-03-05,2,DET,28,21,21,20,0,90,CLE,26,28,36,22,0,112
2018-03-07,2,TOR,27,18,40,29,7,121,DET,23,36,25,30,5,119
2018-03-09,2,CHI,26,21,15,21,0,83,DET,21,28,24,26,0,99
2018-03-13,4,DET,21,18,20,20,0,79,UTA,42,22,22,24,0,110
2018-03-15,2,DET,29,22,33,29,0,113,DEN,33,32,33,22,0,120
2018-03-17,2,DET,20,25,18,24,0,87,POR,31,29,20,20,0,100
2018-03-19,2,DET,25,19,29,33,0,106,SAC,21,23,22,24,0,90
2018-03-20,1,DET,19,25,36,35,0,115,PHO,19,19,26,24,0,88
2018-03-22,2,DET,27,23,18,20,8,96,HOU,21,27,23,17,12,100
2018-03-24,2,CHI,22,25,29,19,0,95,DET,36,30,29,22,0,117
2018-03-26,2,LAL,29,26,21,30,0,106,DET,26,27,28,31,0,112
2018-03-29,3,WAS,24,25,17,26,0,92,DET,23,26,32,22,0,103
2018-03-31,2,DET,30,26,29,30,0,115,NYK,27,27,30,25,0,109
2018-04-01,1,DET,33,29,21,25,0,108,BRK,28,20,22,26,0,96
2018-04-04,3,PHI,36,29,23,27,0,115,DET,28,21,22,37,0,108
2018-04-06,2,DAL,24,30,21,26,5,106,DET,22,31,25,23,12,113
2018-04-08,2,DET,22,34,28,33,0,117,MEM,30,32,34,34,0,130
2018-04-09,1,TOR,32,25,28,23,0,108,DET,32,28,20,18,0,98
2018-04-11,2,DET,35,31,28,25,0,119,CHI,21,29,24,13,0,87
2017-10-18,10,ATL,27,31,24,35,0,117,DAL,24,23,35,29,0,111
2017-10-20,2,ATL,28,28,17,18,0,91,CHO,18,31,35,25,0,109
2017-10-22,2,ATL,25,28,24,27,0,104,BRK,19,37,35,25,0,116
2017-10-23,1,ATL,23,21,29,20,0,93,MIA,26,36,15,27,0,104
2017-10-26,3,ATL,20,19,20,27,0,86,CHI,18,19,28,26,0,91
2017-10-27,1,DEN,26,27,22,30,0,105,ATL,23,29,19,29,0,100
2017-10-29,2,MIL,28,33,31,25,0,117,ATL,16,32,25,33,0,106
2017-11-01,3,ATL,25,32,36,16,0,109,PHI,34,25,34,26,0,119
2017-11-03,2,HOU,36,33,28,22,0,119,ATL,25,26,25,28,0,104
2017-11-05,2,ATL,37,17,37,26,0,117,CLE,28,17,33,37,0,115
2017-11-06,1,BOS,26,28,28,28,0,110,ATL,25,29,21,32,0,107
2017-11-10,4,ATL,22,19,28,35,0,104,DET,26,31,19,35,0,111
2017-11-11,1,ATL,19,23,25,27,0,94,WAS,20,29,27,37,0,113
2017-11-13,2,ATL,32,18,30,25,0,105,NOP,23,22,33,28,0,106
2017-11-15,2,SAC,16,19,26,19,0,80,ATL,24,40,28,34,0,126
2017-11-18,3,BOS,20,24,36,30,0,110,ATL,35,15,27,22,0,99
2017-11-20,2,ATL,22,16,27,20,0,85,SAS,24,22,24,26,0,96
2017-11-22,2,LAC,29,33,26,28,0,116,ATL,30,33,21,19,0,103
2017-11-24,2,NYK,39,28,19,18,0,104,ATL,24,35,30,27,0,116
2017-11-25,1,TOR,28,39,32,13,0,112,ATL,25,14,19,20,0,78
2017-11-30,5,CLE,42,21,36,22,0,121,ATL,35,32,23,24,0,114
2017-12-02,2,ATL,25,29,27,33,0,114,BRK,22,23,30,27,0,102
2017-12-04,2,BRK,33,20,31,26,0,110,ATL,32,22,15,21,0,90
2017-12-06,2,ATL,23,29,27,17,10,106,ORL,31,13,30,22,14,110
2017-12-09,3,ORL,22,32,33,23,0,110,ATL,32,25,32,28,0,117
2017-12-10,1,ATL,21,31,23,32,0,107,NYK,24,27,25,35,0,111
2017-12-12,2,ATL,31,17,29,37,0,114,CLE,31,31,32,29,0,123
2017-12-14,2,DET,30,29,26,20,0,105,ATL,31,15,18,27,0,91
2017-12-15,1,ATL,21,26,26,21,0,94,MEM,17,23,32,24,0,96
2017-12-18,3,MIA,30,27,19,28,0,104,ATL,29,29,29,23,0,110
2017-12-20,2,IND,28,25,25,27,0,105,ATL,27,24,20,24,0,95
2017-12-22,2,ATL,28,22,31,36,0,117,OKC,28,36,18,38,0,120
2017-12-23,1,DAL,25,28,27,27,0,107,ATL,25,23,31,33,0,112
2017-12-27,4,WAS,29,28,19,23,0,99,ATL,29,26,23,35,0,113
2017-12-29,2,ATL,22,25,22,29,0,98,TOR,30,32,26,23,0,111
2017-12-30,1,POR,23,29,17,20,0,89,ATL,24,22,26,32,0,104
2018-01-02,3,ATL,27,21,32,23,0,103,PHO,19,30,24,31,0,104
2018-01-05,3,ATL,22,24,22,21,0,89,POR,30,22,30,28,0,110
2018-01-07,2,ATL,27,21,32,33,0,113,LAL,29,37,30,36,0,132
2018-01-08,1,ATL,25,22,30,30,0,107,LAC,32,26,22,28,0,108
2018-01-10,2,ATL,29,25,28,28,0,110,DEN,21,25,32,19,0,97
2018-01-12,2,BRK,25,28,21,36,0,110,ATL,25,25,24,31,0,105
2018-01-15,3,SAS,23,25,25,26,0,99,ATL,21,23,28,30,0,102
2018-01-17,2,NOP,32,28,10,23,0,93,ATL,25,20,26,23,0,94
2018-01-20,3,CHI,29,26,22,36,0,113,ATL,21,17,25,34,0,97
2018-01-22,2,UTA,20,21,22,27,0,90,ATL,19,23,32,30,0,104
2018-01-24,2,TOR,28,30,27,23,0,108,ATL,16,24,25,28,0,93
2018-01-26,2,ATL,26,26,34,24,0,110,CHO,30,31,29,31,0,121
2018-01-27,1,WAS,27,34,31,37,0,129,ATL,18,27,26,33,0,104
2018-01-29,2,MIN,32,26,21,21,0,100,ATL,27,28,21,29,0,105
2018-01-31,2,CHO,35,29,33,26,0,123,ATL,28,24,32,26,0,110
2018-02-02,2,ATL,32,23,20,35,0,110,BOS,26,27,41,25,0,119
2018-02-04,2,ATL,21,23,25,30,0,99,NYK,22,16,33,25,0,96
2018-02-06,2,MEM,15,20,19,28,0,82,ATL,22,29,28,29,0,108
2018-02-08,2,ATL,23,16,31,28,0,98,ORL,26,13,30,31,0,100
2018-02-09,1,CLE,31,30,36,26,0,123,ATL,27,29,26,25,0,107
2018-02-11,2,DET,23,33,24,35,0,115,ATL,28,27,27,36,0,118
2018-02-13,2,ATL,24,19,18,31,0,92,MIL,21,20,33,23,0,97
2018-02-14,1,ATL,14,19,28,37,0,98,DET,22,23,37,22,0,104
2018-02-23,9,ATL,22,22,22,27,0,93,IND,27,34,22,33,0,116
2018-02-26,3,LAL,28,36,32,27,0,123,ATL,22,24,29,29,0,104
2018-02-28,2,IND,27,23,15,37,0,102,ATL,28,27,30,22,0,107
2018-03-02,2,GSW,33,29,28,24,0,114,ATL,31,19,34,25,0,109
2018-03-04,2,PHO,23,33,31,25,0,112,ATL,29,27,30,27,0,113
2018-03-06,2,ATL,28,23,26,13,0,90,TOR,27,23,26,30,0,106
2018-03-09,3,ATL,15,22,26,24,0,87,IND,34,19,34,25,0,112
2018-03-11,2,CHI,20,33,38,38,0,129,ATL,34,16,35,37,0,122
2018-03-13,2,OKC,31,23,36,29,0,119,ATL,28,38,22,19,0,107
2018-03-15,2,CHO,33,30,34,32,0,129,ATL,23,32,24,38,0,117
2018-03-17,2,ATL,31,19,37,30,0,117,MIL,26,30,39,27,0,122
2018-03-20,3,ATL,21,20,22,36,0,99,UTA,27,15,25,27,0,94
2018-03-22,2,ATL,28,16,27,19,0,90,SAC,25,24,31,25,0,105
2018-03-23,1,ATL,18,33,23,20,0,94,GSW,16,27,36,27,0,106
2018-03-25,2,ATL,20,25,29,25,0,99,HOU,33,36,25,24,0,118
2018-03-28,3,ATL,32,25,31,26,0,114,MIN,34,31,33,28,0,126
2018-03-30,2,PHI,30,17,39,15,0,101,ATL,27,14,18,32,0,91
2018-04-01,2,ORL,18,25,21,24,0,88,ATL,21,35,13,25,0,94
2018-04-03,2,ATL,25,31,22,20,0,98,MIA,30,22,26,23,0,101
2018-04-04,1,MIA,23,30,31,31,0,115,ATL,29,18,21,18,0,86
2018-04-06,2,ATL,21,31,29,22,0,103,WAS,22,26,29,20,0,97
2018-04-08,2,ATL,24,25,27,36,0,112,BOS,31,27,24,24,0,106
2018-04-10,2,PHI,27,34,28,32,0,121,ATL,32,23,24,34,0,113
2017-10-19,10,CHI,23,14,27,36,0,100,TOR,25,33,26,33,0,117
2017-10-21,2,SAS,19,22,24,22,0,87,CHI,21,17,17,22,0,77
2017-10-24,3,CHI,38,30,24,20,0,112,CLE,28,37,26,28,0,119
2017-10-26,2,ATL,20,19,20,27,0,86,CHI,18,19,28,26,0,91
2017-10-28,2,OKC,26,24,32,19,0,101,CHI,23,8,22,16,0,69
2017-11-01,4,CHI,17,30,17,27,0,91,MIA,27,22,18,30,0,97
2017-11-03,2,CHI,28,16,29,32,0,105,ORL,26,19,15,23,0,83
2017-11-04,1,NOP,17,21,19,26,13,96,CHI,19,19,26,19,7,90
2017-11-07,3,CHI,26,19,36,33,0,114,TOR,29,36,33,21,0,119
2017-11-10,3,IND,27,18,35,25,0,105,CHI,16,19,26,26,0,87
2017-11-11,1,CHI,15,32,23,24,0,94,SAS,37,26,34,36,0,133
2017-11-15,4,CHI,7,27,22,23,0,79,OKC,27,31,19,15,0,92
2017-11-17,2,CHO,27,33,32,28,0,120,CHI,26,34,23,40,0,123
2017-11-19,2,CHI,37,19,28,21,0,105,PHO,30,31,24,28,0,113
2017-11-21,2,CHI,27,29,19,19,0,94,LAL,23,19,30,31,0,103
2017-11-22,1,CHI,24,22,23,11,0,80,UTA,25,30,32,23,0,110
2017-11-24,2,CHI,32,21,13,28,0,94,GSW,29,45,36,33,0,143
2017-11-26,2,MIA,7,38,19,36,0,100,CHI,13,29,19,32,0,93
2017-11-28,2,PHO,28,18,27,31,0,104,CHI,29,14,27,29,0,99
2017-11-30,2,CHI,39,29,24,18,0,110,DEN,30,32,29,20,0,111
2017-12-01,1,SAC,29,32,21,25,0,107,CHI,31,29,21,25,0,106
2017-12-04,3,CLE,29,32,25,27,0,113,CHI,22,23,26,20,0,91
2017-12-06,2,CHI,30,25,28,13,0,96,IND,20,19,30,29,0,98
2017-12-08,2,CHI,31,21,23,31,13,119,CHO,25,27,27,27,5,111
2017-12-09,1,NYK,18,26,26,32,0,102,CHI,27,22,19,36,0,104
2017-12-11,2,BOS,29,13,21,22,0,85,CHI,28,28,22,30,0,108
2017-12-13,2,UTA,24,24,26,26,0,100,CHI,30,19,28,26,0,103
2017-12-15,2,CHI,33,26,23,33,0,115,MIL,30,28,24,27,0,109
2017-12-18,3,PHI,25,34,28,28,0,115,CHI,30,37,22,28,0,117
2017-12-20,2,ORL,24,24,18,28,0,94,CHI,31,28,31,22,0,112
2017-12-21,1,CHI,27,29,23,33,0,112,CLE,29,29,24,33,0,115
2017-12-23,2,CHI,31,27,18,16,0,92,BOS,33,27,38,19,0,117
2017-12-26,3,CHI,22,34,27,32,0,115,MIL,31,22,30,23,0,106
2017-12-27,1,NYK,28,24,21,14,0,87,CHI,17,32,22,21,0,92
2017-12-29,2,IND,27,25,25,30,0,107,CHI,37,27,22,33,0,119
2017-12-31,2,CHI,38,25,26,21,0,110,WAS,30,29,24,31,0,114
2018-01-01,1,POR,31,21,31,29,12,124,CHI,23,30,34,25,8,120
2018-01-03,2,TOR,21,35,34,34,0,124,CHI,31,28,31,25,0,115
2018-01-05,2,CHI,34,23,23,47,0,127,DAL,28,25,35,36,0,124
2018-01-06,1,CHI,26,11,30,19,0,86,IND,31,33,37,24,0,125
2018-01-08,2,HOU,35,25,27,29,0,116,CHI,22,33,21,31,0,107
2018-01-10,2,CHI,26,22,30,27,7,122,NYK,25,27,30,23,7,119
2018-01-13,3,DET,31,30,23,21,0,105,CHI,36,24,27,20,0,107
2018-01-15,2,MIA,25,23,24,39,0,111,CHI,32,23,29,35,0,119
2018-01-17,2,GSW,38,25,32,24,0,119,CHI,40,26,12,34,0,112
2018-01-20,3,CHI,29,26,22,36,0,113,ATL,21,17,25,34,0,97
2018-01-22,2,CHI,21,27,33,33,8,128,NOP,25,29,27,33,8,132
2018-01-24,2,CHI,16,25,26,34,0,101,PHI,25,30,30,30,0,115
2018-01-26,2,LAL,32,30,22,24,0,108,CHI,25,32,15,31,0,103
2018-01-28,2,MIL,26,35,25,24,0,110,CHI,20,22,30,24,0,96
2018-01-31,3,CHI,19,25,31,33,0,108,POR,43,24,35,22,0,124
2018-02-03,3,CHI,17,35,29,22,0,103,LAC,22,35,30,26,0,113
2018-02-05,2,CHI,28,27,24,19,0,98,SAC,9,32,36,27,0,104
2018-02-09,4,MIN,27,40,19,27,0,113,CHI,30,26,33,25,0,114
2018-02-10,1,WAS,30,26,26,19,0,101,CHI,22,24,24,20,0,90
2018-02-12,2,ORL,27,24,20,30,0,101,CHI,30,23,24,28,0,105
2018-02-14,2,TOR,27,34,34,27,0,122,CHI,33,16,27,22,0,98
2018-02-22,8,PHI,33,34,26,23,0,116,CHI,29,40,22,24,0,115
2018-02-24,2,CHI,24,38,20,22,0,104,MIN,31,29,26,36,0,122
2018-02-26,2,CHI,19,32,19,17,0,87,BRK,28,21,35,20,0,104
2018-02-27,1,CHI,29,22,27,25,0,103,CHO,26,25,36,31,0,118
2018-03-02,3,DAL,32,17,36,15,0,100,CHI,24,23,31,30,0,108
2018-03-05,3,BOS,35,20,31,19,0,105,CHI,16,13,24,36,0,89
2018-03-07,2,MEM,22,29,24,35,0,110,CHI,30,34,26,29,0,119
2018-03-09,2,CHI,26,21,15,21,0,83,DET,21,28,24,26,0,99
2018-03-11,2,CHI,20,33,38,38,0,129,ATL,34,16,35,37,0,122
2018-03-13,2,LAC,31,31,28,22,0,112,CHI,27,33,18,28,0,106
2018-03-15,2,CHI,22,30,26,33,0,111,MEM,29,23,23,35,0,110
2018-03-17,2,CLE,32,37,16,29,0,114,CHI,31,21,29,28,0,109
2018-03-19,2,CHI,18,19,30,25,0,92,NYK,19,28,36,27,0,110
2018-03-21,2,DEN,39,38,36,22,0,135,CHI,25,21,24,32,0,102
2018-03-23,2,MIL,24,37,29,28,0,118,CHI,34,27,21,23,0,105
2018-03-24,1,CHI,22,25,29,19,0,95,DET,36,30,29,22,0,117
2018-03-27,3,CHI,23,16,18,29,0,86,HOU,31,29,27,31,0,118
2018-03-29,2,CHI,21,25,22,24,0,92,MIA,29,22,27,25,0,103
2018-03-30,1,CHI,30,27,9,24,0,90,ORL,24,20,25,13,0,82
2018-04-01,2,WAS,27,32,16,19,0,94,CHI,36,32,19,26,0,113
2018-04-03,2,CHO,22,25,32,35,0,114,CHI,19,34,33,34,0,120
2018-04-06,3,CHI,30,28,18,28,0,104,BOS,30,25,24,32,0,111
2018-04-07,1,BRK,28,35,33,28,0,124,CHI,23,28,26,19,0,96
2018-04-09,2,CHI,26,29,28,22,0,105,BRK,29,33,24,28,0,114
2018-04-11,2,DET,35,31,28,25,0,119,CHI,21,29,24,13,0,87
2017-10-18,10,MIA,37,18,23,31,0,109,ORL,32,26,30,28,0,116
2017-10-21,3,IND,31,19,26,32,0,108,MIA,26,37,28,21,0,112
2017-10-23,2,ATL,23,21,29,20,0,93,MIA,26,36,15,27,0,104
2017-10-25,2,SAS,30,26,32,29,0,117,MIA,30,21,22,27,0,100
2017-10-28,3,BOS,21,26,27,22,0,96,MIA,26,19,18,27,0,90
2017-10-30,2,MIN,23,37,19,31,15,125,MIA,32,30,20,28,12,122
2017-11-01,2,CHI,17,30,17,27,0,91,MIA,27,22,18,30,0,97
2017-11-03,2,MIA,37,21,13,23,0,94,DEN,28,23,25,19,0,95
2017-11-05,2,MIA,34,28,27,15,0,104,LAC,20,29,17,35,0,101
2017-11-06,1,MIA,21,16,20,23,0,80,GSW,22,28,25,22,0,97
2017-11-08,2,MIA,36,33,25,32,0,126,PHO,27,27,32,29,0,115
2017-11-10,2,MIA,25,12,20,27,0,84,UTA,22,27,8,17,0,74
2017-11-12,2,MIA,29,29,23,22,0,103,DET,31,24,28,29,0,112
2017-11-15,3,WAS,30,31,10,31,0,102,MIA,19,30,25,19,0,93
2017-11-17,2,MIA,26,24,16,25,0,91,WAS,17,12,28,31,0,88
2017-11-19,2,IND,29,29,32,30,0,120,MIA,27,28,13,27,0,95
2017-11-22,3,BOS,16,25,22,35,0,98,MIA,27,27,25,25,0,104
2017-11-24,2,MIA,28,30,23,28,0,109,MIN,24,24,22,27,0,97
2017-11-26,2,MIA,7,38,19,36,0,100,CHI,13,29,19,32,0,93
2017-11-28,2,MIA,24,25,25,23,0,97,CLE,35,40,18,15,0,108
2017-11-29,1,MIA,22,22,20,22,0,86,NYK,33,32,23,27,0,115
2017-12-01,2,CHO,30,19,26,25,0,100,MIA,22,28,29,26,0,105
2017-12-03,2,GSW,33,29,37,24,0,123,MIA,36,24,17,18,0,95
2017-12-06,3,MIA,35,23,24,23,0,105,SAS,27,30,29,31,0,117
2017-12-09,3,MIA,24,26,25,26,0,101,BRK,26,27,19,17,0,89
2017-12-11,2,MIA,21,24,25,37,0,107,MEM,23,19,18,22,0,82
2017-12-13,2,POR,21,29,20,32,0,102,MIA,33,27,19,16,0,95
2017-12-15,2,MIA,24,29,26,25,0,104,CHO,19,28,24,27,0,98
2017-12-16,1,LAC,17,23,25,20,0,85,MIA,24,22,23,21,0,90
2017-12-18,2,MIA,30,27,19,28,0,104,ATL,29,29,29,23,0,110
2017-12-20,2,MIA,15,21,26,28,0,90,BOS,24,20,15,30,0,89
2017-12-22,2,DAL,23,30,20,28,0,101,MIA,32,21,29,31,0,113
2017-12-23,1,NOP,27,29,27,26,0,109,MIA,28,25,16,25,0,94
2017-12-26,3,ORL,18,31,19,21,0,89,MIA,21,22,25,39,0,107
2017-12-29,3,BRK,24,35,36,16,0,111,MIA,20,19,21,27,0,87
2017-12-30,1,MIA,21,29,36,31,0,117,ORL,32,34,26,19,0,111
2018-01-03,4,DET,29,23,29,23,0,104,MIA,24,32,25,30,0,111
2018-01-05,2,NYK,25,20,26,26,6,103,MIA,26,25,24,22,10,107
2018-01-07,2,UTA,22,25,28,27,0,102,MIA,27,22,25,29,0,103
2018-01-09,2,MIA,22,29,21,18,0,90,TOR,21,20,23,25,0,89
2018-01-10,1,MIA,38,20,26,30,0,114,IND,26,21,31,28,0,106
2018-01-14,4,MIL,23,20,16,20,0,79,MIA,21,20,30,26,0,97
2018-01-15,1,MIA,25,23,24,39,0,111,CHI,32,23,29,35,0,119
2018-01-17,2,MIA,30,22,26,28,0,106,MIL,25,32,22,22,0,101
2018-01-19,2,MIA,24,29,16,26,0,95,BRK,21,22,24,34,0,101
2018-01-20,1,MIA,31,26,16,33,0,106,CHO,27,21,35,22,0,105
2018-01-22,2,MIA,33,17,18,22,0,90,HOU,25,21,25,28,0,99
2018-01-25,3,SAC,19,28,24,18,0,89,MIA,17,30,25,16,0,88
2018-01-27,2,CHO,26,22,30,13,0,91,MIA,22,32,17,24,0,95
2018-01-29,2,MIA,22,29,24,20,0,95,DAL,26,20,15,27,0,88
2018-01-31,2,MIA,21,29,22,17,0,89,CLE,27,21,24,19,0,91
2018-02-02,2,MIA,23,18,19,37,0,97,PHI,24,27,35,17,0,103
2018-02-03,1,MIA,26,24,27,30,0,107,DET,27,27,22,35,0,111
2018-02-05,2,ORL,26,33,34,18,0,111,MIA,35,25,27,22,0,109
2018-02-07,2,HOU,35,26,22,26,0,109,MIA,24,33,23,21,0,101
2018-02-09,2,MIL,23,23,8,31,0,85,MIA,19,23,30,19,0,91
2018-02-13,4,MIA,24,31,26,31,0,112,TOR,28,29,41,17,0,115
2018-02-14,1,MIA,29,33,19,21,0,102,PHI,20,19,34,31,0,104
2018-02-23,9,MIA,27,32,30,19,15,123,NOP,22,35,27,24,16,124
2018-02-24,1,MEM,31,21,18,19,0,89,MIA,34,26,32,23,0,115
2018-02-27,3,PHI,24,24,27,26,0,101,MIA,17,28,28,29,0,102
2018-03-01,2,LAL,33,40,31,27,0,131,MIA,36,26,32,19,0,113
2018-03-03,2,DET,28,18,24,26,0,96,MIA,27,32,15,31,0,105
2018-03-05,2,PHO,27,21,32,23,0,103,MIA,30,31,32,32,0,125
2018-03-06,1,MIA,26,24,30,25,8,113,WAS,31,28,27,19,12,117
2018-03-08,2,PHI,28,21,25,25,0,99,MIA,29,24,20,35,0,108
2018-03-10,2,WAS,20,28,28,26,0,102,MIA,26,34,43,26,0,129
2018-03-12,2,MIA,25,22,25,27,0,99,POR,34,25,29,27,0,115
2018-03-14,2,MIA,31,21,27,32,8,119,SAC,24,35,32,20,12,123
2018-03-16,2,MIA,25,25,24,18,0,92,LAL,24,26,21,20,0,91
2018-03-19,3,DEN,37,26,28,27,13,141,MIA,36,28,28,26,13,149
2018-03-21,2,NYK,26,21,30,21,0,98,MIA,27,37,35,20,0,119
2018-03-23,2,MIA,18,22,26,33,0,99,OKC,24,20,20,41,0,105
2018-03-25,2,MIA,30,23,21,22,11,107,IND,21,31,30,14,17,113
2018-03-27,2,CLE,18,16,25,20,0,79,MIA,29,25,21,23,0,98
2018-03-29,2,CHI,21,25,22,24,0,92,MIA,29,22,27,25,0,103
2018-03-31,2,BRK,22,26,32,21,9,110,MIA,32,23,21,25,8,109
2018-04-03,3,ATL,25,31,22,20,0,98,MIA,30,22,26,23,0,101
2018-04-04,1,MIA,23,30,31,31,0,115,ATL,29,18,21,18,0,86
2018-04-06,2,MIA,23,27,28,20,0,98,NYK,34,29,33,26,0,122
2018-04-09,3,OKC,21,28,27,39,0,115,MIA,27,25,29,12,0,93
2018-04-11,2,TOR,29,24,25,27,4,109,MIA,27,20,24,34,11,116
2017-10-18,10,NOP,34,18,18,21,0,91,MEM,27,27,25,24,0,103
2017-10-21,3,GSW,26,25,20,30,0,101,MEM,31,25,32,23,0,111
2017-10-23,2,MEM,24,26,20,28,0,98,HOU,26,31,19,14,0,90
2017-10-25,2,MEM,18,31,23,22,0,94,DAL,32,25,22,24,0,103
2017-10-26,1,DAL,14,21,33,23,0,91,MEM,28,26,22,20,0,96
2017-10-28,2,HOU,32,17,23,17,0,89,MEM,30,24,27,22,0,103
2017-10-30,2,CHO,31,20,22,31,0,104,MEM,31,26,25,17,0,99
2017-11-01,2,ORL,23,31,27,20,0,101,MEM,26,28,21,24,0,99
2017-11-04,3,MEM,27,33,27,26,0,113,LAC,25,31,24,24,0,104
2017-11-05,1,MEM,24,30,16,32,0,102,LAL,27,35,26,19,0,107
2017-11-07,2,MEM,23,24,27,24,0,98,POR,21,29,21,26,0,97
2017-11-11,4,MEM,22,28,20,26,0,96,HOU,33,29,31,18,0,111
2017-11-13,2,MEM,29,36,12,26,0,103,MIL,34,26,24,26,0,110
2017-11-15,2,IND,34,33,30,19,0,116,MEM,25,28,31,29,0,113
2017-11-18,3,HOU,33,26,23,23,0,105,MEM,25,25,17,16,0,83
2017-11-20,2,POR,23,32,17,28,0,100,MEM,24,22,25,21,0,92
2017-11-22,2,DAL,12,27,35,21,0,95,MEM,27,29,16,22,0,94
2017-11-24,2,MEM,18,27,29,18,0,92,DEN,27,34,15,28,0,104
2017-11-26,2,BRK,19,28,32,19,0,98,MEM,22,25,18,23,0,88
2017-11-29,3,MEM,21,28,24,22,0,95,SAS,28,30,21,25,0,104
2017-12-01,2,SAS,24,23,21,27,0,95,MEM,18,20,21,20,0,79
2017-12-02,1,MEM,32,20,30,29,0,111,CLE,28,38,27,23,0,116
2017-12-04,2,MIN,26,27,22,17,0,92,MEM,29,27,20,19,0,95
2017-12-06,2,MEM,32,17,18,21,0,88,NYK,23,26,27,23,0,99
2017-12-08,2,TOR,25,32,35,24,0,116,MEM,34,28,31,14,0,107
2017-12-09,1,OKC,19,27,21,25,10,102,MEM,34,23,9,26,9,101
2017-12-11,2,MIA,21,24,25,37,0,107,MEM,23,19,18,22,0,82
2017-12-13,2,MEM,12,17,28,30,0,87,WAS,22,19,19,33,0,93
2017-12-15,2,ATL,21,26,26,21,0,94,MEM,17,23,32,24,0,96
2017-12-16,1,BOS,31,17,23,31,0,102,MEM,12,28,33,20,0,93
2017-12-20,4,MEM,28,23,14,19,0,84,GSW,24,32,18,23,0,97
2017-12-21,1,MEM,25,26,30,14,0,95,PHO,26,34,19,18,0,97
2017-12-23,2,LAC,33,26,22,31,0,112,MEM,30,33,27,25,0,115
2017-12-26,3,MEM,19,34,23,21,0,97,PHO,29,28,19,23,0,99
2017-12-27,1,MEM,24,30,22,33,0,109,LAL,18,29,29,23,0,99
2017-12-30,3,MEM,38,29,31,30,0,128,GSW,40,38,38,25,0,141
2017-12-31,1,MEM,36,28,26,24,0,114,SAC,22,24,17,33,0,96
2018-01-02,2,MEM,31,31,22,21,0,105,LAC,34,33,19,27,0,113
2018-01-05,3,WAS,33,25,29,15,0,102,MEM,24,26,22,28,0,100
2018-01-10,5,NOP,38,23,9,32,0,102,MEM,29,31,17,28,0,105
2018-01-12,2,MEM,26,21,13,18,0,78,DEN,16,27,24,20,0,87
2018-01-15,3,LAL,27,23,27,37,0,114,MEM,34,26,37,26,0,123
2018-01-17,2,NYK,31,22,20,26,0,99,MEM,32,29,27,17,0,105
2018-01-19,2,SAC,17,23,19,29,0,88,MEM,30,10,27,39,0,106
2018-01-20,1,MEM,18,26,37,23,0,104,NOP,34,25,24,28,0,111
2018-01-22,2,PHI,30,25,28,18,0,101,MEM,19,30,25,31,0,105
2018-01-24,2,SAS,22,29,26,31,0,108,MEM,21,19,24,21,0,85
2018-01-26,2,LAC,24,34,25,26,0,109,MEM,20,30,26,24,0,100
2018-01-29,3,PHO,26,21,27,35,0,109,MEM,22,42,26,30,0,120
2018-01-31,2,MEM,25,28,22,26,0,101,IND,21,34,29,21,0,105
2018-02-01,1,MEM,25,26,25,26,0,102,DET,27,24,31,22,0,104
2018-02-04,3,MEM,24,20,30,12,0,86,TOR,25,31,20,25,0,101
2018-02-06,2,MEM,15,20,19,28,0,82,ATL,22,29,28,29,0,108
2018-02-07,1,UTA,21,23,24,24,0,92,MEM,16,23,24,25,0,88
2018-02-11,4,MEM,18,36,26,12,0,92,OKC,35,39,21,15,0,110
2018-02-14,3,OKC,34,39,19,29,0,121,MEM,33,20,31,30,0,114
2018-02-23,9,CLE,20,34,31,27,0,112,MEM,27,22,22,18,0,89
2018-02-24,1,MEM,31,21,18,19,0,89,MIA,34,26,32,23,0,115
2018-02-26,2,MEM,24,17,28,29,0,98,BOS,33,34,19,23,0,109
2018-02-28,2,PHO,21,36,25,28,0,110,MEM,27,27,18,30,0,102
2018-03-02,2,DEN,35,28,28,17,0,108,MEM,29,25,26,22,0,102
2018-03-03,1,MEM,27,25,27,21,0,100,ORL,31,21,25,30,0,107
2018-03-05,2,MEM,23,22,27,26,0,98,SAS,21,26,23,30,0,100
2018-03-07,2,MEM,22,29,24,35,0,110,CHI,30,34,26,29,0,119
2018-03-09,2,UTA,24,26,21,24,0,95,MEM,23,15,20,20,0,78
2018-03-10,1,MEM,13,17,33,17,0,80,DAL,31,25,28,30,0,114
2018-03-12,2,MIL,32,32,26,31,0,121,MEM,24,26,23,30,0,103
2018-03-15,3,CHI,22,30,26,33,0,111,MEM,29,23,23,35,0,110
2018-03-17,2,DEN,17,31,27,19,0,94,MEM,34,19,31,17,0,101
2018-03-19,2,MEM,31,32,31,21,0,115,BRK,32,33,22,31,0,118
2018-03-21,2,MEM,19,25,25,36,0,105,PHI,26,32,41,20,0,119
2018-03-22,1,MEM,14,28,15,22,0,79,CHO,37,38,37,28,0,140
2018-03-24,2,LAL,17,35,19,29,0,100,MEM,28,29,14,22,0,93
2018-03-26,2,MEM,26,33,19,23,0,101,MIN,25,34,23,11,0,93
2018-03-28,2,POR,28,30,23,22,0,103,MEM,20,33,23,32,0,108
2018-03-30,2,MEM,14,33,29,21,0,97,UTA,29,23,28,27,0,107
2018-04-01,2,MEM,24,27,24,23,0,98,POR,32,23,43,15,0,113
2018-04-04,3,MEM,23,30,20,22,0,95,NOP,32,33,32,26,0,123
2018-04-06,2,SAC,25,19,24,26,0,94,MEM,22,26,15,30,0,93
2018-04-08,2,DET,22,34,28,33,0,117,MEM,30,32,34,34,0,130
2018-04-09,1,MEM,26,27,22,19,0,94,MIN,20,36,27,30,0,113
2018-04-11,2,MEM,28,29,39,27,0,123,OKC,38,39,28,32,0,137
2017-10-17,10,HOU,34,28,26,34,0,122,GSW,35,36,30,20,0,121
2017-10-20,3,GSW,26,35,37,30,0,128,NOP,39,25,26,30,0,120
2017-10-21,1,GSW,26,25,20,30,0,101,MEM,31,25,32,23,0,111
2017-10-23,2,GSW,40,25,34,34,0,133,DAL,24,38,22,19,0,103
2017-10-25,2,TOR,26,27,33,26,0,112,GSW,29,32,30,26,0,117
2017-10-27,2,WAS,34,33,30,20,0,117,GSW,27,26,34,33,0,120
2017-10-29,2,DET,27,25,30,33,0,115,GSW,35,22,24,26,0,107
2017-10-30,1,GSW,34,40,33,34,0,141,LAC,28,29,29,27,0,113
2017-11-02,3,GSW,24,26,34,28,0,112,SAS,33,22,23,14,0,92
2017-11-04,2,GSW,36,24,43,24,0,127,DEN,23,32,21,32,0,108
2017-11-06,2,MIA,21,16,20,23,0,80,GSW,22,28,25,22,0,97
2017-11-08,2,MIN,22,28,26,25,0,101,GSW,22,29,44,30,0,125
2017-11-11,3,PHI,28,36,21,29,0,114,GSW,32,33,36,34,0,135
2017-11-13,2,ORL,29,27,19,25,0,100,GSW,27,29,32,22,0,110
2017-11-16,3,GSW,28,19,21,20,0,88,BOS,18,24,26,24,0,92
2017-11-18,2,GSW,28,24,47,25,0,124,PHI,47,27,15,27,0,116
2017-11-19,1,GSW,32,32,34,20,0,118,BRK,20,22,42,27,0,111
2017-11-22,3,GSW,26,22,23,20,0,91,OKC,33,32,29,14,0,108
2017-11-24,2,CHI,32,21,13,28,0,94,GSW,29,45,36,33,0,143
2017-11-25,1,NOP,31,22,22,20,0,95,GSW,17,36,31,26,0,110
2017-11-27,2,SAC,27,26,30,27,0,110,GSW,27,28,27,24,0,106
2017-11-29,2,GSW,30,20,34,25,18,127,LAL,20,34,30,25,14,123
2017-12-01,2,GSW,41,37,24,31,0,133,ORL,34,29,28,21,0,112
2017-12-03,2,GSW,33,29,37,24,0,123,MIA,36,24,17,18,0,95
2017-12-04,1,GSW,26,23,39,37,0,125,NOP,33,36,22,24,0,115
2017-12-06,2,GSW,26,27,26,22,0,101,CHO,18,20,30,19,0,87
2017-12-08,2,GSW,30,16,31,25,0,102,DET,24,26,17,31,0,98
2017-12-11,3,POR,28,19,28,29,0,104,GSW,27,33,33,18,0,111
2017-12-14,3,DAL,28,20,25,24,0,97,GSW,24,24,32,32,0,112
2017-12-18,4,GSW,32,25,26,19,14,116,LAL,24,29,29,20,12,114
2017-12-20,2,MEM,28,23,14,19,0,84,GSW,24,32,18,23,0,97
2017-12-22,2,LAL,24,20,28,34,0,106,GSW,27,34,23,29,0,113
2017-12-23,1,DEN,22,31,20,23,0,96,GSW,20,21,21,19,0,81
2017-12-25,2,CLE,28,16,23,25,0,92,GSW,24,22,25,28,0,99
2017-12-27,2,UTA,24,23,22,32,0,101,GSW,23,25,42,36,0,126
2017-12-29,2,CHO,32,21,26,32,0,111,GSW,29,24,22,25,0,100
2017-12-30,1,MEM,38,29,31,30,0,128,GSW,40,38,38,25,0,141
2018-01-03,4,GSW,35,32,24,34,0,125,DAL,26,35,28,33,0,122
2018-01-04,1,GSW,33,29,31,31,0,124,HOU,37,26,27,24,0,114
2018-01-06,2,GSW,31,33,39,18,0,121,LAC,28,27,21,29,0,105
2018-01-08,2,DEN,28,29,24,33,0,114,GSW,37,27,29,31,0,124
2018-01-10,2,LAC,32,26,39,28,0,125,GSW,35,27,28,16,0,106
2018-01-12,2,GSW,36,27,17,28,0,108,MIL,27,22,33,12,0,94
2018-01-13,1,GSW,43,38,27,19,0,127,TOR,35,19,35,36,0,125
2018-01-15,2,GSW,35,22,36,25,0,118,CLE,37,27,27,17,0,108
2018-01-17,2,GSW,38,25,32,24,0,119,CHI,40,26,12,34,0,112
2018-01-20,3,GSW,28,30,33,17,0,108,HOU,40,25,27,24,0,116
2018-01-23,3,NYK,31,29,26,26,0,112,GSW,21,37,37,28,0,123
2018-01-25,2,MIN,29,33,31,20,0,113,GSW,38,36,32,20,0,126
2018-01-27,2,BOS,37,17,19,32,0,105,GSW,27,23,30,29,0,109
2018-01-30,3,GSW,30,26,29,14,0,99,UTA,35,34,34,26,0,129
2018-02-02,3,GSW,29,29,26,35,0,119,SAC,27,25,23,29,0,104
2018-02-03,1,GSW,32,24,27,25,0,108,DEN,29,26,22,38,0,115
2018-02-06,3,OKC,42,28,29,26,0,125,GSW,30,27,20,28,0,105
2018-02-08,2,DAL,33,27,25,18,0,103,GSW,23,37,33,28,0,121
2018-02-10,2,SAS,37,18,20,30,0,105,GSW,27,31,33,31,0,122
2018-02-12,2,PHO,24,21,26,12,0,83,GSW,25,37,37,30,0,129
2018-02-14,2,GSW,27,24,36,30,0,117,POR,40,23,29,31,0,123
2018-02-22,8,LAC,23,35,34,35,0,127,GSW,34,36,32,32,0,134
2018-02-24,2,OKC,19,26,21,14,0,80,GSW,24,28,32,28,0,112
2018-02-26,2,GSW,37,26,39,23,0,125,NYK,39,25,18,29,0,111
2018-02-28,2,GSW,36,22,27,24,0,109,WAS,21,35,14,31,0,101
2018-03-02,2,GSW,33,29,28,24,0,114,ATL,31,19,34,25,0,109
2018-03-06,4,BRK,19,34,27,21,0,101,GSW,35,13,38,28,0,114
2018-03-08,2,SAS,21,29,37,20,0,107,GSW,28,18,32,32,0,110
2018-03-09,1,GSW,27,25,31,25,0,108,POR,33,28,26,38,0,125
2018-03-11,2,GSW,24,38,22,19,0,103,MIN,34,21,29,25,0,109
2018-03-14,3,LAL,23,32,27,24,0,106,GSW,26,29,34,28,0,117
2018-03-16,2,SAC,29,28,18,23,0,98,GSW,36,23,16,18,0,93
2018-03-17,1,GSW,30,22,42,30,0,124,PHO,34,26,25,24,0,109
2018-03-19,2,GSW,21,20,22,12,0,75,SAS,30,19,12,28,0,89
2018-03-23,4,ATL,18,33,23,20,0,94,GSW,16,27,36,27,0,106
2018-03-25,2,UTA,18,35,36,21,0,110,GSW,22,25,18,26,0,91
2018-03-27,2,IND,18,21,29,24,0,92,GSW,27,21,22,11,0,81
2018-03-29,2,MIL,29,29,34,24,0,116,GSW,27,22,23,35,0,107
2018-03-31,2,GSW,28,29,36,19,0,112,SAC,25,24,20,27,0,96
2018-04-01,1,PHO,24,35,18,30,0,107,GSW,22,36,36,23,0,117
2018-04-03,2,GSW,24,33,27,27,0,111,OKC,27,20,34,26,0,107
2018-04-05,2,GSW,26,25,26,29,0,106,IND,27,35,35,29,0,126
2018-04-07,2,NOP,40,27,21,38,0,126,GSW,32,33,27,28,0,120
2018-04-08,1,GSW,33,31,27,26,0,117,PHO,29,21,22,28,0,100
2018-04-10,2,GSW,16,17,23,23,0,79,UTA,33,29,31,26,0,119
2017-10-18,10,DEN,30,28,25,13,0,96,UTA,21,28,29,28,0,106
2017-10-21,3,SAC,18,16,18,27,0,79,DEN,17,25,24,30,0,96
2017-10-23,2,WAS,29,27,22,31,0,109,DEN,29,26,22,27,0,104
2017-10-25,2,DEN,23,16,29,25,0,93,CHO,27,35,23,25,0,110
2017-10-27,2,DEN,26,27,22,30,0,105,ATL,23,29,19,29,0,100
2017-10-29,2,DEN,29,31,40,24,0,124,BRK,36,27,21,27,0,111
2017-10-30,1,DEN,25,18,38,29,0,110,NYK,35,30,19,32,0,116
2017-11-01,2,TOR,19,27,25,40,0,111,DEN,34,26,43,26,0,129
2017-11-03,2,MIA,37,21,13,23,0,94,DEN,28,23,25,19,0,95
2017-11-04,1,GSW,36,24,43,24,0,127,DEN,23,32,21,32,0,108
2017-11-07,3,BRK,21,25,27,31,0,104,DEN,28,29,36,19,0,112
2017-11-09,2,OKC,28,25,22,19,0,94,DEN,22,29,24,27,0,102
2017-11-11,2,ORL,23,24,30,30,0,107,DEN,39,31,28,27,0,125
2017-11-13,2,DEN,21,28,17,16,0,82,POR,25,29,30,15,0,99
2017-11-17,4,NOP,19,37,24,34,0,114,DEN,37,27,42,40,0,146
2017-11-19,2,DEN,26,22,36,25,0,109,LAL,32,38,29,28,0,127
2017-11-20,1,DEN,22,25,34,33,0,114,SAC,22,25,23,28,0,98
2017-11-22,2,DEN,17,23,27,28,0,95,HOU,36,39,26,24,0,125
2017-11-24,2,MEM,18,27,29,18,0,92,DEN,27,34,15,28,0,104
2017-11-28,4,DEN,24,25,17,11,0,77,UTA,26,22,28,30,0,106
2017-11-30,2,CHI,39,29,24,18,0,110,DEN,30,32,29,20,0,111
2017-12-02,2,LAL,29,30,21,20,0,100,DEN,34,21,23,37,0,115
2017-12-04,2,DEN,23,24,35,23,0,105,DAL,39,25,29,29,0,122
2017-12-06,2,DEN,33,33,25,23,0,114,NOP,33,34,30,26,0,123
2017-12-08,2,DEN,14,35,32,22,0,103,ORL,25,23,22,19,0,89
2017-12-10,2,DEN,35,31,22,26,2,116,IND,22,37,31,24,12,126
2017-12-12,2,DEN,26,23,31,23,0,103,DET,18,22,20,24,0,84
2017-12-13,1,DEN,31,28,33,26,0,118,BOS,30,38,29,27,0,124
2017-12-15,2,NOP,33,25,28,18,7,111,DEN,20,26,30,28,13,117
2017-12-18,3,DEN,18,26,32,18,0,94,OKC,32,20,18,25,0,95
2017-12-20,2,MIN,17,33,30,32,0,112,DEN,24,28,32,20,0,104
2017-12-22,2,DEN,28,24,28,22,0,102,POR,22,19,25,19,0,85
2017-12-23,1,DEN,22,31,20,23,0,96,GSW,20,21,21,19,0,81
2017-12-26,3,UTA,20,14,25,24,0,83,DEN,28,22,26,31,0,107
2017-12-27,1,DEN,23,35,24,32,11,125,MIN,35,36,17,26,14,128
2017-12-30,3,PHI,31,27,25,24,0,107,DEN,29,32,19,22,0,102
2018-01-03,4,PHO,26,41,18,26,0,111,DEN,34,27,37,36,0,134
2018-01-05,2,UTA,26,23,16,26,0,91,DEN,23,23,38,15,0,99
2018-01-06,1,DEN,27,14,30,27,0,98,SAC,29,17,33,27,0,106
2018-01-08,2,DEN,28,29,24,33,0,114,GSW,37,27,29,31,0,124
2018-01-10,2,ATL,29,25,28,28,0,110,DEN,21,25,32,19,0,97
2018-01-12,2,MEM,26,21,13,18,0,78,DEN,16,27,24,20,0,87
2018-01-13,1,DEN,16,28,25,11,0,80,SAS,32,24,26,30,0,112
2018-01-16,3,DAL,27,21,21,33,0,102,DEN,30,31,25,19,0,105
2018-01-17,1,DEN,27,32,22,23,0,104,LAC,29,21,30,29,0,109
2018-01-19,2,PHO,29,31,25,23,0,108,DEN,31,19,23,27,0,100
2018-01-22,3,POR,19,30,29,23,0,101,DEN,20,25,31,28,0,104
2018-01-25,3,NYK,28,32,32,26,0,118,DEN,39,34,26,31,0,130
2018-01-27,2,DAL,26,16,32,15,0,89,DEN,30,20,16,25,0,91
2018-01-29,2,BOS,32,24,24,31,0,111,DEN,21,24,37,28,0,110
2018-01-30,1,DEN,30,25,26,23,0,104,SAS,30,30,20,26,0,106
2018-02-01,2,OKC,33,24,32,35,0,124,DEN,40,32,32,23,0,127
2018-02-03,2,GSW,32,24,27,25,0,108,DEN,29,26,22,38,0,115
2018-02-05,2,CHO,25,37,22,20,0,104,DEN,36,27,34,24,0,121
2018-02-09,4,DEN,23,23,24,34,0,104,HOU,35,28,34,33,0,130
2018-02-10,1,DEN,28,34,32,29,0,123,PHO,23,37,29,24,0,113
2018-02-13,3,SAS,32,29,29,19,0,109,DEN,30,28,29,30,0,117
2018-02-15,2,DEN,35,39,33,27,0,134,MIL,28,34,26,35,0,123
2018-02-23,8,SAS,30,31,28,30,0,119,DEN,32,31,33,26,0,122
2018-02-25,2,HOU,38,28,26,27,0,119,DEN,25,27,27,35,0,114
2018-02-27,2,LAC,24,28,29,41,0,122,DEN,33,25,30,32,0,120
2018-03-02,3,DEN,35,28,28,17,0,108,MEM,29,25,26,22,0,102
2018-03-03,1,DEN,37,36,30,23,0,126,CLE,31,31,35,20,0,117
2018-03-06,3,DEN,25,37,23,22,0,107,DAL,29,29,38,22,0,118
2018-03-07,1,CLE,38,32,19,24,0,113,DEN,23,35,29,21,0,108
2018-03-09,2,LAL,28,34,34,20,0,116,DEN,37,28,29,31,0,125
2018-03-11,2,SAC,25,24,19,36,0,104,DEN,32,34,35,29,0,130
2018-03-13,2,DEN,22,25,35,21,0,103,LAL,35,13,29,35,0,112
2018-03-15,2,DET,29,22,33,29,0,113,DEN,33,32,33,22,0,120
2018-03-17,2,DEN,17,31,27,19,0,94,MEM,34,19,31,17,0,101
2018-03-19,2,DEN,37,26,28,27,13,141,MIA,36,28,28,26,13,149
2018-03-21,2,DEN,39,38,36,22,0,135,CHI,25,21,24,32,0,102
2018-03-23,2,DEN,23,32,23,30,0,108,WAS,16,27,33,24,0,100
2018-03-26,3,DEN,27,32,15,30,0,104,PHI,23,28,34,38,0,123
2018-03-27,1,DEN,23,35,27,25,0,110,TOR,25,33,24,32,0,114
2018-03-30,3,DEN,27,35,30,22,12,126,OKC,28,30,21,35,11,125
2018-04-01,2,MIL,34,20,38,19,14,125,DEN,22,41,16,32,17,128
2018-04-03,2,IND,26,20,27,31,0,104,DEN,27,22,28,30,0,107
2018-04-05,2,MIN,24,30,18,24,0,96,DEN,27,24,28,21,0,100
2018-04-07,2,DEN,33,33,35,33,0,134,LAC,26,32,31,26,0,115
2018-04-09,2,POR,23,26,20,13,0,82,DEN,28,14,24,22,0,88
2018-04-11,2,DEN,26,28,27,20,5,106,MIN,29,33,24,15,11,112
2017-10-18,10,BRK,30,33,35,33,0,131,IND,29,36,41,34,0,140
2017-10-20,2,ORL,27,28,36,30,0,121,BRK,29,29,31,37,0,126
2017-10-22,2,ATL,25,28,24,27,0,104,BRK,19,37,35,25,0,116
2017-10-24,2,BRK,30,31,35,25,0,121,ORL,30,31,26,38,0,125
2017-10-25,1,CLE,23,29,21,34,0,107,BRK,26,29,29,28,0,112
2017-10-27,2,BRK,28,14,24,20,0,86,NYK,23,24,36,24,0,107
2017-10-29,2,DEN,29,31,40,24,0,124,BRK,36,27,21,27,0,111
2017-10-31,2,PHO,30,29,28,35,0,122,BRK,24,29,35,26,0,114
2017-11-03,3,BRK,29,26,29,28,0,112,LAL,30,34,31,29,0,124
2017-11-06,3,BRK,28,19,25,26,0,98,PHO,19,22,27,24,0,92
2017-11-07,1,BRK,21,25,27,31,0,104,DEN,28,29,36,19,0,112
2017-11-10,3,BRK,21,25,31,24,0,101,POR,28,24,18,27,0,97
2017-11-11,1,BRK,25,20,30,31,0,106,UTA,25,36,24,29,0,114
2017-11-14,3,BOS,30,22,28,29,0,109,BRK,21,31,19,31,0,102
2017-11-17,3,UTA,25,24,31,27,0,107,BRK,39,26,24,29,0,118
2017-11-19,2,GSW,32,32,34,20,0,118,BRK,20,22,42,27,0,111
2017-11-22,3,BRK,17,29,31,32,0,109,CLE,20,25,32,42,0,119
2017-11-24,2,POR,23,28,41,35,0,127,BRK,32,21,39,33,0,125
2017-11-26,2,BRK,19,28,32,19,0,98,MEM,22,25,18,23,0,88
2017-11-27,1,BRK,26,29,25,23,0,103,HOU,43,23,30,21,0,117
2017-11-29,2,BRK,21,27,32,29,0,109,DAL,27,20,29,28,0,104
2017-12-02,3,ATL,25,29,27,33,0,114,BRK,22,23,30,27,0,102
2017-12-04,2,BRK,33,20,31,26,0,110,ATL,32,22,15,21,0,90
2017-12-07,3,OKC,33,25,21,16,0,95,BRK,20,29,25,26,0,100
2017-12-09,2,MIA,24,26,25,26,0,101,BRK,26,27,19,17,0,89
2017-12-12,3,WAS,22,29,27,20,0,98,BRK,30,21,28,24,0,103
2017-12-14,2,NYK,32,31,24,24,0,111,BRK,26,24,32,22,0,104
2017-12-15,1,BRK,20,24,20,23,0,87,TOR,30,28,33,29,0,120
2017-12-17,2,IND,28,31,21,29,0,109,BRK,29,19,24,25,0,97
2017-12-20,3,SAC,36,28,22,18,0,104,BRK,20,28,27,24,0,99
2017-12-22,2,WAS,23,20,18,23,0,84,BRK,26,27,35,31,0,119
2017-12-23,1,BRK,28,29,24,30,8,119,IND,21,20,39,31,12,123
2017-12-26,3,BRK,16,28,25,28,0,97,SAS,19,31,30,29,0,109
2017-12-27,1,BRK,23,23,29,38,0,113,NOP,31,38,22,37,0,128
2017-12-29,2,BRK,24,35,36,16,0,111,MIA,20,19,21,27,0,87
2017-12-31,2,BRK,28,31,17,29,0,105,BOS,38,23,21,26,0,108
2018-01-01,1,ORL,27,21,22,25,0,95,BRK,22,25,24,27,0,98
2018-01-03,2,MIN,22,21,30,24,0,97,BRK,24,24,23,27,0,98
2018-01-06,3,BOS,16,23,25,23,0,87,BRK,22,19,20,24,0,85
2018-01-08,2,TOR,26,19,33,29,7,114,BRK,19,25,27,36,6,113
2018-01-10,2,DET,34,29,27,24,0,114,BRK,26,15,20,19,0,80
2018-01-12,2,BRK,25,28,21,36,0,110,ATL,25,25,24,31,0,105
2018-01-13,1,BRK,18,21,35,33,6,113,WAS,33,26,24,24,12,119
2018-01-15,2,NYK,26,26,31,36,0,119,BRK,24,18,39,23,0,104
2018-01-17,2,SAS,31,20,25,24,0,100,BRK,26,20,18,31,0,95
2018-01-19,2,MIA,24,29,16,26,0,95,BRK,21,22,24,34,0,101
2018-01-21,2,BRK,30,23,24,24,0,101,DET,20,28,20,32,0,100
2018-01-23,2,BRK,26,33,26,23,0,108,OKC,30,17,27,35,0,109
2018-01-26,3,BRK,15,20,37,19,0,91,MIL,33,25,23,35,0,116
2018-01-27,1,BRK,11,31,23,32,0,97,MIN,30,24,24,33,0,111
2018-01-30,3,BRK,22,19,28,26,0,95,NYK,30,31,25,25,0,111
2018-01-31,1,PHI,34,31,23,20,0,108,BRK,30,34,27,25,0,116
2018-02-02,2,LAL,24,35,26,17,0,102,BRK,26,31,28,14,0,99
2018-02-04,2,MIL,36,26,21,26,0,109,BRK,22,19,31,22,0,94
2018-02-06,2,HOU,38,27,31,27,0,123,BRK,31,32,23,27,0,113
2018-02-07,1,BRK,21,29,23,33,0,106,DET,26,27,26,36,0,115
2018-02-10,3,NOP,34,38,28,16,8,138,BRK,22,30,33,31,8,128
2018-02-12,2,LAC,34,32,24,24,0,114,BRK,22,29,16,34,0,101
2018-02-14,2,IND,22,32,19,35,0,108,BRK,23,31,25,24,0,103
2018-02-22,8,BRK,28,25,21,22,0,96,CHO,32,23,25,31,0,111
2018-02-26,4,CHI,19,32,19,17,0,87,BRK,28,21,35,20,0,104
2018-02-27,1,BRK,29,32,30,32,0,123,CLE,25,35,34,35,0,129
2018-03-01,2,BRK,31,20,28,21,11,111,SAC,22,31,20,27,16,116
2018-03-04,3,BRK,27,26,33,34,0,120,LAC,32,33,26,32,0,123
2018-03-06,2,BRK,19,34,27,21,0,101,GSW,35,13,38,28,0,114
2018-03-08,2,BRK,35,30,31,29,0,125,CHO,29,30,26,26,0,111
2018-03-11,3,PHI,37,33,26,24,0,120,BRK,25,35,23,14,0,97
2018-03-13,2,TOR,32,25,30,29,0,116,BRK,40,27,18,17,0,102
2018-03-16,3,BRK,33,25,23,35,0,116,PHI,30,25,31,34,0,120
2018-03-17,1,DAL,24,32,33,17,0,106,BRK,30,29,29,26,0,114
2018-03-19,2,MEM,31,32,31,21,0,115,BRK,32,33,22,31,0,118
2018-03-21,2,CHO,22,21,32,36,0,111,BRK,34,28,25,18,0,105
2018-03-23,2,BRK,32,32,27,21,0,112,TOR,31,28,25,32,0,116
2018-03-25,2,CLE,28,32,27,34,0,121,BRK,30,32,27,25,0,114
2018-03-28,3,BRK,36,22,27,26,0,111,ORL,33,18,30,23,0,104
2018-03-31,3,BRK,22,26,32,21,9,110,MIA,32,23,21,25,8,109
2018-04-01,1,DET,33,29,21,25,0,108,BRK,28,20,22,26,0,96
2018-04-03,2,BRK,22,27,22,24,0,95,PHI,28,33,32,28,0,121
2018-04-05,2,BRK,30,22,31,36,0,119,MIL,24,21,36,30,0,111
2018-04-07,2,BRK,28,35,33,28,0,124,CHI,23,28,26,19,0,96
2018-04-09,2,CHI,26,29,28,22,0,105,BRK,29,33,24,28,0,114
2018-04-11,2,BRK,22,21,27,27,0,97,BOS,27,26,30,27,0,110
2017-10-19,10,LAC,27,26,34,21,0,108,LAL,19,23,21,29,0,92
2017-10-21,2,PHO,18,26,20,24,0,88,LAC,23,35,32,40,0,130
2017-10-24,3,UTA,20,21,15,28,0,84,LAC,27,15,33,27,0,102
2017-10-26,2,LAC,30,32,18,24,0,104,POR,24,29,26,24,0,103
2017-10-28,2,DET,27,18,22,28,0,95,LAC,24,31,17,15,0,87
2017-10-30,2,GSW,34,40,33,34,0,141,LAC,28,29,29,27,0,113
2017-11-01,2,DAL,29,19,29,21,0,98,LAC,32,34,29,24,0,119
2017-11-04,3,MEM,27,33,27,26,0,113,LAC,25,31,24,24,0,104
2017-11-05,1,MIA,34,28,27,15,0,104,LAC,20,29,17,35,0,101
2017-11-07,2,LAC,26,29,21,31,0,107,SAS,32,20,40,28,0,120
2017-11-10,3,LAC,31,24,31,25,0,111,OKC,30,33,31,26,0,120
2017-11-11,1,LAC,26,32,24,21,0,103,NOP,31,32,25,23,0,111
2017-11-13,2,PHI,36,19,22,32,0,109,LAC,28,25,26,26,0,105
2017-11-17,4,LAC,27,29,25,24,8,113,CLE,24,32,22,27,13,118
2017-11-18,1,LAC,24,22,25,16,0,87,CHO,25,30,18,29,0,102
2017-11-20,2,LAC,20,24,24,17,0,85,NYK,20,36,27,24,0,107
2017-11-22,2,LAC,29,33,26,28,0,116,ATL,30,33,21,19,0,103
2017-11-25,3,LAC,25,22,29,21,0,97,SAC,31,30,10,24,0,95
2017-11-27,2,LAL,32,30,27,26,0,115,LAC,34,26,27,33,0,120
2017-11-30,3,UTA,26,35,33,32,0,126,LAC,27,34,26,20,0,107
2017-12-02,2,LAC,17,21,28,16,0,82,DAL,24,35,27,22,0,108
2017-12-03,1,LAC,27,28,21,30,0,106,MIN,31,29,18,34,0,112
2017-12-06,3,MIN,29,33,26,25,0,113,LAC,22,27,31,27,0,107
2017-12-09,3,WAS,27,22,32,31,0,112,LAC,30,32,23,28,0,113
2017-12-11,2,TOR,30,23,21,17,0,91,LAC,19,32,19,26,0,96
2017-12-13,2,LAC,13,32,29,32,0,106,ORL,24,16,28,27,0,95
2017-12-15,2,LAC,18,25,21,27,0,91,WAS,25,23,27,25,0,100
2017-12-16,1,LAC,17,23,25,20,0,85,MIA,24,22,23,21,0,90
2017-12-18,2,LAC,17,32,21,21,0,91,SAS,31,26,28,24,0,109
2017-12-20,2,PHO,15,20,31,29,0,95,LAC,23,30,28,27,0,108
2017-12-22,2,LAC,23,29,35,41,0,128,HOU,33,32,20,33,0,118
2017-12-23,1,LAC,33,26,22,31,0,112,MEM,30,33,27,25,0,115
2017-12-26,3,SAC,30,23,20,22,0,95,LAC,30,41,24,27,0,122
2017-12-29,3,LAC,35,27,29,30,0,121,LAL,22,26,28,30,0,106
2017-12-31,2,CHO,22,30,14,32,0,98,LAC,29,13,33,31,0,106
2018-01-02,2,MEM,31,31,22,21,0,105,LAC,34,33,19,27,0,113
2018-01-04,2,OKC,30,34,30,33,0,127,LAC,33,31,33,20,0,117
2018-01-06,2,GSW,31,33,39,18,0,121,LAC,28,27,21,29,0,105
2018-01-08,2,ATL,25,22,30,30,0,107,LAC,32,26,22,28,0,108
2018-01-10,2,LAC,32,26,39,28,0,125,GSW,35,27,28,16,0,106
2018-01-11,1,LAC,29,43,28,21,0,121,SAC,21,39,29,26,0,115
2018-01-13,2,SAC,17,28,23,37,0,105,LAC,30,34,27,35,0,126
2018-01-15,2,HOU,31,25,28,18,0,102,LAC,30,29,33,21,0,113
2018-01-17,2,DEN,27,32,22,23,0,104,LAC,29,21,30,29,0,109
2018-01-20,3,LAC,29,30,28,26,0,113,UTA,39,37,28,21,0,125
2018-01-22,2,MIN,30,31,31,34,0,126,LAC,26,31,33,28,0,118
2018-01-24,2,BOS,25,37,29,22,0,113,LAC,22,33,22,25,0,102
2018-01-26,2,LAC,24,34,25,26,0,109,MEM,20,30,26,24,0,100
2018-01-28,2,LAC,26,25,29,32,0,112,NOP,34,28,15,26,0,103
2018-01-30,2,POR,30,26,30,18,0,104,LAC,27,24,16,29,0,96
2018-02-03,4,CHI,17,35,29,22,0,103,LAC,22,35,30,26,0,113
2018-02-05,2,DAL,28,27,27,19,0,101,LAC,32,26,20,26,0,104
2018-02-09,4,LAC,31,21,25,31,0,108,DET,30,26,24,15,0,95
2018-02-10,1,LAC,28,27,23,20,0,98,PHI,37,32,16,27,0,112
2018-02-12,2,LAC,34,32,24,24,0,114,BRK,22,29,16,34,0,101
2018-02-14,2,LAC,34,27,32,36,0,129,BOS,25,32,34,28,0,119
2018-02-22,8,LAC,23,35,34,35,0,127,GSW,34,36,32,32,0,134
2018-02-23,1,LAC,40,39,16,33,0,128,PHO,18,32,28,39,0,117
2018-02-27,4,LAC,24,28,29,41,0,122,DEN,33,25,30,32,0,120
2018-02-28,1,HOU,34,27,22,22,0,105,LAC,12,31,29,20,0,92
2018-03-02,2,NYK,25,35,18,27,0,105,LAC,32,25,35,36,0,128
2018-03-04,2,BRK,27,26,33,34,0,120,LAC,32,33,26,32,0,123
2018-03-06,2,NOP,35,32,30,24,0,121,LAC,27,25,30,34,0,116
2018-03-09,3,CLE,17,30,30,25,0,102,LAC,35,26,24,31,0,116
2018-03-10,1,ORL,27,31,31,16,0,105,LAC,30,26,31,26,0,113
2018-03-13,3,LAC,31,31,28,22,0,112,CHI,27,33,18,28,0,106
2018-03-15,2,LAC,26,25,23,22,0,96,HOU,28,19,31,23,0,101
2018-03-16,1,LAC,30,26,28,29,0,113,OKC,27,36,26,32,0,121
2018-03-18,2,POR,24,34,33,31,0,122,LAC,18,34,29,28,0,109
2018-03-20,2,LAC,32,26,25,26,0,109,MIN,28,31,36,28,0,123
2018-03-21,1,LAC,38,26,33,30,0,127,MIL,24,33,26,37,0,120
2018-03-23,2,LAC,28,25,23,28,0,104,IND,27,31,24,27,0,109
2018-03-25,2,LAC,28,25,27,37,0,117,TOR,35,25,20,26,0,106
2018-03-27,2,MIL,29,27,26,16,0,98,LAC,35,27,16,27,0,105
2018-03-28,1,LAC,27,31,27,26,0,111,PHO,32,24,26,17,0,99
2018-03-30,2,LAC,23,26,17,30,0,96,POR,26,38,23,18,0,105
2018-04-01,2,IND,22,28,26,35,0,111,LAC,30,21,27,26,0,104
2018-04-03,2,SAS,31,25,27,27,0,110,LAC,17,32,23,41,0,113
2018-04-05,2,LAC,26,23,18,28,0,95,UTA,36,29,29,23,0,117
2018-04-07,2,DEN,33,33,35,33,0,134,LAC,26,32,31,26,0,115
2018-04-09,2,NOP,31,28,34,20,0,113,LAC,23,26,22,29,0,100
2018-04-11,2,LAL,39,25,28,23,0,115,LAC,32,21,21,26,0,100
2017-10-18,10,POR,29,31,38,26,0,124,PHO,21,14,20,21,0,76
2017-10-20,2,POR,31,31,29,23,0,114,IND,25,27,21,23,0,96
2017-10-21,1,POR,26,29,25,30,0,110,MIL,24,36,24,29,0,113
2017-10-24,3,NOP,19,29,25,20,0,93,POR,29,18,24,32,0,103
2017-10-26,2,LAC,30,32,18,24,0,104,POR,24,29,26,24,0,103
2017-10-28,2,PHO,24,33,32,18,0,107,POR,29,32,31,22,0,114
2017-10-30,2,TOR,29,25,27,18,0,99,POR,29,6,26,24,0,85
2017-11-01,2,POR,20,19,30,25,9,103,UTA,22,17,25,30,18,112
2017-11-02,1,LAL,25,37,23,25,0,110,POR,41,25,21,26,0,113
2017-11-05,3,OKC,20,26,21,32,0,99,POR,28,22,28,25,0,103
2017-11-07,2,MEM,23,24,27,24,0,98,POR,21,29,21,26,0,97
2017-11-10,3,BRK,21,25,31,24,0,101,POR,28,24,18,27,0,97
2017-11-13,3,DEN,21,28,17,16,0,82,POR,25,29,30,15,0,99
2017-11-15,2,ORL,33,14,24,23,0,94,POR,24,27,24,24,0,99
2017-11-17,2,POR,20,21,19,22,0,82,SAC,19,23,18,26,0,86
2017-11-18,1,SAC,20,21,22,27,0,90,POR,21,32,27,22,0,102
2017-11-20,2,POR,23,32,17,28,0,100,MEM,24,22,25,21,0,92
2017-11-22,2,POR,14,23,20,24,0,81,PHI,26,24,20,31,0,101
2017-11-24,2,POR,23,28,41,35,0,127,BRK,32,21,39,33,0,125
2017-11-25,1,POR,27,14,32,35,0,108,WAS,30,22,31,22,0,105
2017-11-27,2,POR,30,23,37,13,0,103,NYK,23,14,27,27,0,91
2017-11-30,3,MIL,33,27,27,16,0,103,POR,21,24,21,25,0,91
2017-12-02,2,NOP,26,34,38,25,0,123,POR,33,24,25,34,0,116
2017-12-05,3,WAS,24,27,28,27,0,106,POR,22,15,29,26,0,92
2017-12-09,4,HOU,31,31,22,40,0,124,POR,37,25,36,19,0,117
2017-12-11,2,POR,28,19,28,29,0,104,GSW,27,33,33,18,0,111
2017-12-13,2,POR,21,29,20,32,0,102,MIA,33,27,19,16,0,95
2017-12-15,2,POR,24,26,25,20,0,95,ORL,20,23,23,22,0,88
2017-12-16,1,POR,24,25,25,19,0,93,CHO,20,17,30,24,0,91
2017-12-18,2,POR,24,30,31,22,0,107,MIN,24,27,25,32,0,108
2017-12-20,2,SAS,25,29,20,19,0,93,POR,22,24,26,19,0,91
2017-12-22,2,DEN,28,24,28,22,0,102,POR,22,19,25,19,0,85
2017-12-23,1,POR,17,27,26,25,0,95,LAL,24,25,21,22,0,92
2017-12-28,5,PHI,30,21,34,25,0,110,POR,27,25,20,42,0,114
2017-12-30,2,POR,23,29,17,20,0,89,ATL,24,22,26,32,0,104
2018-01-01,2,POR,31,21,31,29,12,124,CHI,23,30,34,25,8,120
2018-01-02,1,POR,28,28,31,23,0,110,CLE,28,25,38,36,0,127
2018-01-05,3,ATL,22,24,22,21,0,89,POR,30,22,30,28,0,110
2018-01-07,2,SAS,27,26,27,30,0,110,POR,27,21,32,31,0,111
2018-01-09,2,POR,24,30,34,29,0,117,OKC,26,24,26,30,0,106
2018-01-10,1,POR,19,26,32,35,0,112,HOU,25,30,31,35,0,121
2018-01-12,2,POR,25,36,25,27,0,113,NOP,31,30,27,31,0,119
2018-01-14,2,POR,33,10,31,29,0,103,MIN,31,26,34,29,0,120
2018-01-16,2,PHO,31,20,21,39,0,111,POR,36,30,26,26,0,118
2018-01-18,2,IND,28,19,27,12,0,86,POR,29,23,22,26,0,100
2018-01-20,2,DAL,20,25,34,29,0,108,POR,33,29,29,26,0,117
2018-01-22,2,POR,19,30,29,23,0,101,DEN,20,25,31,28,0,104
2018-01-24,2,MIN,29,25,30,30,0,114,POR,25,29,43,26,0,123
2018-01-26,2,POR,17,35,23,32,0,107,DAL,25,19,24,25,0,93
2018-01-30,4,POR,30,26,30,18,0,104,LAC,27,24,16,29,0,96
2018-01-31,1,CHI,19,25,31,33,0,108,POR,43,24,35,22,0,124
2018-02-02,2,POR,18,34,28,25,0,105,TOR,37,37,27,29,0,130
2018-02-04,2,POR,26,28,19,23,0,96,BOS,19,19,31,28,0,97
2018-02-05,1,POR,20,23,24,24,0,91,DET,22,27,30,32,0,111
2018-02-08,3,CHO,18,27,20,32,6,103,POR,29,20,30,18,12,109
2018-02-09,1,POR,33,29,30,26,0,118,SAC,31,21,22,26,0,100
2018-02-11,2,UTA,19,24,38,34,0,115,POR,26,18,19,33,0,96
2018-02-14,3,GSW,27,24,36,30,0,117,POR,40,23,29,31,0,123
2018-02-23,9,POR,31,22,27,20,0,100,UTA,30,17,17,17,0,81
2018-02-24,1,POR,28,27,16,35,0,106,PHO,24,26,31,23,0,104
2018-02-27,3,SAC,26,27,27,19,0,99,POR,36,30,22,28,0,116
2018-03-01,2,MIN,24,25,29,21,0,99,POR,19,25,31,33,0,108
2018-03-03,2,OKC,28,22,25,25,0,100,POR,25,28,30,25,0,108
2018-03-05,2,POR,27,31,15,35,0,108,LAL,24,31,25,23,0,103
2018-03-06,1,NYK,28,24,19,16,0,87,POR,35,22,30,24,0,111
2018-03-09,3,GSW,27,25,31,25,0,108,POR,33,28,26,38,0,125
2018-03-12,3,MIA,25,22,25,27,0,99,POR,34,25,29,27,0,115
2018-03-15,3,CLE,29,25,23,28,0,105,POR,29,30,29,25,0,113
2018-03-17,2,DET,20,25,18,24,0,87,POR,31,29,20,20,0,100
2018-03-18,1,POR,24,34,33,31,0,122,LAC,18,34,29,28,0,109
2018-03-20,2,HOU,27,28,31,29,0,115,POR,31,24,32,24,0,111
2018-03-23,3,BOS,23,24,20,38,0,105,POR,26,26,25,23,0,100
2018-03-25,2,POR,34,23,25,26,0,108,OKC,17,35,28,25,0,105
2018-03-27,2,POR,20,26,25,36,0,107,NOP,24,25,26,28,0,103
2018-03-28,1,POR,28,30,23,22,0,103,MEM,20,33,23,32,0,108
2018-03-30,2,LAC,23,26,17,30,0,96,POR,26,38,23,18,0,105
2018-04-01,2,MEM,24,27,24,23,0,98,POR,32,23,43,15,0,113
2018-04-03,2,POR,22,27,29,31,0,109,DAL,22,28,32,33,0,115
2018-04-05,2,POR,17,27,27,23,0,94,HOU,36,30,18,12,0,96
2018-04-07,2,POR,33,23,21,28,0,105,SAS,32,22,27,35,0,116
2018-04-09,2,POR,23,26,20,13,0,82,DEN,28,14,24,22,0,88
2018-04-11,2,UTA,21,20,18,34,0,93,POR,28,27,25,22,0,102
2017-10-18,10,BRK,30,33,35,33,0,131,IND,29,36,41,34,0,140
2017-10-20,2,POR,31,31,29,23,0,114,IND,25,27,21,23,0,96
2017-10-21,1,IND,31,19,26,32,0,108,MIA,26,37,28,21,0,112
2017-10-24,3,IND,33,28,37,32,0,130,MIN,20,41,23,23,0,107
2017-10-25,1,IND,27,21,26,22,0,96,OKC,30,24,32,28,0,114
2017-10-29,4,SAS,24,24,16,30,0,94,IND,26,27,15,29,0,97
2017-10-31,2,SAC,13,17,18,35,0,83,IND,24,31,14,32,0,101
2017-11-01,1,IND,30,32,30,32,0,124,CLE,28,33,24,22,0,107
2017-11-03,2,IND,28,35,26,21,0,110,PHI,30,26,36,29,0,121
2017-11-05,2,IND,33,29,22,17,0,101,NYK,25,24,23,36,0,108
2017-11-07,2,NOP,34,27,35,21,0,117,IND,37,38,19,18,0,112
2017-11-08,1,IND,30,22,23,22,0,97,DET,22,37,23,32,0,114
2017-11-10,2,IND,27,18,35,25,0,105,CHI,16,19,26,26,0,87
2017-11-12,2,HOU,35,28,24,31,0,118,IND,18,33,20,24,0,95
2017-11-15,3,IND,34,33,30,19,0,116,MEM,25,28,31,29,0,113
2017-11-17,2,DET,32,26,23,19,0,100,IND,23,24,24,36,0,107
2017-11-19,2,IND,29,29,32,30,0,120,MIA,27,28,13,27,0,95
2017-11-20,1,IND,34,16,28,27,0,105,ORL,31,24,17,25,0,97
2017-11-24,4,TOR,25,35,20,24,0,104,IND,29,21,31,26,0,107
2017-11-25,1,BOS,27,18,37,26,0,108,IND,32,22,16,28,0,98
2017-11-27,2,ORL,25,25,34,25,0,109,IND,33,24,28,36,0,121
2017-11-29,2,IND,27,22,22,26,0,97,HOU,22,32,35,29,0,118
2017-12-01,2,IND,32,26,31,26,0,115,TOR,27,38,29,26,0,120
2017-12-04,3,NYK,19,21,25,32,0,97,IND,31,35,29,20,0,115
2017-12-06,2,CHI,30,25,28,13,0,96,IND,20,19,30,29,0,98
2017-12-08,2,CLE,33,30,23,16,0,102,IND,32,25,32,17,0,106
2017-12-10,2,DEN,35,31,22,26,2,116,IND,22,37,31,24,12,126
2017-12-13,3,OKC,22,29,22,27,0,100,IND,27,19,23,26,0,95
2017-12-15,2,DET,27,25,34,18,0,104,IND,19,35,20,24,0,98
2017-12-17,2,IND,28,31,21,29,0,109,BRK,29,19,24,25,0,97
2017-12-18,1,BOS,38,24,23,27,0,112,IND,21,26,31,33,0,111
2017-12-20,2,IND,28,25,25,27,0,105,ATL,27,24,20,24,0,95
2017-12-23,3,BRK,28,29,24,30,8,119,IND,21,20,39,31,12,123
2017-12-26,3,IND,19,26,21,17,0,83,DET,40,18,24,25,0,107
2017-12-27,1,DAL,22,31,18,27,0,98,IND,29,25,20,20,0,94
2017-12-29,2,IND,27,25,25,30,0,107,CHI,37,27,22,33,0,119
2017-12-31,2,MIN,23,26,38,20,0,107,IND,13,25,20,32,0,90
2018-01-03,3,IND,26,26,24,25,0,101,MIL,34,28,31,29,0,122
2018-01-06,3,CHI,26,11,30,19,0,86,IND,31,33,37,24,0,125
2018-01-08,2,MIL,16,22,27,31,0,96,IND,37,27,24,21,0,109
2018-01-10,2,MIA,38,20,26,30,0,114,IND,26,21,31,28,0,106
2018-01-12,2,CLE,34,24,16,21,0,95,IND,12,32,32,21,0,97
2018-01-14,2,IND,30,34,32,24,0,120,PHO,16,28,22,31,0,97
2018-01-15,1,IND,31,27,27,24,0,109,UTA,21,26,18,29,0,94
2018-01-18,3,IND,28,19,27,12,0,86,POR,29,23,22,26,0,100
2018-01-19,1,IND,25,14,27,20,0,86,LAL,18,29,27,25,0,99
2018-01-21,2,IND,22,24,25,23,0,94,SAS,23,20,16,27,0,86
2018-01-24,3,PHO,18,26,21,36,0,101,IND,32,31,36,17,0,116
2018-01-26,2,IND,31,29,20,28,0,108,CLE,38,35,24,18,0,115
2018-01-27,1,ORL,32,38,22,20,0,112,IND,22,31,31,30,0,114
2018-01-29,2,CHO,23,28,27,18,0,96,IND,23,29,29,24,0,105
2018-01-31,2,MEM,25,28,22,26,0,101,IND,21,34,29,21,0,105
2018-02-02,2,IND,37,20,34,35,0,126,CHO,49,22,25,37,0,133
2018-02-03,1,PHI,27,30,18,17,0,92,IND,33,29,14,24,0,100
2018-02-05,2,WAS,28,30,28,25,0,111,IND,23,26,25,28,0,102
2018-02-09,4,IND,30,29,17,21,0,97,BOS,16,22,34,19,0,91
2018-02-11,2,NYK,37,25,22,29,0,113,IND,36,32,26,27,0,121
2018-02-14,3,IND,22,32,19,35,0,108,BRK,23,31,25,24,0,103
2018-02-23,9,ATL,22,22,22,27,0,93,IND,27,34,22,33,0,116
2018-02-26,3,IND,23,20,22,38,0,103,DAL,23,26,19,41,0,109
2018-02-28,2,IND,27,23,15,37,0,102,ATL,28,27,30,22,0,107
2018-03-02,2,IND,18,27,33,25,0,103,MIL,21,25,21,29,0,96
2018-03-04,2,IND,30,25,25,18,0,98,WAS,20,25,20,30,0,95
2018-03-05,1,MIL,17,29,23,20,0,89,IND,20,24,29,19,0,92
2018-03-07,2,UTA,32,22,25,25,0,104,IND,20,24,25,15,0,84
2018-03-09,2,ATL,15,22,26,24,0,87,IND,34,19,34,25,0,112
2018-03-11,2,IND,24,16,34,25,0,99,BOS,25,25,20,27,0,97
2018-03-13,2,IND,33,24,26,18,0,101,PHI,23,30,26,19,0,98
2018-03-15,2,TOR,25,24,28,29,0,106,IND,27,30,22,20,0,99
2018-03-17,2,IND,20,25,26,31,0,102,WAS,25,32,29,23,0,109
2018-03-19,2,LAL,37,22,21,20,0,100,IND,29,28,35,18,0,110
2018-03-21,2,IND,25,25,19,23,0,92,NOP,24,27,16,29,0,96
2018-03-23,2,LAC,28,25,23,28,0,104,IND,27,31,24,27,0,109
2018-03-25,2,MIA,30,23,21,22,11,107,IND,21,31,30,14,17,113
2018-03-27,2,IND,18,21,29,24,0,92,GSW,27,21,22,11,0,81
2018-03-29,2,IND,28,33,18,27,0,106,SAC,28,28,23,24,0,103
2018-04-01,3,IND,22,28,26,35,0,111,LAC,30,21,27,26,0,104
2018-04-03,2,IND,26,20,27,31,0,104,DEN,27,22,28,30,0,107
2018-04-05,2,GSW,26,25,26,29,0,106,IND,27,35,35,29,0,126
2018-04-06,1,IND,14,19,16,24,0,73,TOR,26,19,27,20,0,92
2018-04-08,2,IND,31,39,25,28,0,123,CHO,25,32,24,36,0,117
2018-04-10,2,CHO,37,26,24,32,0,119,IND,25,30,16,22,0,93
2017-10-18,10,MIN,25,24,28,22,0,99,SAS,32,21,34,20,0,107
2017-10-21,3,SAS,19,22,24,22,0,87,CHI,21,17,17,22,0,77
2017-10-23,2,TOR,23,27,24,23,0,97,SAS,21,29,25,26,0,101
2017-10-25,2,SAS,30,26,32,29,0,117,MIA,30,21,22,27,0,100
2017-10-27,2,SAS,18,16,30,23,0,87,ORL,32,29,34,19,0,114
2017-10-29,2,SAS,24,24,16,30,0,94,IND,26,27,15,29,0,97
2017-10-30,1,SAS,26,23,18,27,0,94,BOS,30,24,26,28,0,108
2017-11-02,3,GSW,24,26,34,28,0,112,SAS,33,22,23,14,0,92
2017-11-03,1,CHO,19,26,26,30,0,101,SAS,25,24,31,28,0,108
2017-11-05,2,PHO,20,35,13,27,0,95,SAS,28,23,34,27,0,112
2017-11-07,2,LAC,26,29,21,31,0,107,SAS,32,20,40,28,0,120
2017-11-10,3,MIL,25,21,30,18,0,94,SAS,27,20,23,17,0,87
2017-11-11,1,CHI,15,32,23,24,0,94,SAS,37,26,34,36,0,133
2017-11-14,3,SAS,17,27,18,35,0,97,DAL,16,23,21,31,0,91
2017-11-15,1,SAS,24,19,22,21,0,86,MIN,18,39,18,23,0,98
2017-11-17,2,OKC,32,23,23,23,0,101,SAS,15,33,30,26,0,104
2017-11-20,3,ATL,22,16,27,20,0,85,SAS,24,22,24,26,0,96
2017-11-22,2,SAS,29,13,17,31,0,90,NOP,19,31,37,20,0,107
2017-11-25,3,SAS,14,26,32,34,0,106,CHO,15,14,29,28,0,86
2017-11-27,2,DAL,23,30,22,33,0,108,SAS,21,25,31,38,0,115
2017-11-29,2,MEM,21,28,24,22,0,95,SAS,28,30,21,25,0,104
2017-12-01,2,SAS,24,23,21,27,0,95,MEM,18,20,21,20,0,79
2017-12-03,2,SAS,18,25,30,14,0,87,OKC,25,29,22,14,0,90
2017-12-04,1,DET,29,24,20,20,0,93,SAS,28,22,19,27,0,96
2017-12-06,2,MIA,35,23,24,23,0,105,SAS,27,30,29,31,0,117
2017-12-08,2,BOS,31,24,27,20,0,102,SAS,26,30,21,28,0,105
2017-12-09,1,SAS,28,24,27,25,0,104,PHO,17,22,32,30,0,101
2017-12-12,3,SAS,23,21,25,20,0,89,DAL,30,16,21,28,0,95
2017-12-15,3,SAS,16,27,29,37,0,109,HOU,31,29,32,32,0,124
2017-12-16,1,DAL,31,22,27,16,0,96,SAS,18,25,28,27,0,98
2017-12-18,2,LAC,17,32,21,21,0,91,SAS,31,26,28,24,0,109
2017-12-20,2,SAS,25,29,20,19,0,93,POR,22,24,26,19,0,91
2017-12-21,1,SAS,17,21,32,19,0,89,UTA,24,26,22,28,0,100
2017-12-23,2,SAS,33,29,22,24,0,108,SAC,33,16,27,23,0,99
2017-12-26,3,BRK,16,28,25,28,0,97,SAS,19,31,30,29,0,109
2017-12-28,2,NYK,24,29,26,28,0,107,SAS,32,22,32,33,0,119
2017-12-30,2,SAS,13,23,21,22,0,79,DET,24,15,24,30,0,93
2018-01-02,3,SAS,25,27,29,19,0,100,NYK,29,20,18,24,0,91
2018-01-03,1,SAS,22,27,35,22,0,106,PHI,27,33,28,24,0,112
2018-01-05,2,PHO,26,16,30,17,0,89,SAS,26,23,31,23,0,103
2018-01-07,2,SAS,27,26,27,30,0,110,POR,27,21,32,31,0,111
2018-01-08,1,SAS,21,25,27,34,0,107,SAC,25,31,20,24,0,100
2018-01-11,3,SAS,15,23,24,19,0,81,LAL,20,29,19,25,0,93
2018-01-13,2,DEN,16,28,25,11,0,80,SAS,32,24,26,30,0,112
2018-01-15,2,SAS,23,25,25,26,0,99,ATL,21,23,28,30,0,102
2018-01-17,2,SAS,31,20,25,24,0,100,BRK,26,20,18,31,0,95
2018-01-19,2,SAS,18,19,23,23,0,83,TOR,17,27,19,23,0,86
2018-01-21,2,IND,22,24,25,23,0,94,SAS,23,20,16,27,0,86
2018-01-23,2,CLE,29,26,26,21,0,102,SAS,25,38,26,25,0,114
2018-01-24,1,SAS,22,29,26,31,0,108,MEM,21,19,24,21,0,85
2018-01-26,2,PHI,25,25,31,16,0,97,SAS,13,18,30,17,0,78
2018-01-28,2,SAC,22,28,19,29,0,98,SAS,29,20,30,34,0,113
2018-01-30,2,DEN,30,25,26,23,0,104,SAS,30,30,20,26,0,106
2018-02-01,2,HOU,27,27,28,20,0,102,SAS,14,24,32,21,0,91
2018-02-03,2,UTA,33,28,26,33,0,120,SAS,24,25,29,33,0,111
2018-02-07,4,SAS,28,41,28,32,0,129,PHO,9,22,19,31,0,81
2018-02-10,3,SAS,37,18,20,30,0,105,GSW,27,31,33,31,0,122
2018-02-12,2,SAS,22,26,29,22,0,99,UTA,25,29,15,32,0,101
2018-02-13,1,SAS,32,29,29,19,0,109,DEN,30,28,29,30,0,117
2018-02-23,10,SAS,30,31,28,30,0,119,DEN,32,31,33,26,0,122
2018-02-25,2,SAS,25,25,26,34,0,110,CLE,20,33,21,20,0,94
2018-02-28,3,NOP,24,27,36,34,0,121,SAS,29,31,35,21,0,116
2018-03-03,3,LAL,23,30,27,36,0,116,SAS,30,30,31,21,0,112
2018-03-05,2,MEM,23,22,27,26,0,98,SAS,21,26,23,30,0,100
2018-03-08,3,SAS,21,29,37,20,0,107,GSW,28,18,32,32,0,110
2018-03-10,2,SAS,19,24,25,26,0,94,OKC,24,28,25,27,0,104
2018-03-12,2,SAS,21,22,24,26,0,93,HOU,25,29,34,21,0,109
2018-03-13,1,ORL,18,19,20,15,0,72,SAS,24,38,34,12,0,108
2018-03-15,2,NOP,26,32,15,20,0,93,SAS,37,23,18,20,0,98
2018-03-17,2,MIN,24,26,31,20,0,101,SAS,23,38,29,27,0,117
2018-03-19,2,GSW,21,20,22,12,0,75,SAS,30,19,12,28,0,89
2018-03-21,2,WAS,18,26,16,30,0,90,SAS,18,32,27,21,0,98
2018-03-23,2,UTA,21,30,22,41,6,120,SAS,29,27,21,37,10,124
2018-03-25,2,SAS,15,32,28,28,0,103,MIL,27,20,41,18,0,106
2018-03-27,2,SAS,24,21,21,40,0,106,WAS,21,38,29,28,0,116
2018-03-29,2,OKC,29,27,25,18,0,99,SAS,24,35,18,26,0,103
2018-04-01,3,HOU,17,21,28,17,0,83,SAS,26,20,29,25,0,100
2018-04-03,2,SAS,31,25,27,27,0,110,LAC,17,32,23,41,0,113
2018-04-04,1,SAS,30,31,26,21,4,112,LAL,29,29,23,27,14,122
2018-04-07,3,POR,33,23,21,28,0,105,SAS,32,22,27,35,0,116
2018-04-09,2,SAC,25,25,16,19,0,85,SAS,17,26,17,38,0,98
2018-04-11,2,SAS,26,17,29,26,0,98,NOP,27,34,29,32,0,122
2017-10-17,10,HOU,34,28,26,34,0,122,GSW,35,36,30,20,0,121
2017-10-18,1,HOU,26,26,23,30,0,105,SAC,25,23,24,28,0,100
2017-10-21,3,DAL,20,19,19,33,0,91,HOU,33,29,30,15,0,107
2017-10-23,2,MEM,24,26,20,28,0,98,HOU,26,31,19,14,0,90
2017-10-25,2,HOU,31,25,23,26,0,105,PHI,33,21,26,24,0,104
2017-10-27,2,HOU,27,29,22,31,0,109,CHO,30,16,28,19,0,93
2017-10-28,1,HOU,32,17,23,17,0,89,MEM,30,24,27,22,0,103
2017-10-30,2,PHI,37,21,34,23,0,115,HOU,27,29,24,27,0,107
2017-11-01,2,HOU,24,36,40,19,0,119,NYK,27,21,26,23,0,97
2017-11-03,2,HOU,36,33,28,22,0,119,ATL,25,26,25,28,0,104
2017-11-05,2,UTA,28,21,36,25,0,110,HOU,39,28,48,22,0,137
2017-11-09,4,CLE,25,42,26,20,0,113,HOU,36,29,35,17,0,117
2017-11-11,2,MEM,22,28,20,26,0,96,HOU,33,29,31,18,0,111
2017-11-12,1,HOU,35,28,24,31,0,118,IND,18,33,20,24,0,95
2017-11-14,2,TOR,31,45,27,26,0,129,HOU,33,31,30,19,0,113
2017-11-16,2,HOU,45,45,30,22,0,142,PHO,23,42,26,25,0,116
2017-11-18,2,HOU,33,26,23,23,0,105,MEM,25,25,17,16,0,83
2017-11-22,4,DEN,17,23,27,28,0,95,HOU,36,39,26,24,0,125
2017-11-25,3,NYK,39,22,13,28,0,102,HOU,29,29,37,22,0,117
2017-11-27,2,BRK,26,29,25,23,0,103,HOU,43,23,30,21,0,117
2017-11-29,2,IND,27,22,22,26,0,97,HOU,22,32,35,29,0,118
2017-12-03,4,HOU,27,34,24,33,0,118,LAL,27,19,27,22,0,95
2017-12-07,4,HOU,25,26,37,24,0,112,UTA,20,26,20,35,0,101
2017-12-09,2,HOU,31,31,22,40,0,124,POR,37,25,36,19,0,117
2017-12-11,2,NOP,41,35,27,20,0,123,HOU,35,43,18,34,0,130
2017-12-13,2,CHO,23,26,20,27,0,96,HOU,38,25,28,17,0,108
2017-12-15,2,SAS,16,27,29,37,0,109,HOU,31,29,32,32,0,124
2017-12-16,1,MIL,25,30,24,32,0,111,HOU,28,27,29,31,0,115
2017-12-18,2,UTA,26,24,34,15,0,99,HOU,25,26,28,41,0,120
2017-12-20,2,LAL,37,26,31,28,0,122,HOU,22,37,30,27,0,116
2017-12-22,2,LAC,23,29,35,41,0,128,HOU,33,32,20,33,0,118
2017-12-25,3,HOU,31,26,31,19,0,107,OKC,28,30,30,24,0,112
2017-12-28,3,HOU,32,30,16,20,0,98,BOS,12,26,31,30,0,99
2017-12-29,1,HOU,23,25,30,25,0,103,WAS,27,32,28,34,0,121
2017-12-31,2,LAL,37,35,29,21,11,142,HOU,44,21,25,32,11,148
2018-01-03,3,HOU,25,30,34,27,0,116,ORL,12,29,25,32,0,98
2018-01-04,1,GSW,33,29,31,31,0,124,HOU,37,26,27,24,0,114
2018-01-06,2,HOU,37,21,19,24,0,101,DET,31,26,31,20,0,108
2018-01-08,2,HOU,35,25,27,29,0,116,CHI,22,33,21,31,0,107
2018-01-10,2,POR,19,26,32,35,0,112,HOU,25,30,31,35,0,121
2018-01-12,2,HOU,27,30,33,22,0,112,PHO,23,21,24,27,0,95
2018-01-15,3,HOU,31,25,28,18,0,102,LAC,30,29,33,21,0,113
2018-01-18,3,MIN,17,33,20,28,0,98,HOU,26,37,26,27,0,116
2018-01-20,2,GSW,28,30,33,17,0,108,HOU,40,25,27,24,0,116
2018-01-22,2,MIA,33,17,18,22,0,90,HOU,25,21,25,28,0,99
2018-01-24,2,HOU,38,13,34,19,0,104,DAL,28,17,22,30,0,97
2018-01-26,2,HOU,30,23,27,33,0,113,NOP,29,37,24,25,0,115
2018-01-28,2,PHO,24,29,24,25,0,102,HOU,28,32,32,21,0,113
2018-01-30,2,ORL,30,25,33,19,0,107,HOU,27,27,36,24,0,114
2018-02-01,2,HOU,27,27,28,20,0,102,SAS,14,24,32,21,0,91
2018-02-03,2,HOU,32,33,32,23,0,120,CLE,20,19,30,19,0,88
2018-02-06,3,HOU,38,27,31,27,0,123,BRK,31,32,23,27,0,113
2018-02-07,1,HOU,35,26,22,26,0,109,MIA,24,33,23,21,0,101
2018-02-09,2,DEN,23,23,24,34,0,104,HOU,35,28,34,33,0,130
2018-02-11,2,DAL,19,36,20,22,0,97,HOU,27,30,30,17,0,104
2018-02-13,2,HOU,23,31,30,42,0,126,MIN,31,19,30,28,0,108
2018-02-14,1,SAC,25,20,18,28,0,91,HOU,20,35,17,28,0,100
2018-02-23,9,MIN,32,22,21,27,0,102,HOU,26,29,33,32,0,120
2018-02-25,2,HOU,38,28,26,27,0,119,DEN,25,27,27,35,0,114
2018-02-26,1,HOU,19,20,31,26,0,96,UTA,21,23,19,22,0,85
2018-02-28,2,HOU,34,27,22,22,0,105,LAC,12,31,29,20,0,92
2018-03-03,3,BOS,32,32,25,31,0,120,HOU,30,28,28,37,0,123
2018-03-06,3,HOU,26,28,33,35,0,122,OKC,24,21,29,38,0,112
2018-03-07,1,HOU,24,34,29,23,0,110,MIL,22,24,30,23,0,99
2018-03-09,2,HOU,16,27,32,30,0,105,TOR,32,26,25,25,0,108
2018-03-11,2,HOU,25,23,32,25,0,105,DAL,14,33,16,19,0,82
2018-03-12,1,SAS,21,22,24,26,0,93,HOU,25,29,34,21,0,109
2018-03-15,3,LAC,26,25,23,22,0,96,HOU,28,19,31,23,0,101
2018-03-17,2,HOU,32,28,24,23,0,107,NOP,29,25,18,29,0,101
2018-03-18,1,HOU,38,39,30,22,0,129,MIN,23,33,35,29,0,120
2018-03-20,2,HOU,27,28,31,29,0,115,POR,31,24,32,24,0,111
2018-03-22,2,DET,27,23,18,20,8,96,HOU,21,27,23,17,12,100
2018-03-24,2,NOP,16,21,24,30,0,91,HOU,29,35,19,31,0,114
2018-03-25,1,ATL,20,25,29,25,0,99,HOU,33,36,25,24,0,118
2018-03-27,2,CHI,23,16,18,29,0,86,HOU,31,29,27,31,0,118
2018-03-30,3,PHO,25,32,29,17,0,103,HOU,22,18,35,29,0,104
2018-04-01,2,HOU,17,21,28,17,0,83,SAS,26,20,29,25,0,100
2018-04-03,2,WAS,24,25,26,29,0,104,HOU,35,36,24,25,0,120
2018-04-05,2,POR,17,27,27,23,0,94,HOU,36,30,18,12,0,96
2018-04-07,2,OKC,36,25,19,28,0,108,HOU,30,32,21,19,0,102
2018-04-10,3,HOU,23,33,26,23,0,105,LAL,16,32,27,24,0,99
2018-04-11,1,HOU,22,22,19,20,0,83,SAC,28,24,27,17,0,96
2017-10-19,10,NYK,24,18,17,25,0,84,OKC,27,26,26,26,0,105
2017-10-21,2,OKC,14,20,23,30,0,87,UTA,21,23,29,23,0,96
2017-10-22,1,MIN,28,33,27,27,0,115,OKC,23,31,21,38,0,113
2017-10-25,3,IND,27,21,26,22,0,96,OKC,30,24,32,28,0,114
2017-10-27,2,OKC,33,26,30,27,0,116,MIN,26,33,31,29,0,119
2017-10-28,1,OKC,26,24,32,19,0,101,CHI,23,8,22,16,0,69
2017-10-31,3,OKC,31,29,25,25,0,110,MIL,23,19,22,27,0,91
2017-11-03,3,BOS,18,19,30,34,0,101,OKC,31,24,16,23,0,94
2017-11-05,2,OKC,20,26,21,32,0,99,POR,28,22,28,25,0,103
2017-11-07,2,OKC,25,16,16,29,0,86,SAC,10,32,25,27,0,94
2017-11-09,2,OKC,28,25,22,19,0,94,DEN,22,29,24,27,0,102
2017-11-10,1,LAC,31,24,31,25,0,111,OKC,30,33,31,26,0,120
2017-11-12,2,DAL,20,22,25,32,0,99,OKC,18,26,39,29,0,112
2017-11-15,3,CHI,7,27,22,23,0,79,OKC,27,31,19,15,0,92
2017-11-17,2,OKC,32,23,23,23,0,101,SAS,15,33,30,26,0,104
2017-11-20,3,OKC,33,32,21,21,0,107,NOP,24,33,30,27,0,114
2017-11-22,2,GSW,26,22,23,20,0,91,OKC,33,32,29,14,0,108
2017-11-24,2,DET,25,24,24,26,0,99,OKC,29,30,18,21,0,98
2017-11-25,1,OKC,24,13,18,26,0,81,DAL,25,27,26,19,0,97
2017-11-29,4,OKC,25,32,23,28,0,108,ORL,31,28,28,34,0,121
2017-12-01,2,MIN,33,21,25,28,0,107,OKC,42,22,21,26,0,111
2017-12-03,2,SAS,18,25,30,14,0,87,OKC,25,29,22,14,0,90
2017-12-05,2,UTA,28,19,33,14,0,94,OKC,19,20,29,32,0,100
2017-12-07,2,OKC,33,25,21,16,0,95,BRK,20,29,25,26,0,100
2017-12-09,2,OKC,19,27,21,25,10,102,MEM,34,23,9,26,9,101
2017-12-11,2,CHO,34,18,40,24,0,116,OKC,26,26,22,29,0,103
2017-12-13,2,OKC,22,29,22,27,0,100,IND,27,19,23,26,0,95
2017-12-15,2,OKC,28,27,26,13,8,119,PHI,23,24,30,17,8,117
2017-12-16,1,OKC,26,18,29,23,0,96,NYK,23,27,30,31,0,111
2017-12-18,2,DEN,18,26,32,18,0,94,OKC,32,20,18,25,0,95
2017-12-20,2,UTA,9,28,23,19,0,79,OKC,25,28,34,20,0,107
2017-12-22,2,ATL,28,22,31,36,0,117,OKC,28,36,18,38,0,120
2017-12-23,1,OKC,28,19,29,27,0,103,UTA,22,21,21,25,0,89
2017-12-25,2,HOU,31,26,31,19,0,107,OKC,28,30,30,24,0,112
2017-12-27,2,TOR,38,25,25,19,0,107,OKC,32,34,36,22,0,124
2017-12-29,2,MIL,38,20,15,24,0,97,OKC,18,26,23,28,0,95
2017-12-31,2,DAL,35,22,27,32,0,116,OKC,32,31,22,28,0,113
2018-01-03,3,OKC,26,37,33,37,0,133,LAL,26,18,26,26,0,96
2018-01-04,1,OKC,30,34,30,33,0,127,LAC,33,31,33,20,0,117
2018-01-07,3,OKC,23,30,29,18,0,100,PHO,28,34,28,24,0,114
2018-01-09,2,POR,24,30,34,29,0,117,OKC,26,24,26,30,0,106
2018-01-10,1,OKC,23,24,18,23,0,88,MIN,23,24,29,28,0,104
2018-01-13,3,OKC,31,24,18,28,0,101,CHO,28,31,17,15,0,91
2018-01-15,2,SAC,24,28,16,20,0,88,OKC,20,26,31,18,0,95
2018-01-17,2,LAL,25,29,18,18,0,90,OKC,33,27,33,21,0,114
2018-01-20,3,OKC,43,33,38,34,0,148,CLE,24,36,34,30,0,124
2018-01-23,3,BRK,26,33,26,23,0,108,OKC,30,17,27,35,0,109
2018-01-25,2,WAS,20,20,34,38,0,112,OKC,25,29,28,39,0,121
2018-01-27,2,OKC,36,33,29,23,0,121,DET,24,33,24,27,0,108
2018-01-28,1,PHI,29,29,25,29,0,112,OKC,31,26,35,30,0,122
2018-01-30,2,OKC,25,29,22,20,0,96,WAS,30,23,22,27,0,102
2018-02-01,2,OKC,33,24,32,35,0,124,DEN,40,32,32,23,0,127
2018-02-02,1,NOP,22,32,36,24,0,114,OKC,32,26,25,17,0,100
2018-02-04,2,LAL,25,26,31,26,0,108,OKC,22,27,30,25,0,104
2018-02-06,2,OKC,42,28,29,26,0,125,GSW,30,27,20,28,0,105
2018-02-08,2,OKC,27,19,20,15,0,81,LAL,30,22,31,23,0,106
2018-02-11,3,MEM,18,36,26,12,0,92,OKC,35,39,21,15,0,110
2018-02-13,2,CLE,29,33,29,29,0,120,OKC,28,29,30,25,0,112
2018-02-14,1,OKC,34,39,19,29,0,121,MEM,33,20,31,30,0,114
2018-02-22,8,OKC,44,23,18,25,0,110,SAC,21,39,30,17,0,107
2018-02-24,2,OKC,19,26,21,14,0,80,GSW,24,28,32,28,0,112
2018-02-26,2,ORL,38,24,15,28,0,105,OKC,31,30,23,28,0,112
2018-02-28,2,OKC,32,22,23,23,11,111,DAL,21,22,33,24,10,110
2018-03-02,2,OKC,32,28,37,27,0,124,PHO,37,30,32,17,0,116
2018-03-03,1,OKC,28,22,25,25,0,100,POR,25,28,30,25,0,108
2018-03-06,3,HOU,26,28,33,35,0,122,OKC,24,21,29,38,0,112
2018-03-08,2,PHO,23,15,29,20,0,87,OKC,26,23,39,27,0,115
2018-03-10,2,SAS,19,24,25,26,0,94,OKC,24,28,25,27,0,104
2018-03-12,2,SAC,16,24,39,22,0,101,OKC,19,27,32,28,0,106
2018-03-13,1,OKC,31,23,36,29,0,119,ATL,28,38,22,19,0,107
2018-03-16,3,LAC,30,26,28,29,0,113,OKC,27,36,26,32,0,121
2018-03-18,2,OKC,40,26,31,35,0,132,TOR,34,30,34,27,0,125
2018-03-20,2,OKC,26,22,27,24,0,99,BOS,18,27,28,27,0,100
2018-03-23,3,MIA,18,22,26,33,0,99,OKC,24,20,20,41,0,105
2018-03-25,2,POR,34,23,25,26,0,108,OKC,17,35,28,25,0,105
2018-03-29,4,OKC,29,27,25,18,0,99,SAS,24,35,18,26,0,103
2018-03-30,1,DEN,27,35,30,22,12,126,OKC,28,30,21,35,11,125
2018-04-01,2,OKC,20,33,27,29,0,109,NOP,28,22,25,29,0,104
2018-04-03,2,GSW,24,33,27,27,0,111,OKC,27,20,34,26,0,107
2018-04-07,4,OKC,36,25,19,28,0,108,HOU,30,32,21,19,0,102
2018-04-09,2,OKC,21,28,27,39,0,115,MIA,27,25,29,12,0,93
2018-04-11,2,MEM,28,29,39,27,0,123,OKC,38,39,28,32,0,137
2017-10-19,10,CHI,23,14,27,36,0,100,TOR,25,33,26,33,0,117
2017-10-21,2,PHI,19,30,22,23,0,94,TOR,36,26,40,26,0,128
2017-10-23,2,TOR,23,27,24,23,0,97,SAS,21,29,25,26,0,101
2017-10-25,2,TOR,26,27,33,26,0,112,GSW,29,32,30,26,0,117
2017-10-27,2,TOR,19,26,27,29,0,101,LAL,26,25,20,21,0,92
2017-10-30,3,TOR,29,25,27,18,0,99,POR,29,6,26,24,0,85
2017-11-01,2,TOR,19,27,25,40,0,111,DEN,34,26,43,26,0,129
2017-11-03,2,TOR,29,24,36,20,0,109,UTA,26,28,28,18,0,100
2017-11-05,2,WAS,32,30,22,23,0,107,TOR,17,29,30,20,0,96
2017-11-07,2,CHI,26,19,36,33,0,114,TOR,29,36,33,21,0,119
2017-11-09,2,NOP,32,28,32,26,0,118,TOR,34,32,26,30,0,122
2017-11-12,3,TOR,24,25,27,18,0,94,BOS,24,20,33,18,0,95
2017-11-14,2,TOR,31,45,27,26,0,129,HOU,33,31,30,19,0,113
2017-11-15,1,TOR,29,35,34,27,0,125,NOP,34,29,23,30,0,116
2017-11-17,2,NYK,18,18,28,20,0,84,TOR,30,24,24,29,0,107
2017-11-19,2,WAS,28,27,21,15,0,91,TOR,28,32,19,21,0,100
2017-11-22,3,TOR,34,25,10,31,0,100,NYK,26,22,41,19,0,108
2017-11-24,2,TOR,25,35,20,24,0,104,IND,29,21,31,26,0,107
2017-11-25,1,TOR,28,39,32,13,0,112,ATL,25,14,19,20,0,78
2017-11-29,4,CHO,25,27,33,28,0,113,TOR,32,39,22,33,0,126
2017-12-01,2,IND,32,26,31,26,0,115,TOR,27,38,29,26,0,120
2017-12-05,4,PHO,23,23,33,34,0,113,TOR,36,19,42,29,0,126
2017-12-08,3,TOR,25,32,35,24,0,116,MEM,34,28,31,14,0,107
2017-12-10,2,TOR,22,32,25,23,0,102,SAC,17,29,21,20,0,87
2017-12-11,1,TOR,30,23,21,17,0,91,LAC,19,32,19,26,0,96
2017-12-13,2,TOR,37,21,34,23,0,115,PHO,31,21,27,30,0,109
2017-12-15,2,BRK,20,24,20,23,0,87,TOR,30,28,33,29,0,120
2017-12-17,2,SAC,30,33,14,16,0,93,TOR,35,26,22,25,0,108
2017-12-20,3,TOR,22,41,36,30,0,129,CHO,26,21,32,32,0,111
2017-12-21,1,TOR,30,22,34,28,0,114,PHI,31,34,23,21,0,109
2017-12-23,2,PHI,27,19,17,23,0,86,TOR,27,28,26,21,0,102
2017-12-26,3,TOR,23,30,24,16,0,93,DAL,31,26,28,13,0,98
2017-12-27,1,TOR,38,25,25,19,0,107,OKC,32,34,36,22,0,124
2017-12-29,2,ATL,22,25,22,29,0,98,TOR,30,32,26,23,0,111
2018-01-01,3,MIL,30,26,28,30,13,127,TOR,35,25,28,26,17,131
2018-01-03,2,TOR,21,35,34,34,0,124,CHI,31,28,31,25,0,115
2018-01-05,2,TOR,33,28,43,25,0,129,MIL,24,35,19,32,0,110
2018-01-08,3,TOR,26,19,33,29,7,114,BRK,19,25,27,36,6,113
2018-01-09,1,MIA,22,29,21,18,0,90,TOR,21,20,23,25,0,89
2018-01-11,2,CLE,24,16,32,27,0,99,TOR,30,35,35,33,0,133
2018-01-13,2,GSW,43,38,27,19,0,127,TOR,35,19,35,36,0,125
2018-01-15,2,TOR,23,26,26,36,0,111,PHI,32,27,34,24,0,117
2018-01-17,2,DET,18,33,22,18,0,91,TOR,31,23,19,23,0,96
2018-01-19,2,SAS,18,19,23,23,0,83,TOR,17,27,19,23,0,86
2018-01-20,1,TOR,28,34,21,26,0,109,MIN,26,28,33,28,0,115
2018-01-24,4,TOR,28,30,27,23,0,108,ATL,16,24,25,28,0,93
2018-01-26,2,UTA,30,15,30,22,0,97,TOR,24,24,21,24,0,93
2018-01-28,2,LAL,21,28,28,34,0,111,TOR,28,31,32,32,0,123
2018-01-30,2,MIN,27,30,23,24,0,104,TOR,19,32,27,31,0,109
2018-02-01,2,TOR,34,28,25,32,0,119,WAS,27,28,33,34,0,122
2018-02-02,1,POR,18,34,28,25,0,105,TOR,37,37,27,29,0,130
2018-02-04,2,MEM,24,20,30,12,0,86,TOR,25,31,20,25,0,101
2018-02-06,2,BOS,18,19,23,31,0,91,TOR,22,36,25,28,0,111
2018-02-08,2,NYK,18,23,25,22,0,88,TOR,23,29,30,31,0,113
2018-02-11,3,TOR,30,32,28,33,0,123,CHO,26,29,19,29,0,103
2018-02-13,2,MIA,24,31,26,31,0,112,TOR,28,29,41,17,0,115
2018-02-14,1,TOR,27,34,34,27,0,122,CHI,33,16,27,22,0,98
2018-02-23,9,MIL,23,42,31,14,12,122,TOR,29,28,31,22,9,119
2018-02-26,3,DET,26,27,22,19,0,94,TOR,30,29,34,30,0,123
2018-02-28,2,TOR,42,27,21,27,0,117,ORL,37,26,26,15,0,104
2018-03-02,2,TOR,19,32,26,25,0,102,WAS,27,20,27,21,0,95
2018-03-04,2,CHO,21,22,26,29,0,98,TOR,26,26,30,21,0,103
2018-03-06,2,ATL,28,23,26,13,0,90,TOR,27,23,26,30,0,106
2018-03-07,1,TOR,27,18,40,29,7,121,DET,23,36,25,30,5,119
2018-03-09,2,HOU,16,27,32,30,0,105,TOR,32,26,25,25,0,108
2018-03-11,2,TOR,32,33,37,30,0,132,NYK,27,30,29,20,0,106
2018-03-13,2,TOR,32,25,30,29,0,116,BRK,40,27,18,17,0,102
2018-03-15,2,TOR,25,24,28,29,0,106,IND,27,30,22,20,0,99
2018-03-16,1,DAL,27,33,24,22,9,115,TOR,29,25,24,28,16,122
2018-03-18,2,OKC,40,26,31,35,0,132,TOR,34,30,34,27,0,125
2018-03-20,2,TOR,24,28,16,25,0,93,ORL,25,26,25,10,0,86
2018-03-21,1,TOR,38,41,20,30,0,129,CLE,42,22,34,34,0,132
2018-03-23,2,BRK,32,32,27,21,0,112,TOR,31,28,25,32,0,116
2018-03-25,2,LAC,28,25,27,37,0,117,TOR,35,25,20,26,0,106
2018-03-27,2,DEN,23,35,27,25,0,110,TOR,25,33,24,32,0,114
2018-03-31,4,TOR,33,22,29,15,0,99,BOS,31,22,29,28,0,110
2018-04-03,3,TOR,24,28,26,28,0,106,CLE,28,32,26,26,0,112
2018-04-04,1,BOS,20,13,20,25,0,78,TOR,14,29,24,29,0,96
2018-04-06,2,IND,14,19,16,24,0,73,TOR,26,19,27,20,0,92
2018-04-08,2,ORL,24,26,24,27,0,101,TOR,35,26,28,23,0,112
2018-04-09,1,TOR,32,25,28,23,0,108,DET,32,28,20,18,0,98
2018-04-11,2,TOR,29,24,25,27,4,109,MIA,27,20,24,34,11,116
2017-10-18,10,MIA,37,18,23,31,0,109,ORL,32,26,30,28,0,116
2017-10-20,2,ORL,27,28,36,30,0,121,BRK,29,29,31,37,0,126
2017-10-21,1,ORL,36,20,32,26,0,114,CLE,18,27,20,28,0,93
2017-10-24,3,BRK,30,31,35,25,0,121,ORL,30,31,26,38,0,125
2017-10-27,3,SAS,18,16,30,23,0,87,ORL,32,29,34,19,0,114
2017-10-29,2,ORL,24,25,37,27,0,113,CHO,27,34,32,27,0,120
2017-10-30,1,ORL,33,27,27,28,0,115,NOP,24,40,20,15,0,99
2017-11-01,2,ORL,23,31,27,20,0,101,MEM,26,28,21,24,0,99
2017-11-03,2,CHI,28,16,29,32,0,105,ORL,26,19,15,23,0,83
2017-11-05,2,BOS,22,27,28,27,0,104,ORL,20,18,31,19,0,88
2017-11-08,3,NYK,28,22,26,23,0,99,ORL,27,27,30,28,0,112
2017-11-10,2,ORL,36,28,33,31,0,128,PHO,32,31,20,29,0,112
2017-11-11,1,ORL,23,24,30,30,0,107,DEN,39,31,28,27,0,125
2017-11-13,2,ORL,29,27,19,25,0,100,GSW,27,29,32,22,0,110
2017-11-15,2,ORL,33,14,24,23,0,94,POR,24,27,24,24,0,99
2017-11-18,3,UTA,29,34,34,28,0,125,ORL,26,22,19,18,0,85
2017-11-20,2,IND,34,16,28,27,0,105,ORL,31,24,17,25,0,97
2017-11-22,2,ORL,35,27,18,38,0,118,MIN,30,35,41,18,0,124
2017-11-24,2,ORL,26,21,22,34,0,103,BOS,40,33,26,19,0,118
2017-11-25,1,ORL,28,27,30,26,0,111,PHI,31,39,31,29,0,130
2017-11-27,2,ORL,25,25,34,25,0,109,IND,33,24,28,36,0,121
2017-11-29,2,OKC,25,32,23,28,0,108,ORL,31,28,28,34,0,121
2017-12-01,2,GSW,41,37,24,31,0,133,ORL,34,29,28,21,0,112
2017-12-03,2,ORL,36,18,24,27,0,105,NYK,25,26,25,24,0,100
2017-12-04,1,ORL,23,22,29,20,0,94,CHO,26,28,21,29,0,104
2017-12-06,2,ATL,23,29,27,17,10,106,ORL,31,13,30,22,14,110
2017-12-08,2,DEN,14,35,32,22,0,103,ORL,25,23,22,19,0,89
2017-12-09,1,ORL,22,32,33,23,0,110,ATL,32,25,32,28,0,117
2017-12-13,4,LAC,13,32,29,32,0,106,ORL,24,16,28,27,0,95
2017-12-15,2,POR,24,26,25,20,0,95,ORL,20,23,23,22,0,88
2017-12-17,2,ORL,23,20,36,31,0,110,DET,36,24,36,18,0,114
2017-12-20,3,ORL,24,24,18,28,0,94,CHI,31,28,31,22,0,112
2017-12-22,2,NOP,32,28,28,23,0,111,ORL,20,30,22,25,0,97
2017-12-23,1,ORL,29,19,35,20,0,103,WAS,37,35,28,30,0,130
2017-12-26,3,ORL,18,31,19,21,0,89,MIA,21,22,25,39,0,107
2017-12-28,2,DET,28,22,23,16,0,89,ORL,33,17,27,25,0,102
2017-12-30,2,MIA,21,29,36,31,0,117,ORL,32,34,26,19,0,111
2018-01-01,2,ORL,27,21,22,25,0,95,BRK,22,25,24,27,0,98
2018-01-03,2,HOU,25,30,34,27,0,116,ORL,12,29,25,32,0,98
2018-01-06,3,CLE,31,36,40,24,0,131,ORL,30,34,23,40,0,127
2018-01-09,3,ORL,19,29,27,24,0,99,DAL,25,18,39,32,0,114
2018-01-10,1,ORL,29,17,23,34,0,103,MIL,30,23,36,21,0,110
2018-01-12,2,ORL,33,30,35,21,0,119,WAS,34,31,33,27,0,125
2018-01-16,4,MIN,25,23,27,27,0,102,ORL,25,22,26,35,0,108
2018-01-18,2,ORL,20,27,33,23,0,103,CLE,36,31,17,20,0,104
2018-01-21,3,ORL,28,30,32,13,0,103,BOS,29,30,12,24,0,95
2018-01-23,2,SAC,28,24,25,28,0,105,ORL,27,26,29,17,0,99
2018-01-27,4,ORL,32,38,22,20,0,112,IND,22,31,31,30,0,114
2018-01-30,3,ORL,30,25,33,19,0,107,HOU,27,27,36,24,0,114
2018-01-31,1,LAL,25,26,30,24,0,105,ORL,29,29,43,26,0,127
2018-02-03,3,WAS,31,25,31,28,0,115,ORL,25,22,22,29,0,98
2018-02-05,2,ORL,26,33,34,18,0,111,MIA,35,25,27,22,0,109
2018-02-06,1,CLE,43,24,22,9,0,98,ORL,31,20,41,24,0,116
2018-02-08,2,ATL,23,16,31,28,0,98,ORL,26,13,30,31,0,100
2018-02-10,2,MIL,24,26,28,33,0,111,ORL,29,25,20,30,0,104
2018-02-12,2,ORL,27,24,20,30,0,101,CHI,30,23,24,28,0,105
2018-02-14,2,CHO,20,34,31,19,0,104,ORL,26,27,25,24,0,102
2018-02-22,8,NYK,31,32,30,27,0,120,ORL,41,28,21,23,0,113
2018-02-24,2,ORL,18,22,31,34,0,105,PHI,27,31,29,29,0,116
2018-02-26,2,ORL,38,24,15,28,0,105,OKC,31,30,23,28,0,112
2018-02-28,2,TOR,42,27,21,27,0,117,ORL,37,26,26,15,0,104
2018-03-02,2,DET,29,23,30,22,2,106,ORL,31,22,29,22,11,115
2018-03-03,1,MEM,27,25,27,21,0,100,ORL,31,21,25,30,0,107
2018-03-05,2,ORL,29,15,23,13,0,80,UTA,25,29,20,20,0,94
2018-03-07,2,ORL,32,19,28,28,0,107,LAL,23,33,25,27,0,108
2018-03-09,2,ORL,14,22,26,26,0,88,SAC,22,19,33,20,0,94
2018-03-10,1,ORL,27,31,31,16,0,105,LAC,30,26,31,26,0,113
2018-03-13,3,ORL,18,19,20,15,0,72,SAS,24,38,34,12,0,108
2018-03-14,1,MIL,20,32,28,37,0,117,ORL,36,25,30,35,0,126
2018-03-16,2,BOS,25,23,27,17,0,92,ORL,16,15,21,31,0,83
2018-03-20,4,TOR,24,28,16,25,0,93,ORL,25,26,25,10,0,86
2018-03-22,2,PHI,32,38,25,23,0,118,ORL,23,26,16,33,0,98
2018-03-24,2,PHO,23,23,28,25,0,99,ORL,26,12,39,28,0,105
2018-03-28,4,BRK,36,22,27,26,0,111,ORL,33,18,30,23,0,104
2018-03-30,2,CHI,30,27,9,24,0,90,ORL,24,20,25,13,0,82
2018-04-01,2,ORL,18,25,21,24,0,88,ATL,21,35,13,25,0,94
2018-04-03,2,ORL,27,19,22,29,0,97,NYK,25,20,16,12,0,73
2018-04-04,1,DAL,22,29,23,26,0,100,ORL,33,23,21,28,0,105
2018-04-06,2,CHO,43,29,31,34,0,137,ORL,25,24,26,25,0,100
2018-04-08,2,ORL,24,26,24,27,0,101,TOR,35,26,28,23,0,112
2018-04-09,1,ORL,21,21,25,19,0,86,MIL,31,14,29,28,0,102
2018-04-11,2,WAS,23,22,30,17,0,92,ORL,26,29,21,25,0,101
