date,rest_days,away_team,away_q1,away_q2,away_q3,away_q4,away_OT,away_final,home_team,home_q1,home_q2,home_q3,home_q4,home_OT,home_final
2018-10-17,10,CLE,25,22,28,29,0,104,TOR,28,32,30,26,0,116
2018-10-19,2,CLE,30,24,41,28,0,123,MIN,32,39,33,27,0,131
2018-10-21,2,ATL,24,40,28,41,0,133,CLE,34,26,26,25,0,111
2018-10-24,3,BRK,24,21,38,19,0,102,CLE,17,28,17,24,0,86
2018-10-25,1,CLE,27,23,18,35,0,103,DET,30,28,22,30,0,110
2018-10-27,2,IND,30,30,28,31,0,119,CLE,30,25,28,24,0,107
2018-10-30,3,ATL,31,26,30,27,0,114,CLE,35,23,41,37,0,136
2018-11-01,2,DEN,15,35,33,27,0,110,CLE,27,15,24,25,0,91
2018-11-03,2,CLE,22,30,21,21,0,94,CHO,30,29,34,33,0,126
2018-11-05,2,CLE,21,26,32,21,0,100,ORL,30,28,12,32,0,102
2018-11-07,2,OKC,23,25,23,24,0,95,CLE,20,20,24,22,0,86
2018-11-10,3,CLE,23,30,24,21,0,98,CHI,37,16,26,20,0,99
2018-11-13,3,CHO,23,28,18,20,0,89,CLE,38,29,21,25,0,113
2018-11-14,1,CLE,29,23,22,21,0,95,WAS,41,32,23,23,0,119
2018-11-19,5,CLE,27,19,23,33,0,102,DET,38,28,27,20,0,113
2018-11-21,2,LAL,24,25,32,28,0,109,CLE,28,24,29,24,0,105
2018-11-23,2,CLE,31,23,30,37,0,121,PHI,23,31,29,29,0,112
2018-11-24,1,HOU,30,28,25,25,0,108,CLE,29,34,30,24,0,117
2018-11-26,2,MIN,29,25,21,27,0,102,CLE,26,21,24,24,0,95
2018-11-28,2,CLE,28,19,15,21,0,83,OKC,21,26,26,27,0,100
2018-11-30,2,CLE,26,26,20,23,0,95,BOS,30,32,39,27,0,128
2018-12-01,1,TOR,21,26,30,29,0,106,CLE,21,19,27,28,0,95
2018-12-03,2,CLE,30,26,24,19,0,99,BRK,29,21,26,21,0,97
2018-12-05,2,GSW,31,27,37,34,0,129,CLE,25,39,22,19,0,105
2018-12-07,2,SAC,38,28,30,33,0,129,CLE,27,39,23,21,0,110
2018-12-08,1,WAS,25,21,20,35,0,101,CLE,38,24,25,29,0,116
2018-12-10,2,CLE,18,23,25,26,0,92,MIL,31,28,25,24,0,108
2018-12-12,2,NYK,23,31,32,20,0,106,CLE,39,26,21,27,0,113
2018-12-14,2,MIL,27,34,30,23,0,114,CLE,16,31,30,25,0,102
2018-12-16,2,PHI,29,36,24,39,0,128,CLE,36,22,27,20,0,105
2018-12-18,2,CLE,21,24,22,25,0,92,IND,19,25,24,23,0,91
2018-12-19,1,CLE,25,21,29,24,0,99,CHO,16,25,41,28,0,110
2018-12-21,2,CLE,28,24,41,17,0,110,TOR,34,25,40,27,0,126
2018-12-23,2,CHI,28,26,30,28,0,112,CLE,29,30,15,18,0,92
2018-12-26,3,CLE,9,23,21,34,0,87,MEM,21,24,20,30,0,95
2018-12-28,2,CLE,30,22,17,25,0,94,MIA,29,27,26,36,0,118
2018-12-29,1,CLE,26,25,23,34,0,108,ATL,23,34,27,27,0,111
2019-01-02,4,MIA,22,36,35,24,0,117,CLE,23,20,30,19,0,92
2019-01-04,2,UTA,23,25,33,36,0,117,CLE,20,29,22,20,0,91
2019-01-05,1,NOP,28,33,37,35,0,133,CLE,26,26,20,26,0,98
2019-01-08,3,IND,38,25,29,31,0,123,CLE,16,27,36,36,0,115
2019-01-09,1,CLE,38,25,28,33,0,124,NOP,25,34,41,40,0,140
2019-01-11,2,CLE,22,27,32,32,0,113,HOU,42,35,36,28,0,141
2019-01-13,2,CLE,32,19,24,26,0,101,LAL,24,22,19,30,0,95
2019-01-16,3,CLE,26,29,30,27,0,112,POR,30,32,38,29,0,129
2019-01-18,2,CLE,20,17,23,39,0,99,UTA,29,32,32,22,0,115
2019-01-19,1,CLE,25,21,30,26,0,102,DEN,37,33,31,23,0,124
2019-01-21,2,CHI,31,17,28,28,0,104,CLE,18,24,25,21,0,88
2019-01-23,2,CLE,30,20,30,23,0,103,BOS,27,38,27,31,0,123
2019-01-25,2,MIA,27,21,32,20,0,100,CLE,23,30,17,24,0,94
2019-01-27,2,CLE,27,24,28,25,0,104,CHI,29,24,26,22,0,101
2019-01-29,2,WAS,24,23,22,44,0,113,CLE,26,27,35,28,0,116
2019-02-02,4,DAL,40,18,28,25,0,111,CLE,31,24,25,18,0,98
2019-02-05,3,BOS,28,31,26,18,0,103,CLE,30,21,28,17,0,96
2019-02-08,3,CLE,27,25,34,20,0,106,WAS,41,25,26,27,0,119
2019-02-09,1,CLE,17,25,18,30,0,90,IND,30,24,20,31,0,105
2019-02-11,2,NYK,22,26,31,25,0,104,CLE,30,33,26,18,0,107
2019-02-13,2,BRK,30,25,29,25,9,148,CLE,29,29,26,25,9,139
2019-02-21,8,PHO,28,23,21,26,0,98,CLE,23,32,22,34,0,111
2019-02-23,2,MEM,24,32,28,23,0,107,CLE,37,26,19,30,0,112
2019-02-25,2,POR,29,42,17,35,0,123,CLE,18,30,36,26,0,110
2019-02-28,3,CLE,27,30,28,40,0,125,NYK,31,28,38,21,0,118
2019-03-02,2,DET,42,29,29,29,0,129,CLE,23,15,34,21,0,93
2019-03-03,1,ORL,24,24,24,21,0,93,CLE,29,23,15,40,0,107
2019-03-06,3,CLE,20,30,35,22,0,107,BRK,31,24,25,33,0,113
2019-03-08,2,CLE,29,28,26,27,0,110,MIA,28,29,37,32,0,126
2019-03-11,3,TOR,24,31,22,24,0,101,CLE,25,34,32,35,0,126
2019-03-12,1,CLE,12,35,30,22,0,99,PHI,24,29,28,25,0,106
2019-03-14,2,CLE,20,21,22,28,0,91,ORL,36,25,27,32,0,120
2019-03-16,2,CLE,26,31,31,28,0,116,DAL,34,32,34,21,0,121
2019-03-18,2,DET,32,29,27,31,0,119,CLE,25,35,27,39,0,126
2019-03-20,2,MIL,24,23,34,21,0,102,CLE,30,28,23,26,0,107
2019-03-22,2,LAC,25,33,34,18,0,110,CLE,40,20,23,25,0,108
2019-03-24,2,CLE,27,28,22,28,0,105,MIL,32,36,22,37,0,127
2019-03-26,2,BOS,32,25,31,28,0,116,CLE,27,24,30,25,0,106
2019-03-28,2,CLE,28,25,28,29,0,110,SAS,27,17,40,32,0,116
2019-03-30,2,CLE,29,23,31,25,0,108,LAC,29,36,28,39,0,132
2019-04-01,2,CLE,23,29,32,29,0,113,PHO,31,40,20,31,0,122
2019-04-04,3,CLE,22,29,33,20,0,104,SAC,29,28,36,24,0,117
2019-04-05,1,CLE,26,23,35,30,0,114,GSW,36,32,31,21,0,120
2019-04-07,2,SAS,24,38,17,33,0,112,CLE,24,22,17,27,0,90
2019-04-09,2,CHO,33,31,26,34,0,124,CLE,31,25,19,22,0,97
2018-10-16,10,PHI,21,21,24,21,0,87,BOS,21,26,30,28,0,105
2018-10-19,3,BOS,25,28,26,22,0,101,TOR,18,31,33,31,0,113
2018-10-20,1,BOS,31,19,27,26,0,103,NYK,18,30,22,31,0,101
2018-10-22,2,ORL,28,20,27,18,0,93,BOS,19,26,25,20,0,90
2018-10-25,3,BOS,16,18,40,27,0,101,OKC,22,28,23,22,0,95
2018-10-27,2,BOS,30,33,21,25,0,109,DET,21,20,26,22,0,89
2018-10-30,3,DET,28,30,13,34,0,105,BOS,31,25,25,27,0,108
2018-11-01,2,MIL,16,37,25,35,0,113,BOS,23,32,38,24,0,117
2018-11-03,2,BOS,28,17,27,29,0,101,IND,18,27,27,30,0,102
2018-11-05,2,BOS,34,22,25,26,0,107,DEN,19,35,34,27,0,115
2018-11-08,3,BOS,13,22,30,35,16,116,PHO,32,23,25,20,9,109
2018-11-09,1,BOS,25,26,29,35,0,115,UTA,27,31,35,30,0,123
2018-11-11,2,BOS,21,16,33,24,0,94,POR,26,28,29,17,0,100
2018-11-14,3,CHI,24,11,24,23,0,82,BOS,19,32,26,34,0,111
2018-11-16,2,TOR,27,25,30,25,9,116,BOS,30,24,24,29,16,123
2018-11-17,1,UTA,29,21,27,21,0,98,BOS,20,25,17,24,0,86
2018-11-19,2,BOS,24,32,31,25,0,112,CHO,29,25,30,33,0,117
2018-11-21,2,NYK,26,39,19,33,0,117,BOS,18,31,20,40,0,109
2018-11-23,2,BOS,45,16,21,32,0,114,ATL,23,22,19,32,0,96
2018-11-24,1,BOS,26,30,26,22,0,104,DAL,32,27,28,26,0,113
2018-11-26,2,BOS,34,23,32,35,0,124,NOP,21,27,31,28,0,107
2018-11-30,4,CLE,26,26,20,23,0,95,BOS,30,32,39,27,0,128
2018-12-01,1,BOS,29,28,27,34,0,118,MIN,26,22,29,32,0,109
2018-12-06,5,NYK,30,28,26,16,0,100,BOS,38,31,30,29,0,128
2018-12-08,2,BOS,35,29,29,40,0,133,CHI,17,26,17,17,0,77
2018-12-10,2,NOP,21,32,19,28,0,100,BOS,28,31,24,30,0,113
2018-12-12,2,BOS,24,22,38,29,17,130,WAS,28,27,22,36,12,125
2018-12-14,2,ATL,19,37,26,26,0,108,BOS,42,25,41,21,0,129
2018-12-15,1,BOS,33,23,22,26,0,104,DET,33,24,28,28,0,113
2018-12-19,4,PHO,26,33,27,25,0,111,BOS,37,25,18,23,0,103
2018-12-21,2,MIL,35,30,28,27,0,120,BOS,22,26,30,29,0,107
2018-12-23,2,CHO,26,21,20,36,0,103,BOS,29,39,26,25,0,119
2018-12-25,2,PHI,25,26,38,19,6,114,BOS,32,25,29,22,13,121
2018-12-27,2,BOS,24,31,31,27,0,113,HOU,35,22,35,35,0,127
2018-12-29,2,BOS,29,18,32,33,0,112,MEM,26,38,23,16,0,103
2018-12-31,2,BOS,23,29,30,29,0,111,SAS,17,29,46,28,0,120
2019-01-02,2,MIN,21,21,39,21,0,102,BOS,25,35,27,28,0,115
2019-01-04,2,DAL,23,28,17,25,0,93,BOS,34,24,26,30,0,114
2019-01-07,3,BRK,22,23,29,21,0,95,BOS,34,22,30,30,0,116
2019-01-09,2,IND,23,30,27,28,0,108,BOS,29,39,37,30,0,135
2019-01-10,1,BOS,24,19,29,27,0,99,MIA,28,33,22,32,0,115
2019-01-12,2,BOS,19,32,26,26,0,103,ORL,19,22,31,33,0,105
2019-01-14,2,BOS,25,20,21,36,0,102,BRK,27,19,44,19,0,109
2019-01-16,2,TOR,36,17,30,25,0,108,BOS,30,34,23,30,0,117
2019-01-18,2,MEM,24,38,29,25,0,116,BOS,35,23,38,26,0,122
2019-01-19,1,BOS,28,32,23,30,0,113,ATL,36,31,22,16,0,105
2019-01-21,2,MIA,23,27,18,31,0,99,BOS,33,17,37,20,0,107
2019-01-23,2,CLE,30,20,30,23,0,103,BOS,27,38,27,31,0,123
2019-01-26,3,GSW,29,32,29,25,0,115,BOS,26,33,25,27,0,111
2019-01-28,2,BRK,26,24,38,16,0,104,BOS,32,28,29,23,0,112
2019-01-30,2,CHO,28,31,16,19,0,94,BOS,35,28,35,28,0,126
2019-02-01,2,BOS,25,31,24,33,0,113,NYK,20,27,26,26,0,99
2019-02-03,2,OKC,29,29,35,36,0,129,BOS,31,35,33,35,0,134
2019-02-05,2,BOS,28,31,26,18,0,103,CLE,30,21,28,17,0,96
2019-02-07,2,LAL,24,33,42,30,0,129,BOS,30,36,27,35,0,128
2019-02-09,2,LAC,20,33,28,42,0,123,BOS,43,31,12,26,0,112
2019-02-12,3,BOS,28,24,25,35,0,112,PHI,23,23,28,35,0,109
2019-02-13,1,DET,29,23,20,38,0,110,BOS,28,29,34,27,0,118
2019-02-21,8,BOS,22,25,21,29,0,97,MIL,20,33,19,26,0,98
2019-02-23,2,BOS,33,18,30,35,0,116,CHI,28,36,30,32,0,126
2019-02-26,3,BOS,32,13,23,27,0,95,TOR,30,36,29,23,0,118
2019-02-27,1,POR,25,18,31,23,0,97,BOS,24,18,22,28,0,92
2019-03-01,2,WAS,20,25,36,15,0,96,BOS,30,19,33,25,0,107
2019-03-03,2,HOU,33,32,35,15,0,115,BOS,23,20,35,26,0,104
2019-03-05,2,BOS,32,41,32,23,0,128,GSW,24,24,28,19,0,95
2019-03-06,1,BOS,26,23,33,29,0,111,SAC,32,17,28,32,0,109
2019-03-09,3,BOS,25,32,36,27,0,120,LAL,24,23,29,31,0,107
2019-03-11,2,BOS,19,30,36,30,0,115,LAC,25,37,39,39,0,140
2019-03-14,3,SAC,38,24,29,29,0,120,BOS,25,31,37,33,0,126
2019-03-16,2,ATL,36,26,30,28,0,120,BOS,43,31,31,24,0,129
2019-03-18,2,DEN,24,31,25,34,0,114,BOS,22,30,28,25,0,105
2019-03-20,2,BOS,39,30,21,25,0,115,PHI,30,28,27,33,0,118
2019-03-23,3,BOS,35,29,34,19,0,117,CHO,29,34,26,35,0,124
2019-03-24,1,SAS,31,23,30,31,0,115,BOS,24,23,25,24,0,96
2019-03-26,2,BOS,32,25,31,28,0,116,CLE,27,24,30,25,0,106
2019-03-29,3,IND,25,35,31,21,0,112,BOS,35,28,26,25,0,114
2019-03-30,1,BOS,21,27,22,26,0,96,BRK,17,32,33,28,0,110
2019-04-01,2,MIA,17,30,30,28,0,105,BOS,36,25,27,22,0,110
2019-04-03,2,BOS,29,24,30,29,0,112,MIA,31,18,32,21,0,102
2019-04-05,2,BOS,24,34,33,26,0,117,IND,27,20,27,23,0,97
2019-04-07,2,ORL,27,21,35,33,0,116,BOS,27,25,26,30,0,108
2019-04-09,2,BOS,25,38,26,27,0,116,WAS,39,25,31,15,0,110
2018-10-18,10,MIA,24,34,27,28,0,113,WAS,25,34,30,23,0,112
2018-10-20,2,TOR,24,33,33,27,0,117,WAS,22,32,28,31,0,113
2018-10-22,2,WAS,28,34,16,33,14,125,POR,32,30,15,34,13,124
2018-10-24,2,WAS,37,34,26,25,0,122,GSW,46,34,35,29,0,144
2018-10-26,2,WAS,27,34,24,27,0,112,SAC,28,27,24,37,0,116
2018-10-28,2,WAS,20,34,23,27,0,104,LAC,28,41,28,39,0,136
2018-10-30,2,WAS,24,21,27,23,0,95,MEM,22,24,32,29,0,107
2018-11-02,3,OKC,35,44,31,24,0,134,WAS,30,20,35,26,0,111
2018-11-04,2,NYK,17,33,28,17,0,95,WAS,24,34,23,27,0,108
2018-11-06,2,WAS,24,25,29,22,0,100,DAL,35,35,17,32,0,119
2018-11-09,3,WAS,25,23,26,34,0,108,ORL,32,31,26,28,0,117
2018-11-10,1,WAS,25,33,25,33,0,116,MIA,35,26,24,25,0,110
2018-11-12,2,ORL,30,25,28,26,0,109,WAS,30,25,28,34,0,117
2018-11-14,2,CLE,29,23,22,21,0,95,WAS,41,32,23,23,0,119
2018-11-16,2,BRK,26,30,35,24,0,115,WAS,30,24,25,25,0,104
2018-11-18,2,POR,32,30,29,28,0,119,WAS,25,16,29,39,0,109
2018-11-20,2,LAC,40,33,22,23,0,118,WAS,21,33,32,39,0,125
2018-11-23,3,WAS,26,36,25,20,0,107,TOR,38,32,31,24,0,125
2018-11-24,1,NOP,34,34,23,23,0,114,WAS,37,31,22,34,0,124
2018-11-26,2,HOU,42,23,33,27,6,131,WAS,30,37,27,31,10,135
2018-11-28,2,WAS,24,23,34,23,0,104,NOP,31,36,31,27,0,125
2018-11-30,2,WAS,19,27,24,28,0,98,PHI,31,37,30,25,0,123
2018-12-01,1,BRK,19,20,19,30,0,88,WAS,24,18,26,34,0,102
2018-12-03,2,WAS,26,26,34,24,0,110,NYK,32,29,19,27,0,107
2018-12-05,2,WAS,33,39,31,28,0,131,ATL,25,24,45,23,0,117
2018-12-08,3,WAS,25,21,20,35,0,101,CLE,38,24,25,29,0,116
2018-12-10,2,WAS,33,17,25,26,0,101,IND,29,30,28,22,0,109
2018-12-12,2,BOS,24,22,38,29,17,130,WAS,28,27,22,36,12,125
2018-12-14,2,WAS,31,28,26,33,0,118,BRK,27,43,31,24,0,125
2018-12-16,2,LAL,23,28,25,34,0,110,WAS,33,38,28,29,0,128
2018-12-18,2,WAS,24,30,28,28,0,110,ATL,35,23,24,36,0,118
2018-12-19,1,WAS,28,30,32,28,0,118,HOU,34,36,31,35,0,136
2018-12-22,3,PHO,29,26,24,30,13,146,WAS,33,22,28,26,13,149
2018-12-23,1,WAS,25,21,18,25,0,89,IND,27,26,31,21,0,105
2018-12-26,3,WAS,28,27,17,23,0,95,DET,27,27,31,21,0,106
2018-12-28,2,CHI,20,20,34,27,0,101,WAS,22,20,30,20,0,92
2018-12-29,1,CHO,29,32,31,34,0,126,WAS,27,40,27,36,0,130
2019-01-02,4,ATL,29,24,31,14,0,98,WAS,35,29,24,26,0,114
2019-01-04,2,WAS,24,34,28,23,0,109,MIA,31,30,34,20,0,115
2019-01-06,2,WAS,28,26,36,26,0,116,OKC,25,25,29,19,0,98
2019-01-08,2,WAS,29,16,33,37,0,115,PHI,32,36,36,28,0,132
2019-01-09,1,PHI,20,28,27,31,0,106,WAS,25,38,29,31,0,123
2019-01-11,2,MIL,26,21,35,24,0,106,WAS,40,17,28,28,0,113
2019-01-13,2,TOR,36,25,37,26,7,140,WAS,21,29,34,40,7,138
2019-01-17,4,NYK,30,33,26,11,0,100,WAS,20,33,24,24,0,101
2019-01-21,4,DET,17,17,30,23,0,87,WAS,29,21,31,20,0,101
2019-01-24,3,GSW,37,30,37,22,0,126,WAS,28,31,33,26,0,118
2019-01-25,1,WAS,24,26,25,20,0,95,ORL,21,17,31,22,0,91
2019-01-27,2,WAS,26,43,17,33,0,119,SAS,36,34,29,33,0,132
2019-01-29,2,WAS,24,23,22,44,0,113,CLE,26,27,35,28,0,116
2019-01-30,1,IND,25,20,24,20,0,89,WAS,35,24,23,25,0,107
2019-02-02,3,MIL,38,35,27,31,0,131,WAS,26,24,34,31,0,115
2019-02-04,2,ATL,35,26,38,38,0,137,WAS,20,37,32,40,0,129
2019-02-06,2,WAS,35,30,42,22,0,129,MIL,50,35,35,28,0,148
2019-02-08,2,CLE,27,25,34,20,0,106,WAS,41,25,26,27,0,119
2019-02-09,1,WAS,34,42,30,28,0,134,CHI,32,29,35,29,0,125
2019-02-11,2,WAS,27,32,20,33,0,112,DET,36,25,29,31,0,121
2019-02-13,2,WAS,26,39,28,27,0,120,TOR,30,29,44,26,0,129
2019-02-22,9,WAS,38,22,27,23,0,110,CHO,27,38,31,27,0,123
2019-02-23,1,IND,29,36,24,30,0,119,WAS,21,29,30,32,0,112
2019-02-27,4,WAS,34,34,33,24,0,125,BRK,28,32,19,37,0,116
2019-03-01,2,WAS,20,25,36,15,0,96,BOS,30,19,33,25,0,107
2019-03-03,2,MIN,36,28,23,34,0,121,WAS,40,22,35,38,0,135
2019-03-06,3,DAL,43,22,31,27,0,123,WAS,33,36,30,33,0,132
2019-03-08,2,WAS,22,30,31,28,0,111,CHO,32,19,31,30,0,112
2019-03-09,1,WAS,39,32,28,22,9,130,MIN,28,32,35,26,14,135
2019-03-11,2,SAC,20,40,21,34,0,115,WAS,28,31,31,31,0,121
2019-03-13,2,ORL,28,25,21,16,0,90,WAS,29,32,15,24,0,100
2019-03-15,2,CHO,40,26,29,21,0,116,WAS,26,27,25,32,0,110
2019-03-16,1,MEM,37,34,32,25,0,128,WAS,35,34,36,30,0,135
2019-03-18,2,UTA,31,26,34,25,0,116,WAS,24,21,26,24,0,95
2019-03-20,2,WAS,28,32,21,32,7,120,CHI,35,25,25,28,13,126
2019-03-21,1,DEN,33,28,24,28,0,113,WAS,30,23,32,23,0,108
2019-03-23,2,MIA,25,27,26,35,0,113,WAS,27,26,26,29,0,108
2019-03-26,3,WAS,29,27,27,23,0,106,LAL,34,33,30,27,0,124
2019-03-27,1,WAS,27,32,30,35,0,124,PHO,30,29,31,31,0,121
2019-03-29,2,WAS,30,32,28,34,0,124,UTA,39,31,22,36,0,128
2019-03-31,2,WAS,23,30,22,20,0,95,DEN,34,28,10,18,0,90
2019-04-03,3,CHI,26,30,27,32,0,115,WAS,28,29,30,27,0,114
2019-04-05,2,SAS,37,40,28,24,0,129,WAS,32,26,30,24,0,112
2019-04-07,2,WAS,23,33,33,21,0,110,NYK,29,23,27,34,0,113
2019-04-09,2,BOS,25,38,26,27,0,116,WAS,39,25,31,15,0,110
2018-10-17,10,MIL,36,31,26,20,0,113,CHO,23,31,29,29,0,112
2018-10-19,2,CHO,22,29,31,38,0,120,ORL,10,21,23,34,0,88
2018-10-20,1,CHO,34,38,20,21,0,113,MIA,29,23,30,30,0,112
2018-10-22,2,CHO,22,25,32,27,0,106,TOR,31,31,35,30,0,127
2018-10-24,2,CHO,27,26,29,28,0,110,CHI,24,30,34,24,0,112
2018-10-26,2,CHI,25,29,21,31,0,106,CHO,23,45,34,33,0,135
2018-10-27,1,CHO,28,34,23,18,0,103,PHI,32,31,20,22,0,105
2018-10-30,3,MIA,29,26,18,40,0,113,CHO,31,34,27,33,0,125
2018-11-01,2,OKC,24,20,29,38,0,111,CHO,22,26,29,30,0,107
2018-11-03,2,CLE,22,30,21,21,0,94,CHO,30,29,34,33,0,126
2018-11-06,3,ATL,25,29,23,25,0,102,CHO,23,28,30,32,0,113
2018-11-09,3,CHO,33,17,35,34,13,132,PHI,33,32,31,23,14,133
2018-11-11,2,CHO,24,27,32,30,0,113,DET,27,22,26,28,0,103
2018-11-13,2,CHO,23,28,18,20,0,89,CLE,38,29,21,25,0,113
2018-11-17,4,PHI,42,21,19,28,12,122,CHO,30,26,30,24,9,119
2018-11-19,2,BOS,24,32,31,25,0,112,CHO,29,25,30,33,0,117
2018-11-21,2,IND,30,30,24,25,0,109,CHO,35,33,37,22,0,127
2018-11-23,2,CHO,31,26,23,24,0,104,OKC,33,29,27,20,0,109
2018-11-25,2,CHO,43,23,31,26,0,123,ATL,32,33,35,24,0,124
2018-11-26,1,MIL,35,17,28,27,0,107,CHO,32,33,28,17,0,110
2018-11-28,2,ATL,28,21,26,19,0,94,CHO,24,31,31,22,0,108
2018-11-30,2,UTA,33,24,34,28,0,119,CHO,19,34,30,28,0,111
2018-12-02,2,NOP,29,36,22,32,0,119,CHO,30,26,21,32,0,109
2018-12-05,3,CHO,31,33,22,18,0,104,MIN,31,31,24,35,0,121
2018-12-07,2,DEN,25,28,26,28,0,107,CHO,24,40,23,26,0,113
2018-12-09,2,CHO,27,34,38,20,0,119,NYK,24,23,31,29,0,107
2018-12-12,3,DET,25,30,38,14,0,107,CHO,37,23,22,26,0,108
2018-12-14,2,NYK,16,37,25,35,13,126,CHO,33,39,21,20,11,124
2018-12-15,1,LAL,32,25,40,31,0,128,CHO,22,28,17,33,0,100
2018-12-19,4,CLE,25,21,29,24,0,99,CHO,16,25,41,28,0,110
2018-12-21,2,DET,21,19,25,21,0,86,CHO,25,20,30,23,0,98
2018-12-23,2,CHO,26,21,20,36,0,103,BOS,29,39,26,25,0,119
2018-12-26,3,CHO,29,22,26,37,7,132,BRK,22,34,23,35,7,134
2018-12-28,2,BRK,17,25,23,22,0,87,CHO,33,21,19,27,0,100
2018-12-29,1,CHO,29,32,31,34,0,126,WAS,27,40,27,36,0,130
2018-12-31,2,ORL,23,30,24,23,0,100,CHO,36,27,32,30,0,125
2019-01-02,2,DAL,42,23,29,28,0,122,CHO,26,15,24,19,0,84
2019-01-05,3,CHO,26,30,28,26,0,110,DEN,31,27,31,34,0,123
2019-01-06,1,CHO,29,28,28,34,0,119,PHO,30,30,21,32,0,113
2019-01-08,2,CHO,24,33,20,32,0,109,LAC,33,29,24,42,0,128
2019-01-11,3,CHO,27,22,19,28,0,96,POR,37,33,31,26,0,127
2019-01-12,1,CHO,29,30,17,21,0,97,SAC,35,22,25,22,0,104
2019-01-14,2,CHO,28,21,27,32,0,108,SAS,24,19,29,21,0,93
2019-01-17,3,SAC,25,25,23,22,0,95,CHO,20,43,20,31,0,114
2019-01-19,2,PHO,26,34,26,29,0,115,CHO,39,32,38,26,0,135
2019-01-20,1,CHO,26,15,30,24,0,95,IND,34,22,27,37,0,120
2019-01-23,3,CHO,23,35,28,32,0,118,MEM,22,32,22,31,0,107
2019-01-25,2,CHO,27,27,33,12,0,99,MIL,22,30,24,32,0,108
2019-01-28,3,NYK,24,29,18,21,0,92,CHO,30,24,17,30,0,101
2019-01-30,2,CHO,28,31,16,19,0,94,BOS,35,28,35,28,0,126
2019-02-01,2,MEM,29,16,28,19,0,92,CHO,17,28,25,30,0,100
2019-02-02,1,CHI,26,34,26,32,0,118,CHO,27,24,37,37,0,125
2019-02-05,3,LAC,26,27,31,33,0,117,CHO,25,33,34,23,0,115
2019-02-06,1,CHO,20,26,25,22,0,93,DAL,27,25,22,25,0,99
2019-02-09,3,CHO,46,27,33,23,0,129,ATL,31,37,18,34,0,120
2019-02-11,2,CHO,19,19,33,19,0,90,IND,32,22,23,22,0,99
2019-02-14,3,CHO,18,18,31,22,0,89,ORL,33,38,27,29,0,127
2019-02-22,8,WAS,38,22,27,23,0,110,CHO,27,38,31,27,0,123
2019-02-23,1,BRK,34,29,27,27,0,117,CHO,20,30,34,31,0,115
2019-02-25,2,GSW,34,34,30,23,0,121,CHO,30,30,28,22,0,110
2019-02-27,2,HOU,41,21,28,28,0,118,CHO,33,36,25,19,0,113
2019-03-01,2,CHO,31,37,30,25,0,123,BRK,32,18,36,26,0,112
2019-03-03,2,POR,32,24,25,37,0,118,CHO,25,25,30,28,0,108
2019-03-06,3,MIA,29,14,18,30,0,91,CHO,18,25,15,26,0,84
2019-03-08,2,WAS,22,30,31,28,0,111,CHO,32,19,31,30,0,112
2019-03-09,1,CHO,32,27,28,27,0,114,MIL,24,31,39,37,0,131
2019-03-11,2,CHO,19,25,36,26,0,106,HOU,38,33,22,25,0,118
2019-03-15,4,CHO,40,26,29,21,0,116,WAS,26,27,25,32,0,110
2019-03-17,2,CHO,20,19,21,15,0,75,MIA,19,20,22,32,0,93
2019-03-19,2,PHI,31,31,23,33,0,118,CHO,30,29,30,25,0,114
2019-03-21,2,MIN,25,26,27,28,0,106,CHO,25,29,27,32,0,113
2019-03-23,2,BOS,35,29,34,19,0,117,CHO,29,34,26,35,0,124
2019-03-24,1,CHO,27,31,37,20,0,115,TOR,32,25,26,31,0,114
2019-03-26,2,SAS,23,36,21,26,10,116,CHO,29,26,27,24,19,125
2019-03-29,3,CHO,35,24,32,24,0,115,LAL,33,36,32,28,0,129
2019-03-31,2,CHO,27,22,23,18,0,90,GSW,35,36,34,32,0,137
2019-04-01,1,CHO,23,16,25,38,0,102,UTA,26,26,27,32,0,111
2019-04-03,2,CHO,24,35,24,32,0,115,NOP,21,34,23,31,0,109
2019-04-05,2,TOR,34,31,21,25,0,111,CHO,33,24,33,23,0,113
2019-04-07,2,CHO,32,28,23,21,0,104,DET,27,15,33,16,0,91
2019-04-09,2,CHO,33,31,26,34,0,124,CLE,31,25,19,22,0,97
2019-04-10,1,ORL,30,32,35,25,0,122,CHO,25,33,30,26,0,114
2018-10-17,10,MIN,23,29,31,25,0,108,SAS,31,25,25,31,0,112
2018-10-19,2,CLE,30,24,41,28,0,123,MIN,32,39,33,27,0,131
2018-10-20,1,MIN,46,23,30,37,0,136,DAL,37,32,28,43,0,140
2018-10-22,2,IND,28,21,24,18,0,91,MIN,25,25,22,29,0,101
2018-10-24,2,MIN,19,29,26,31,0,105,TOR,26,31,26,29,0,112
2018-10-26,2,MIL,27,36,34,28,0,125,MIN,16,22,29,28,0,95
2018-10-29,3,LAL,32,34,28,26,0,120,MIN,36,28,29,31,0,124
2018-10-31,2,UTA,25,31,40,29,0,125,MIN,32,33,36,27,0,128
2018-11-02,2,MIN,32,26,29,12,0,99,GSW,36,25,22,33,0,116
2018-11-04,2,MIN,27,18,19,17,0,81,POR,30,31,31,19,0,111
2018-11-05,1,MIN,33,26,25,25,0,109,LAC,31,32,29,28,0,120
2018-11-07,2,MIN,32,35,21,22,0,110,LAL,30,35,21,28,0,114
2018-11-09,2,MIN,31,30,20,29,0,110,SAC,29,34,29,29,0,121
2018-11-12,3,BRK,31,22,32,28,0,113,MIN,30,27,36,27,0,120
2018-11-14,2,NOP,28,26,27,19,0,100,MIN,38,29,18,22,0,107
2018-11-16,2,POR,21,22,24,29,0,96,MIN,29,26,28,29,0,112
2018-11-18,2,MEM,17,30,28,25,0,100,MIN,20,23,19,25,0,87
2018-11-21,3,DEN,23,27,35,18,0,103,MIN,25,31,18,27,0,101
2018-11-23,2,MIN,22,32,35,23,0,112,BRK,26,23,23,30,0,102
2018-11-24,1,CHI,22,28,29,17,0,96,MIN,20,29,35,27,0,111
2018-11-26,2,MIN,29,25,21,27,0,102,CLE,26,21,24,24,0,95
2018-11-28,2,SAS,25,9,24,31,0,89,MIN,28,29,35,36,0,128
2018-12-01,3,BOS,29,28,27,34,0,118,MIN,26,22,29,32,0,109
2018-12-03,2,HOU,24,38,20,9,0,91,MIN,24,24,38,17,0,103
2018-12-05,2,CHO,31,33,22,18,0,104,MIN,31,31,24,35,0,121
2018-12-08,3,MIN,27,24,29,25,0,105,POR,30,23,28,32,0,113
2018-12-10,2,MIN,24,33,20,31,0,108,GSW,30,33,28,25,0,116
2018-12-12,2,MIN,31,19,42,38,0,130,SAC,35,28,33,45,0,141
2018-12-15,3,MIN,30,28,24,17,0,99,PHO,28,28,29,22,0,107
2018-12-17,2,SAC,23,21,33,28,0,105,MIN,38,36,29,29,0,132
2018-12-19,2,DET,27,26,25,40,11,129,MIN,26,36,30,26,5,123
2018-12-21,2,MIN,21,23,27,27,0,98,SAS,29,33,25,37,0,124
2018-12-23,2,MIN,35,18,33,28,0,114,OKC,25,38,17,32,0,112
2018-12-26,3,MIN,29,31,23,36,0,119,CHI,18,19,28,29,0,94
2018-12-28,2,ATL,42,29,18,23,11,123,MIN,27,32,30,23,8,120
2018-12-30,2,MIN,30,25,31,27,0,113,MIA,19,35,23,27,0,104
2018-12-31,1,MIN,22,29,38,25,0,114,NOP,27,36,25,35,0,123
2019-01-02,2,MIN,21,21,39,21,0,102,BOS,25,35,27,28,0,115
2019-01-04,2,ORL,40,28,17,18,0,103,MIN,31,33,31,25,0,120
2019-01-06,2,LAL,19,26,23,18,0,86,MIN,35,29,19,25,0,108
2019-01-08,2,MIN,29,35,32,23,0,119,OKC,23,41,29,24,0,117
2019-01-11,3,DAL,28,33,24,34,0,119,MIN,26,24,28,37,0,115
2019-01-12,1,NOP,29,23,37,17,0,106,MIN,27,27,33,23,0,110
2019-01-15,3,MIN,27,31,32,17,0,107,PHI,40,43,32,34,0,149
2019-01-18,3,SAS,28,30,30,28,0,116,MIN,31,27,32,23,0,113
2019-01-20,2,PHO,31,36,29,18,0,114,MIN,29,35,27,25,0,116
2019-01-22,2,MIN,32,32,29,25,0,118,PHO,27,22,22,20,0,91
2019-01-24,2,MIN,28,30,26,36,0,120,LAL,29,32,21,23,0,105
2019-01-25,1,MIN,24,21,24,33,0,102,UTA,31,21,38,16,0,106
2019-01-27,2,UTA,25,28,37,35,0,125,MIN,22,28,35,26,0,111
2019-01-30,3,MEM,16,28,25,24,4,97,MIN,24,20,27,22,6,99
2019-02-02,3,DEN,29,32,28,18,0,107,MIN,38,26,24,18,0,106
2019-02-05,3,MIN,19,35,29,23,0,106,MEM,32,34,19,23,0,108
2019-02-07,2,MIN,31,27,27,27,0,112,ORL,32,39,31,20,0,122
2019-02-08,1,MIN,35,27,26,29,0,117,NOP,22,40,28,32,0,122
2019-02-11,3,LAC,26,29,36,29,0,120,MIN,29,34,36,31,0,130
2019-02-13,2,HOU,29,29,26,27,0,111,MIN,28,24,35,34,0,121
2019-02-22,9,MIN,29,37,28,21,0,115,NYK,33,25,25,21,0,104
2019-02-23,1,MIN,32,38,39,19,0,128,MIL,35,34,38,33,0,140
2019-02-25,2,SAC,30,23,27,25,0,105,MIN,19,44,30,19,0,112
2019-02-27,2,MIN,40,28,27,23,5,123,ATL,33,27,26,32,13,131
2019-02-28,1,MIN,35,25,30,25,0,115,IND,26,38,28,30,0,122
2019-03-03,3,MIN,36,28,23,34,0,121,WAS,40,22,35,38,0,135
2019-03-05,2,OKC,24,33,30,33,0,120,MIN,30,41,31,29,0,131
2019-03-06,1,MIN,35,29,24,26,0,114,DET,22,38,30,41,0,131
2019-03-09,3,WAS,39,32,28,22,9,130,MIN,28,32,35,26,14,135
2019-03-10,1,NYK,22,23,20,27,0,92,MIN,23,32,25,23,0,103
2019-03-12,2,MIN,20,28,30,29,0,107,DEN,31,27,36,39,0,133
2019-03-14,2,MIN,25,30,26,19,0,100,UTA,34,30,27,29,0,120
2019-03-17,3,MIN,30,19,29,24,0,102,HOU,26,24,43,24,0,117
2019-03-19,2,GSW,30,29,32,26,0,117,MIN,27,20,28,32,0,107
2019-03-21,2,MIN,25,26,27,28,0,106,CHO,25,29,27,32,0,113
2019-03-23,2,MIN,25,24,35,28,0,112,MEM,25,25,18,31,0,99
2019-03-26,3,LAC,42,33,25,22,0,122,MIN,23,32,30,26,0,111
2019-03-29,3,GSW,32,36,18,29,15,130,MIN,27,27,32,29,16,131
2019-03-30,1,PHI,38,30,24,26,0,118,MIN,20,35,26,28,0,109
2019-04-01,2,POR,38,37,22,35,0,132,MIN,23,41,36,22,0,122
2019-04-03,2,MIN,32,26,31,21,0,110,DAL,27,31,21,29,0,108
2019-04-05,2,MIA,35,34,22,18,0,109,MIN,36,25,29,21,0,111
2019-04-07,2,OKC,38,24,33,37,0,132,MIN,31,29,37,29,0,126
2019-04-09,2,TOR,26,43,29,22,0,120,MIN,28,19,31,22,0,100
2019-04-10,1,MIN,21,29,29,16,0,95,DEN,22,29,22,26,0,99
2018-10-17,10,DAL,24,22,27,27,0,100,PHO,37,19,27,38,0,121
2018-10-20,3,MIN,46,23,30,37,0,136,DAL,37,32,28,43,0,140
2018-10-22,2,CHI,28,33,23,25,0,109,DAL,31,28,29,27,0,115
2018-10-24,2,DAL,42,16,29,17,0,104,ATL,22,26,32,31,0,111
2018-10-26,2,DAL,26,34,29,18,0,107,TOR,39,30,23,24,0,116
2018-10-28,2,UTA,26,24,32,31,0,113,DAL,19,27,31,27,0,104
2018-10-29,1,DAL,18,27,29,28,6,108,SAS,20,33,23,26,11,113
2018-10-31,2,DAL,21,38,22,32,0,113,LAL,38,28,28,20,0,114
2018-11-02,2,NYK,33,23,33,29,0,118,DAL,27,32,18,29,0,106
2018-11-06,4,WAS,24,25,29,22,0,100,DAL,35,35,17,32,0,119
2018-11-07,1,DAL,18,27,38,19,0,102,UTA,30,38,31,18,0,117
2018-11-10,3,OKC,22,23,25,26,0,96,DAL,23,34,25,29,0,111
2018-11-12,2,DAL,25,31,22,25,0,103,CHI,20,29,26,23,0,98
2018-11-14,2,UTA,24,22,13,9,0,68,DAL,30,28,26,34,0,118
2018-11-17,3,GSW,22,37,27,23,0,109,DAL,26,31,25,30,0,112
2018-11-19,2,DAL,21,28,25,14,0,88,MEM,25,28,21,24,0,98
2018-11-21,2,BRK,32,18,31,32,0,113,DAL,34,27,24,34,0,119
2018-11-24,3,BOS,26,30,26,22,0,104,DAL,32,27,28,26,0,113
2018-11-28,4,DAL,36,38,22,32,0,128,HOU,28,28,33,19,0,108
2018-11-30,2,DAL,32,26,17,28,0,103,LAL,22,31,25,36,0,114
2018-12-02,2,LAC,35,23,22,30,0,110,DAL,34,28,26,26,0,114
2018-12-04,2,POR,20,25,28,29,0,102,DAL,34,26,27,24,0,111
2018-12-05,1,DAL,31,22,27,26,0,106,NOP,32,37,28,35,0,132
2018-12-08,3,HOU,30,27,27,20,0,104,DAL,32,24,28,23,0,107
2018-12-10,2,ORL,19,21,13,23,0,76,DAL,24,28,23,26,0,101
2018-12-12,2,ATL,26,26,26,29,0,107,DAL,28,23,30,33,0,114
2018-12-13,1,DAL,21,19,27,22,0,89,PHO,25,25,28,21,0,99
2018-12-16,3,SAC,34,27,32,27,0,120,DAL,31,27,25,30,0,113
2018-12-18,2,DAL,33,36,26,23,0,118,DEN,34,40,31,21,0,126
2018-12-20,2,DAL,27,27,28,39,0,121,LAC,30,35,24,36,0,125
2018-12-22,2,DAL,31,30,26,29,0,116,GSW,28,30,36,26,0,120
2018-12-23,1,DAL,27,25,28,27,11,118,POR,25,37,26,19,14,121
2018-12-26,3,NOP,30,34,30,25,0,119,DAL,33,34,23,32,0,122
2018-12-28,2,DAL,29,37,22,24,0,112,NOP,26,29,31,28,0,114
2018-12-30,2,OKC,28,31,14,30,0,103,DAL,27,30,27,21,0,105
2018-12-31,1,DAL,21,22,32,27,0,102,OKC,32,28,32,30,0,122
2019-01-02,2,DAL,42,23,29,28,0,122,CHO,26,15,24,19,0,84
2019-01-04,2,DAL,23,28,17,25,0,93,BOS,34,24,26,30,0,114
2019-01-05,1,DAL,26,25,19,30,0,100,PHI,31,28,28,19,0,106
2019-01-07,2,LAL,25,29,32,21,0,107,DAL,33,34,13,17,0,97
2019-01-09,2,PHO,26,24,19,25,0,94,DAL,26,20,32,26,0,104
2019-01-11,2,DAL,28,33,24,34,0,119,MIN,26,24,28,37,0,115
2019-01-13,2,GSW,25,37,30,27,0,119,DAL,29,25,34,26,0,114
2019-01-16,3,SAS,20,25,30,30,0,105,DAL,35,21,24,21,0,101
2019-01-19,3,DAL,23,19,27,30,0,99,IND,24,34,26,27,0,111
2019-01-21,2,DAL,26,33,25,22,0,106,MIL,35,22,35,24,0,116
2019-01-22,1,LAC,29,27,17,25,0,98,DAL,26,32,20,28,0,106
2019-01-25,3,DET,28,26,31,16,0,101,DAL,23,39,26,18,0,106
2019-01-27,2,TOR,38,32,15,38,0,123,DAL,32,26,30,32,0,120
2019-01-30,3,DAL,24,31,35,24,0,114,NYK,20,27,23,20,0,90
2019-01-31,1,DAL,21,28,21,19,0,89,DET,19,26,18,30,0,93
2019-02-02,2,DAL,40,18,28,25,0,111,CLE,31,24,25,18,0,98
2019-02-06,4,CHO,20,26,25,22,0,93,DAL,27,25,22,25,0,99
2019-02-08,2,MIL,29,35,30,28,0,122,DAL,29,22,35,21,0,107
2019-02-10,2,POR,24,33,35,9,0,101,DAL,25,22,31,24,0,102
2019-02-11,1,DAL,22,28,28,26,0,104,HOU,25,39,28,28,0,120
2019-02-13,2,MIA,29,28,32,23,0,112,DAL,25,33,16,27,0,101
2019-02-22,9,DEN,25,27,39,23,0,114,DAL,30,21,23,30,0,104
2019-02-23,1,DAL,25,33,20,31,0,109,UTA,31,30,25,39,0,125
2019-02-25,2,DAL,22,35,31,24,0,112,LAC,29,34,28,30,0,121
2019-02-27,2,IND,27,26,25,23,0,101,DAL,28,25,26,31,0,110
2019-03-02,3,MEM,33,29,28,21,0,111,DAL,21,28,18,14,0,81
2019-03-04,2,DAL,21,26,26,15,0,88,BRK,31,34,34,28,0,127
2019-03-06,2,DAL,43,22,31,27,0,123,WAS,33,36,30,33,0,132
2019-03-08,2,DAL,19,28,26,33,0,106,ORL,29,33,30,19,0,111
2019-03-10,2,HOU,25,33,23,13,0,94,DAL,26,28,18,21,0,93
2019-03-12,2,SAS,34,26,24,28,0,112,DAL,24,29,21,31,0,105
2019-03-14,2,DAL,29,28,32,10,0,99,DEN,26,25,28,21,0,100
2019-03-16,2,CLE,26,31,31,28,0,116,DAL,34,32,34,21,0,121
2019-03-18,2,NOP,28,21,35,26,19,129,DAL,34,25,20,31,15,125
2019-03-20,2,DAL,17,35,31,35,0,118,POR,26,39,36,25,0,126
2019-03-21,1,DAL,29,22,25,24,0,100,SAC,27,26,31,32,0,116
2019-03-23,2,DAL,37,37,34,18,0,126,GSW,22,24,24,21,0,91
2019-03-26,3,SAC,25,29,33,38,0,125,DAL,23,33,33,32,0,121
2019-03-28,2,DAL,29,30,23,17,0,99,MIA,26,23,26,30,0,105
2019-03-31,3,DAL,31,27,22,26,0,106,OKC,24,32,19,28,0,103
2019-04-01,1,PHI,32,18,27,25,0,102,DAL,27,41,29,25,0,122
2019-04-03,2,MIN,32,26,31,21,0,110,DAL,27,31,21,29,0,108
2019-04-05,2,MEM,31,34,34,23,0,122,DAL,30,23,31,28,0,112
2019-04-07,2,DAL,24,28,31,29,17,129,MEM,26,30,32,24,15,127
2019-04-09,2,PHO,18,20,41,30,0,109,DAL,33,35,30,22,0,120
2019-04-10,1,DAL,16,21,28,29,0,94,SAS,30,27,23,25,0,105
2018-10-17,10,MIL,36,31,26,20,0,113,CHO,23,31,29,29,0,112
2018-10-19,2,IND,25,28,23,25,0,101,MIL,30,32,31,25,0,118
2018-10-22,3,NYK,29,23,35,26,0,113,MIL,33,38,17,36,0,124
2018-10-24,2,PHI,34,30,17,27,0,108,MIL,22,49,21,31,0,123
2018-10-26,2,MIL,27,36,34,28,0,125,MIN,16,22,29,28,0,95
2018-10-27,1,ORL,25,26,17,23,0,91,MIL,30,35,28,20,0,113
2018-10-29,2,TOR,29,24,27,29,0,109,MIL,30,32,33,29,0,124
2018-11-01,3,MIL,16,37,25,35,0,113,BOS,23,32,38,24,0,117
2018-11-04,3,SAC,30,20,32,27,0,109,MIL,39,33,36,36,0,144
2018-11-06,2,MIL,31,20,26,26,0,103,POR,33,24,34,27,0,118
2018-11-08,2,MIL,32,32,41,29,0,134,GSW,29,22,28,32,0,111
2018-11-10,2,MIL,24,40,20,35,7,126,LAC,33,29,27,30,9,128
2018-11-11,1,MIL,33,30,36,22,0,121,DEN,35,24,29,26,0,114
2018-11-14,3,MEM,29,19,36,32,0,116,MIL,19,26,35,33,0,113
2018-11-16,2,CHI,40,23,17,24,0,104,MIL,27,18,46,32,0,123
2018-11-19,3,DEN,29,27,21,21,0,98,MIL,25,21,32,26,0,104
2018-11-21,2,POR,20,30,29,21,0,100,MIL,31,41,37,34,0,143
2018-11-23,2,PHO,34,30,27,25,0,116,MIL,30,31,29,24,0,114
2018-11-24,1,SAS,36,32,34,27,0,129,MIL,37,30,28,40,0,135
2018-11-26,2,MIL,35,17,28,27,0,107,CHO,32,33,28,17,0,110
2018-11-28,2,CHI,40,22,27,24,0,113,MIL,30,33,29,24,0,116
2018-12-01,3,MIL,35,31,31,27,10,134,NYK,28,33,32,31,12,136
2018-12-05,4,DET,21,24,19,28,0,92,MIL,30,26,28,31,0,115
2018-12-07,2,GSW,27,30,26,22,0,105,MIL,22,29,25,19,0,95
2018-12-09,2,MIL,25,26,28,25,0,104,TOR,30,19,25,25,0,99
2018-12-10,1,CLE,18,23,25,26,0,92,MIL,31,28,25,24,0,108
2018-12-12,2,MIL,23,20,27,27,0,97,IND,29,29,27,28,0,113
2018-12-14,2,MIL,27,34,30,23,0,114,CLE,16,31,30,25,0,102
2018-12-17,3,MIL,25,30,26,26,0,107,DET,27,16,34,27,0,104
2018-12-19,2,NOP,31,35,24,25,0,115,MIL,33,29,28,33,0,123
2018-12-21,2,MIL,35,30,28,27,0,120,BOS,22,26,30,29,0,107
2018-12-22,1,MIL,8,30,20,29,0,87,MIA,21,16,35,22,0,94
2018-12-25,3,MIL,22,26,36,25,0,109,NYK,24,22,22,27,0,95
2018-12-27,2,NYK,28,20,29,19,0,96,MIL,24,29,34,25,0,112
2018-12-29,2,BRK,23,29,34,29,0,115,MIL,29,42,35,23,0,129
2019-01-01,3,DET,27,25,21,25,0,98,MIL,35,33,24,29,0,121
2019-01-04,3,ATL,14,29,36,33,0,112,MIL,43,33,42,26,0,144
2019-01-05,1,TOR,27,29,35,32,0,123,MIL,34,23,25,34,0,116
2019-01-07,2,UTA,34,28,24,16,0,102,MIL,32,26,25,31,0,114
2019-01-09,2,MIL,26,28,38,24,0,116,HOU,29,31,23,26,0,109
2019-01-11,2,MIL,26,21,35,24,0,106,WAS,40,17,28,28,0,113
2019-01-13,2,MIL,35,29,31,38,0,133,ATL,32,23,29,30,0,114
2019-01-15,2,MIA,23,22,18,23,0,86,MIL,30,39,24,31,0,124
2019-01-16,1,MIL,28,22,41,20,0,111,MEM,20,25,28,28,0,101
2019-01-19,3,MIL,33,26,28,31,0,118,ORL,24,22,36,26,0,108
2019-01-21,2,DAL,26,33,25,22,0,106,MIL,35,22,35,24,0,116
2019-01-25,4,CHO,27,27,33,12,0,99,MIL,22,30,24,32,0,108
2019-01-27,2,MIL,25,17,37,33,0,112,OKC,31,25,33,29,0,118
2019-01-29,2,MIL,30,32,27,26,0,115,DET,22,27,28,28,0,105
2019-01-31,2,MIL,22,34,31,18,0,105,TOR,25,22,29,16,0,92
2019-02-02,2,MIL,38,35,27,31,0,131,WAS,26,24,34,31,0,115
2019-02-04,2,MIL,23,28,36,26,0,113,BRK,17,25,22,30,0,94
2019-02-06,2,WAS,35,30,42,22,0,129,MIL,50,35,35,28,0,148
2019-02-08,2,MIL,29,35,30,28,0,122,DAL,29,22,35,21,0,107
2019-02-09,1,ORL,20,39,20,24,0,103,MIL,19,30,15,19,0,83
2019-02-11,2,MIL,22,28,29,33,0,112,CHI,21,28,22,28,0,99
2019-02-13,2,MIL,26,29,21,30,0,106,IND,18,29,32,18,0,97
2019-02-21,8,BOS,22,25,21,29,0,97,MIL,20,33,19,26,0,98
2019-02-23,2,MIN,32,38,39,19,0,128,MIL,35,34,38,33,0,140
2019-02-25,2,MIL,25,38,27,27,0,117,CHI,38,16,26,26,0,106
2019-02-27,2,MIL,34,39,31,22,15,141,SAC,33,29,29,35,14,140
2019-03-01,2,MIL,27,32,34,38,0,131,LAL,26,39,29,26,0,120
2019-03-02,1,MIL,26,20,32,33,0,111,UTA,23,30,20,42,0,115
2019-03-04,2,MIL,31,23,28,23,0,105,PHO,20,32,24,38,0,114
2019-03-07,3,IND,24,26,22,26,0,98,MIL,32,22,30,33,0,117
2019-03-09,2,CHO,32,27,28,27,0,114,MIL,24,31,39,37,0,131
2019-03-10,1,MIL,32,28,23,31,0,114,SAS,25,29,33,34,0,121
2019-03-12,2,MIL,23,33,45,29,0,130,NOP,23,25,41,24,0,113
2019-03-15,3,MIL,19,23,37,34,0,113,MIA,37,25,18,18,0,98
2019-03-17,2,PHI,31,31,27,41,0,130,MIL,28,25,29,43,0,125
2019-03-19,2,LAL,24,34,26,17,0,101,MIL,35,26,38,16,0,115
2019-03-20,1,MIL,24,23,34,21,0,102,CLE,30,28,23,26,0,107
2019-03-22,2,MIA,32,19,18,18,0,87,MIL,33,30,31,22,0,116
2019-03-24,2,CLE,27,28,22,28,0,105,MIL,32,36,22,37,0,127
2019-03-26,2,HOU,25,28,18,23,0,94,MIL,20,38,32,18,0,108
2019-03-28,2,LAC,25,21,31,41,0,118,MIL,28,39,33,28,0,128
2019-03-31,3,MIL,43,28,26,25,13,135,ATL,26,42,30,24,14,136
2019-04-01,1,MIL,35,24,32,40,0,131,BRK,20,34,35,32,0,121
2019-04-04,3,MIL,30,26,26,46,0,128,PHI,26,32,28,36,0,122
2019-04-06,2,BRK,34,32,42,25,0,133,MIL,26,39,31,32,0,128
2019-04-07,1,ATL,21,24,27,35,0,107,MIL,28,26,31,30,0,115
2019-04-10,3,OKC,29,39,30,29,0,127,MIL,31,27,31,27,0,116
2018-10-16,10,PHI,21,21,24,21,0,87,BOS,21,26,30,28,0,105
2018-10-18,2,CHI,41,17,18,32,0,108,PHI,38,27,37,25,0,127
2018-10-20,2,ORL,32,20,34,29,0,115,PHI,30,33,26,27,0,116
2018-10-23,3,PHI,28,36,30,26,12,132,DET,27,34,26,33,13,133
2018-10-24,1,PHI,34,30,17,27,0,108,MIL,22,49,21,31,0,123
2018-10-27,3,CHO,28,34,23,18,0,103,PHI,32,31,20,22,0,105
2018-10-29,2,ATL,25,22,13,32,0,92,PHI,20,27,31,35,0,113
2018-10-30,1,PHI,26,27,33,26,0,112,TOR,35,32,38,24,0,129
2018-11-01,2,LAC,30,27,29,27,0,113,PHI,34,38,18,32,0,122
2018-11-03,2,DET,24,23,25,27,0,99,PHI,30,39,16,24,0,109
2018-11-04,1,PHI,21,26,28,22,0,97,BRK,18,33,41,30,0,122
2018-11-07,3,PHI,29,21,28,22,0,100,IND,23,27,21,23,0,94
2018-11-09,2,CHO,33,17,35,34,13,132,PHI,33,32,31,23,14,133
2018-11-10,1,PHI,26,37,17,22,4,106,MEM,21,29,24,28,10,112
2018-11-12,2,PHI,32,32,32,28,0,124,MIA,26,36,28,24,0,114
2018-11-14,2,PHI,30,22,35,19,0,106,ORL,27,26,23,35,0,111
2018-11-16,2,UTA,24,28,32,23,0,107,PHI,38,16,32,27,0,113
2018-11-17,1,PHI,42,21,19,28,12,122,CHO,30,26,30,24,9,119
2018-11-19,2,PHO,36,26,24,28,0,114,PHI,26,31,35,27,0,119
2018-11-21,2,NOP,23,34,30,33,0,120,PHI,38,29,29,25,0,121
2018-11-23,2,CLE,31,23,30,37,0,121,PHI,23,31,29,29,0,112
2018-11-25,2,PHI,25,29,35,38,0,127,BRK,32,36,34,23,0,125
2018-11-28,3,NYK,27,21,20,23,0,91,PHI,41,27,25,24,0,117
2018-11-30,2,WAS,19,27,24,28,0,98,PHI,31,37,30,25,0,123
2018-12-02,2,MEM,25,19,24,27,0,95,PHI,26,28,24,25,0,103
2018-12-05,3,PHI,29,20,28,25,0,102,TOR,23,30,25,35,0,113
2018-12-07,2,PHI,28,28,33,28,0,117,DET,27,41,22,21,0,111
2018-12-10,3,DET,29,18,29,26,0,102,PHI,38,18,31,29,0,116
2018-12-12,2,BRK,31,26,37,33,0,127,PHI,29,27,28,40,0,124
2018-12-14,2,IND,24,25,31,33,0,113,PHI,34,25,18,24,0,101
2018-12-16,2,PHI,29,36,24,39,0,128,CLE,36,22,27,20,0,105
2018-12-17,1,PHI,32,17,22,25,0,96,SAS,29,31,33,30,0,123
2018-12-19,2,NYK,33,28,24,24,0,109,PHI,38,31,30,32,0,131
2018-12-22,3,TOR,30,29,20,22,0,101,PHI,29,36,26,35,0,126
2018-12-25,3,PHI,25,26,38,19,6,114,BOS,32,25,29,22,13,121
2018-12-27,2,PHI,22,35,38,19,0,114,UTA,29,23,27,18,0,97
2018-12-30,3,PHI,20,21,26,28,0,95,POR,31,39,36,23,0,129
2019-01-01,2,PHI,41,35,25,18,0,119,LAC,28,30,30,25,0,113
2019-01-02,1,PHI,44,28,32,28,0,132,PHO,32,17,38,40,0,127
2019-01-05,3,DAL,26,25,19,30,0,100,PHI,31,28,28,19,0,106
2019-01-08,3,WAS,29,16,33,37,0,115,PHI,32,36,36,28,0,132
2019-01-09,1,PHI,20,28,27,31,0,106,WAS,25,38,29,31,0,123
2019-01-11,2,ATL,32,22,35,34,0,123,PHI,30,26,32,33,0,121
2019-01-13,2,PHI,36,30,17,25,0,108,NYK,24,26,32,23,0,105
2019-01-15,2,MIN,27,31,32,17,0,107,PHI,40,43,32,34,0,149
2019-01-17,2,PHI,28,26,32,34,0,120,IND,25,23,23,25,0,96
2019-01-19,2,OKC,33,26,29,29,0,117,PHI,25,31,23,36,0,115
2019-01-21,2,HOU,26,24,13,30,0,93,PHI,30,35,29,27,0,121
2019-01-23,2,SAS,35,29,32,24,0,120,PHI,34,33,29,26,0,122
2019-01-26,3,PHI,37,31,28,14,0,110,DEN,41,36,30,19,0,126
2019-01-29,3,PHI,39,25,32,25,0,121,LAL,20,33,28,24,0,105
2019-01-31,2,PHI,30,23,42,18,0,113,GSW,35,25,26,18,0,104
2019-02-02,2,PHI,26,26,27,29,0,108,SAC,32,30,24,29,0,115
2019-02-05,3,TOR,40,32,28,19,0,119,PHI,28,27,27,25,0,107
2019-02-08,3,DEN,23,33,26,28,0,110,PHI,33,23,27,34,0,117
2019-02-10,2,LAL,40,27,27,26,0,120,PHI,39,37,33,34,0,143
2019-02-12,2,BOS,28,24,25,35,0,112,PHI,23,23,28,35,0,109
2019-02-13,1,PHI,37,34,29,26,0,126,NYK,33,22,36,20,0,111
2019-02-21,8,MIA,21,29,25,27,0,102,PHI,29,28,16,33,0,106
2019-02-23,2,POR,27,32,41,30,0,130,PHI,25,31,26,33,0,115
2019-02-25,2,PHI,31,34,28,18,0,111,NOP,24,28,31,27,0,110
2019-02-28,3,PHI,37,23,26,22,0,108,OKC,26,23,30,25,0,104
2019-03-02,2,GSW,31,24,38,27,0,120,PHI,32,35,23,27,0,117
2019-03-05,3,ORL,34,30,18,24,0,106,PHI,39,31,24,20,0,114
2019-03-06,1,PHI,30,27,29,21,0,107,CHI,30,27,25,26,0,108
2019-03-08,2,PHI,21,23,21,26,0,91,HOU,37,22,28,20,0,107
2019-03-10,2,IND,25,34,11,19,0,89,PHI,26,25,21,34,0,106
2019-03-12,2,CLE,12,35,30,22,0,99,PHI,24,29,28,25,0,106
2019-03-15,3,SAC,29,29,31,25,0,114,PHI,33,29,37,24,0,123
2019-03-17,2,PHI,31,31,27,41,0,130,MIL,28,25,29,43,0,125
2019-03-19,2,PHI,31,31,23,33,0,118,CHO,30,29,30,25,0,114
2019-03-20,1,BOS,39,30,21,25,0,115,PHI,30,28,27,33,0,118
2019-03-23,3,PHI,41,27,32,27,0,127,ATL,34,40,26,29,0,129
2019-03-25,2,PHI,31,29,17,21,0,98,ORL,31,26,32,30,0,119
2019-03-28,3,BRK,23,35,24,28,0,110,PHI,38,30,30,25,0,123
2019-03-30,2,PHI,38,30,24,26,0,118,MIN,20,35,26,28,0,109
2019-04-01,2,PHI,32,18,27,25,0,102,DAL,27,41,29,25,0,122
2019-04-03,2,PHI,38,30,26,28,0,122,ATL,42,30,26,32,0,130
2019-04-04,1,MIL,30,26,26,46,0,128,PHI,26,32,28,36,0,122
2019-04-06,2,PHI,24,33,29,30,0,116,CHI,20,29,19,28,0,96
2019-04-09,3,PHI,20,22,18,39,0,99,MIA,34,27,30,31,0,122
2019-04-10,1,CHI,20,22,22,45,0,109,PHI,32,30,35,28,0,125
2018-10-17,10,DAL,24,22,27,27,0,100,PHO,37,19,27,38,0,121
2018-10-20,3,PHO,16,33,30,12,0,91,DEN,30,35,27,27,0,119
2018-10-22,2,PHO,23,24,34,22,0,103,GSW,32,38,36,17,0,123
2018-10-24,2,LAL,32,44,30,25,0,131,PHO,30,24,32,27,0,113
2018-10-27,3,PHO,18,25,28,25,0,96,MEM,26,42,19,30,0,117
2018-10-28,1,PHO,20,28,28,34,0,110,OKC,30,32,34,21,0,117
2018-10-31,3,SAS,28,32,34,26,0,120,PHO,15,24,27,24,0,90
2018-11-02,2,TOR,23,25,29,30,0,107,PHO,26,26,19,27,0,98
2018-11-04,2,MEM,28,28,25,19,0,100,PHO,21,31,25,25,0,102
2018-11-06,2,BRK,24,28,24,28,0,104,PHO,22,20,24,16,0,82
2018-11-08,2,BOS,13,22,30,35,16,116,PHO,32,23,25,20,9,109
2018-11-10,2,PHO,26,27,29,17,0,99,NOP,33,28,30,28,0,119
2018-11-12,2,PHO,13,27,35,26,0,101,OKC,32,32,22,32,0,118
2018-11-14,2,SAS,19,29,22,26,0,96,PHO,34,18,35,29,0,116
2018-11-17,3,OKC,30,17,32,31,0,110,PHO,25,17,23,35,0,100
2018-11-19,2,PHO,36,26,24,28,0,114,PHI,26,31,35,27,0,119
2018-11-21,2,PHO,28,41,24,23,0,116,CHI,25,39,30,30,0,124
2018-11-23,2,PHO,34,30,27,25,0,116,MIL,30,31,29,24,0,114
2018-11-25,2,PHO,32,28,24,23,0,107,DET,27,35,21,35,0,118
2018-11-27,2,IND,26,35,20,28,0,109,PHO,26,28,23,27,0,104
2018-11-28,1,PHO,22,27,25,25,0,99,LAC,26,23,40,26,0,115
2018-11-30,2,ORL,21,30,24,24,0,99,PHO,25,23,23,14,0,85
2018-12-02,2,PHO,31,15,28,22,0,96,LAL,21,40,34,25,0,120
2018-12-04,2,SAC,36,32,31,23,0,122,PHO,9,31,27,38,0,105
2018-12-06,2,PHO,9,32,18,27,0,86,POR,34,28,25,21,0,108
2018-12-07,1,MIA,34,26,29,26,0,115,PHO,36,14,23,25,0,98
2018-12-10,3,LAC,21,37,30,23,12,123,PHO,29,27,30,25,8,119
2018-12-11,1,PHO,20,26,18,22,0,86,SAS,29,30,29,23,0,111
2018-12-13,2,DAL,21,19,27,22,0,89,PHO,25,25,28,21,0,99
2018-12-15,2,MIN,30,28,24,17,0,99,PHO,28,28,29,22,0,107
2018-12-17,2,PHO,28,31,41,28,0,128,NYK,32,34,17,27,0,110
2018-12-19,2,PHO,26,33,27,25,0,111,BOS,37,25,18,23,0,103
2018-12-22,3,PHO,29,26,24,30,13,146,WAS,33,22,28,26,13,149
2018-12-23,1,PHO,31,25,18,29,0,103,BRK,38,25,28,20,0,111
2018-12-26,3,PHO,26,36,28,28,4,122,ORL,32,21,34,31,2,120
2018-12-28,2,OKC,36,22,23,37,0,118,PHO,29,28,27,18,0,102
2018-12-29,1,DEN,36,26,28,32,0,122,PHO,16,33,29,40,0,118
2018-12-31,2,GSW,31,38,39,24,0,132,PHO,27,25,35,22,0,109
2019-01-02,2,PHI,44,28,32,28,0,132,PHO,32,17,38,40,0,127
2019-01-04,2,LAC,38,30,23,30,0,121,PHO,19,25,34,33,0,111
2019-01-06,2,CHO,29,28,28,34,0,119,PHO,30,30,21,32,0,113
2019-01-08,2,SAC,32,40,14,25,0,111,PHO,35,18,33,29,0,115
2019-01-09,1,PHO,26,24,19,25,0,94,DAL,26,20,32,26,0,104
2019-01-12,3,DEN,23,24,22,24,0,93,PHO,31,29,21,21,0,102
2019-01-15,3,PHO,19,32,22,24,0,97,IND,38,24,34,35,0,131
2019-01-17,2,PHO,20,29,29,31,0,109,TOR,32,25,20,34,0,111
2019-01-19,2,PHO,26,34,26,29,0,115,CHO,39,32,38,26,0,135
2019-01-20,1,PHO,31,36,29,18,0,114,MIN,29,35,27,25,0,116
2019-01-22,2,MIN,32,32,29,25,0,118,PHO,27,22,22,20,0,91
2019-01-24,2,POR,30,26,32,32,0,120,PHO,31,21,24,30,0,106
2019-01-25,1,PHO,32,23,26,14,0,95,DEN,37,33,28,34,0,132
2019-01-27,2,PHO,27,26,28,21,0,102,LAL,31,34,25,26,0,116
2019-01-29,2,PHO,33,34,24,33,0,124,SAS,33,37,26,30,0,126
2019-02-02,4,ATL,33,25,28,32,0,118,PHO,30,27,31,24,0,112
2019-02-04,2,HOU,32,31,31,24,0,118,PHO,28,29,23,30,0,110
2019-02-06,2,PHO,24,22,25,17,0,88,UTA,30,26,23,37,0,116
2019-02-08,2,GSW,26,34,22,35,0,117,PHO,31,22,32,22,0,107
2019-02-10,2,PHO,23,21,28,32,0,104,SAC,33,30,24,30,0,117
2019-02-13,3,PHO,22,29,28,28,0,107,LAC,32,35,33,34,0,134
2019-02-21,8,PHO,28,23,21,26,0,98,CLE,23,32,22,34,0,111
2019-02-23,2,PHO,33,26,28,25,0,112,ATL,33,30,23,34,0,120
2019-02-25,2,PHO,23,29,32,40,0,124,MIA,29,34,24,34,0,121
2019-03-01,4,NOP,27,29,38,36,0,130,PHO,32,25,27,32,0,116
2019-03-02,1,LAL,26,33,19,31,0,109,PHO,33,33,29,23,0,118
2019-03-04,2,MIL,31,23,28,23,0,105,PHO,20,32,24,38,0,114
2019-03-06,2,NYK,22,25,17,32,0,96,PHO,16,33,32,26,0,107
2019-03-09,3,PHO,23,24,30,43,0,120,POR,24,42,36,25,0,127
2019-03-10,1,PHO,16,40,23,36,0,115,GSW,29,28,23,31,0,111
2019-03-13,3,UTA,25,28,25,36,0,114,PHO,27,16,32,22,0,97
2019-03-15,2,PHO,31,26,28,17,0,102,HOU,26,29,28,25,0,108
2019-03-16,1,PHO,34,32,23,33,16,138,NOP,31,29,25,37,14,136
2019-03-18,2,CHI,34,22,30,30,0,116,PHO,20,23,30,28,0,101
2019-03-21,3,DET,29,29,29,31,0,118,PHO,32,28,20,18,0,98
2019-03-23,2,PHO,32,21,22,28,0,103,SAC,19,28,32,33,0,112
2019-03-25,2,PHO,21,22,31,18,0,92,UTA,26,36,26,37,0,125
2019-03-27,2,WAS,27,32,30,35,0,124,PHO,30,29,31,31,0,121
2019-03-30,3,MEM,23,31,34,32,0,120,PHO,38,24,30,23,0,115
2019-04-01,2,CLE,23,29,32,29,0,113,PHO,31,40,20,31,0,122
2019-04-03,2,UTA,25,31,28,34,0,118,PHO,31,22,23,21,0,97
2019-04-05,2,NOP,38,38,23,18,9,126,PHO,31,34,31,21,16,133
2019-04-07,2,PHO,24,23,30,36,0,113,HOU,34,43,40,32,0,149
2019-04-09,2,PHO,18,20,41,30,0,109,DAL,33,35,30,22,0,120
2018-10-18,10,LAL,31,32,28,28,0,119,POR,34,31,28,35,0,128
2018-10-20,2,HOU,31,35,32,26,0,124,LAL,28,34,35,18,0,115
2018-10-22,2,SAS,40,25,34,29,15,143,LAL,26,34,36,32,14,142
2018-10-24,2,LAL,32,44,30,25,0,131,PHO,30,24,32,27,0,113
2018-10-25,1,DEN,26,31,32,25,0,114,LAL,22,36,29,34,0,121
2018-10-27,2,LAL,36,24,28,18,0,106,SAS,29,25,33,23,0,110
2018-10-29,2,LAL,32,34,28,26,0,120,MIN,36,28,29,31,0,124
2018-10-31,2,DAL,21,38,22,32,0,113,LAL,38,28,28,20,0,114
2018-11-03,3,LAL,28,28,32,26,0,114,POR,29,28,16,37,0,110
2018-11-04,1,TOR,42,29,30,20,0,121,LAL,17,32,31,27,0,107
2018-11-07,3,MIN,32,35,21,22,0,110,LAL,30,35,21,28,0,114
2018-11-10,3,LAL,26,24,26,25,0,101,SAC,20,24,21,21,0,86
2018-11-11,1,ATL,22,31,22,31,0,106,LAL,28,24,32,23,0,107
2018-11-14,3,POR,33,22,34,28,0,117,LAL,26,33,38,29,0,126
2018-11-17,3,LAL,31,22,28,36,0,117,ORL,25,37,38,30,0,130
2018-11-18,1,LAL,34,33,25,21,0,113,MIA,21,31,24,21,0,97
2018-11-21,3,LAL,24,25,32,28,0,109,CLE,28,24,29,24,0,105
2018-11-23,2,UTA,16,22,25,20,0,83,LAL,22,16,26,26,0,90
2018-11-25,2,ORL,19,32,35,22,0,108,LAL,29,23,19,33,0,104
2018-11-27,2,LAL,26,24,21,14,0,85,DEN,30,28,31,28,0,117
2018-11-29,2,IND,15,35,25,21,0,96,LAL,38,18,27,21,0,104
2018-11-30,1,DAL,32,26,17,28,0,103,LAL,22,31,25,36,0,114
2018-12-02,2,PHO,31,15,28,22,0,96,LAL,21,40,34,25,0,120
2018-12-05,3,SAS,23,22,37,31,0,113,LAL,31,19,28,43,0,121
2018-12-07,2,LAL,36,36,27,21,0,120,SAS,32,36,21,44,0,133
2018-12-08,1,LAL,27,36,28,20,0,111,MEM,16,24,26,22,0,88
2018-12-10,2,MIA,23,35,25,22,0,105,LAL,27,28,29,24,0,108
2018-12-13,3,LAL,24,32,32,23,0,111,HOU,29,33,28,36,0,126
2018-12-15,2,LAL,32,25,40,31,0,128,CHO,22,28,17,33,0,100
2018-12-16,1,LAL,23,28,25,34,0,110,WAS,33,38,28,29,0,128
2018-12-18,2,LAL,32,25,26,27,0,110,BRK,33,29,28,25,0,115
2018-12-21,3,NOP,34,31,23,16,0,104,LAL,34,35,25,18,0,112
2018-12-23,2,MEM,26,24,22,35,0,107,LAL,20,26,29,24,0,99
2018-12-25,2,LAL,32,33,26,36,0,127,GSW,25,25,32,19,0,101
2018-12-27,2,LAL,34,33,28,21,0,116,SAC,32,29,23,33,0,117
2018-12-28,1,LAC,28,23,31,36,0,118,LAL,23,31,26,27,0,107
2018-12-30,2,SAC,31,37,28,18,0,114,LAL,37,27,28,29,0,121
2019-01-02,3,OKC,25,34,19,29,0,107,LAL,25,32,25,18,0,100
2019-01-04,2,NYK,39,24,23,33,0,119,LAL,25,34,33,20,0,112
2019-01-06,2,LAL,19,26,23,18,0,86,MIN,35,29,19,25,0,108
2019-01-07,1,LAL,25,29,32,21,0,107,DAL,33,34,13,17,0,97
2019-01-09,2,DET,24,23,30,23,0,100,LAL,20,35,34,24,0,113
2019-01-11,2,LAL,26,15,27,27,0,95,UTA,32,30,21,30,0,113
2019-01-13,2,CLE,32,19,24,26,0,101,LAL,24,22,19,30,0,95
2019-01-15,2,CHI,18,25,25,32,0,100,LAL,19,25,32,31,0,107
2019-01-17,2,LAL,27,40,28,27,16,138,OKC,39,24,33,26,6,128
2019-01-19,2,LAL,39,25,22,34,14,134,HOU,26,20,36,38,18,138
2019-01-21,2,GSW,29,36,45,20,0,130,LAL,24,31,25,31,0,111
2019-01-24,3,MIN,28,30,26,36,0,120,LAL,29,32,21,23,0,105
2019-01-27,3,PHO,27,26,28,21,0,102,LAL,31,34,25,26,0,116
2019-01-29,2,PHI,39,25,32,25,0,121,LAL,20,33,28,24,0,105
2019-01-31,2,LAL,32,22,33,25,11,123,LAC,26,27,22,37,8,120
2019-02-02,2,LAL,24,34,28,15,0,101,GSW,33,30,25,27,0,115
2019-02-05,3,LAL,26,20,27,21,0,94,IND,33,36,32,35,0,136
2019-02-07,2,LAL,24,33,42,30,0,129,BOS,30,36,27,35,0,128
2019-02-10,3,LAL,40,27,27,26,0,120,PHI,39,37,33,34,0,143
2019-02-12,2,LAL,32,37,26,18,0,113,ATL,38,27,35,17,0,117
2019-02-21,9,HOU,32,26,32,16,0,106,LAL,22,30,31,28,0,111
2019-02-23,2,LAL,35,22,27,31,0,115,NOP,42,27,31,28,0,128
2019-02-25,2,LAL,31,25,25,24,0,105,MEM,34,27,26,23,0,110
2019-02-27,2,NOP,28,29,35,27,0,119,LAL,35,28,32,30,0,125
2019-03-01,2,MIL,27,32,34,38,0,131,LAL,26,39,29,26,0,120
2019-03-02,1,LAL,26,33,19,31,0,109,PHO,33,33,29,23,0,118
2019-03-04,2,LAC,26,35,30,22,0,113,LAL,34,23,28,20,0,105
2019-03-06,2,DEN,43,23,19,30,0,115,LAL,25,24,28,22,0,99
2019-03-09,3,BOS,25,32,36,27,0,120,LAL,24,23,29,31,0,107
2019-03-12,3,LAL,16,39,43,25,0,123,CHI,34,26,24,23,0,107
2019-03-14,2,LAL,25,29,30,14,0,98,TOR,33,32,25,21,0,111
2019-03-15,1,LAL,22,18,22,35,0,97,DET,27,19,31,34,0,111
2019-03-17,2,LAL,30,36,30,27,0,123,NYK,41,22,31,30,0,124
2019-03-19,2,LAL,24,34,26,17,0,101,MIL,35,26,38,16,0,115
2019-03-22,3,BRK,20,24,34,33,0,111,LAL,23,20,30,33,0,106
2019-03-24,2,SAC,20,29,28,29,0,106,LAL,22,26,39,24,0,111
2019-03-26,2,WAS,29,27,27,23,0,106,LAL,34,33,30,27,0,124
2019-03-27,1,LAL,25,28,18,29,0,100,UTA,32,28,27,28,0,115
2019-03-29,2,CHO,35,24,32,24,0,115,LAL,33,36,32,28,0,129
2019-03-31,2,LAL,26,35,44,25,0,130,NOP,26,36,22,18,0,102
2019-04-02,2,LAL,28,27,23,25,0,103,OKC,34,25,35,25,0,119
2019-04-04,2,GSW,39,21,34,14,0,108,LAL,12,30,24,24,0,90
2019-04-05,1,LAL,35,26,23,38,0,122,LAC,30,37,19,31,0,117
2019-04-07,2,UTA,27,32,24,26,0,109,LAL,34,20,27,32,0,113
2019-04-09,2,POR,26,27,20,31,0,104,LAL,25,23,26,27,0,101
2018-10-17,10,UTA,30,38,25,30,0,123,SAC,34,21,32,30,0,117
2018-10-19,2,GSW,32,37,28,27,0,124,UTA,34,47,22,20,0,123
2018-10-22,3,MEM,19,28,23,22,0,92,UTA,22,24,17,21,0,84
2018-10-24,2,UTA,24,28,23,25,0,100,HOU,29,15,22,23,0,89
2018-10-27,3,UTA,28,36,38,30,0,132,NOP,31,18,33,29,0,111
2018-10-28,1,UTA,26,24,32,31,0,113,DAL,19,27,31,27,0,104
2018-10-31,3,UTA,25,31,40,29,0,125,MIN,32,33,36,27,0,128
2018-11-02,2,MEM,29,24,30,27,0,110,UTA,31,29,18,22,0,100
2018-11-03,1,UTA,25,21,27,15,0,88,DEN,25,22,21,35,0,103
2018-11-05,2,TOR,30,35,29,30,0,124,UTA,31,23,18,39,0,111
2018-11-07,2,DAL,18,27,38,19,0,102,UTA,30,38,31,18,0,117
2018-11-09,2,BOS,25,26,29,35,0,115,UTA,27,31,35,30,0,123
2018-11-12,3,UTA,20,20,34,22,0,96,MEM,16,27,26,19,0,88
2018-11-14,2,UTA,24,22,13,9,0,68,DAL,30,28,26,34,0,118
2018-11-16,2,UTA,24,28,32,23,0,107,PHI,38,16,32,27,0,113
2018-11-17,1,UTA,29,21,27,21,0,98,BOS,20,25,17,24,0,86
2018-11-19,2,UTA,19,28,23,24,0,94,IND,32,25,29,35,0,121
2018-11-21,2,SAC,34,26,24,35,0,119,UTA,23,31,29,27,0,110
2018-11-23,2,UTA,16,22,25,20,0,83,LAL,22,16,26,26,0,90
2018-11-25,2,UTA,30,29,32,42,0,133,SAC,26,24,30,32,0,112
2018-11-26,1,IND,33,25,31,32,0,121,UTA,25,22,23,18,0,88
2018-11-28,2,UTA,17,26,27,31,0,101,BRK,16,26,36,13,0,91
2018-11-30,2,UTA,33,24,34,28,0,119,CHO,19,34,30,28,0,111
2018-12-02,2,UTA,35,20,22,23,0,100,MIA,27,26,27,22,0,102
2018-12-04,2,SAS,20,27,31,27,0,105,UTA,34,29,41,35,0,139
2018-12-06,2,HOU,18,27,11,35,0,91,UTA,27,26,38,27,0,118
2018-12-09,3,UTA,18,18,36,25,0,97,SAS,23,31,28,28,0,110
2018-12-10,1,UTA,22,24,29,38,0,113,OKC,30,27,42,23,0,122
2018-12-12,2,MIA,15,18,20,31,0,84,UTA,40,20,32,19,0,111
2018-12-15,3,UTA,14,21,24,30,0,89,ORL,14,19,22,41,0,96
2018-12-17,2,UTA,23,14,36,24,0,97,HOU,25,25,33,19,0,102
2018-12-19,2,GSW,21,34,25,23,0,103,UTA,24,32,28,24,0,108
2018-12-21,2,UTA,33,22,28,37,0,120,POR,26,23,19,22,0,90
2018-12-22,1,OKC,26,32,35,14,0,107,UTA,32,29,20,25,0,106
2018-12-25,3,POR,24,23,23,26,0,96,UTA,24,35,24,34,0,117
2018-12-27,2,PHI,22,35,38,19,0,114,UTA,29,23,27,18,0,97
2018-12-29,2,NYK,17,17,32,31,0,97,UTA,39,32,26,32,0,129
2019-01-01,3,UTA,24,29,32,31,0,116,TOR,26,25,44,27,0,122
2019-01-04,3,UTA,23,25,33,36,0,117,CLE,20,29,22,20,0,91
2019-01-05,1,UTA,13,35,28,34,0,110,DET,31,22,25,27,0,105
2019-01-07,2,UTA,34,28,24,16,0,102,MIL,32,26,25,31,0,114
2019-01-09,2,ORL,32,31,12,18,0,93,UTA,19,27,32,28,0,106
2019-01-11,2,LAL,26,15,27,27,0,95,UTA,32,30,21,30,0,113
2019-01-12,1,CHI,19,34,29,20,0,102,UTA,29,22,30,29,0,110
2019-01-14,2,DET,31,28,15,20,0,94,UTA,27,26,22,25,0,100
2019-01-16,2,UTA,31,25,32,41,0,129,LAC,22,27,23,37,0,109
2019-01-18,2,CLE,20,17,23,39,0,99,UTA,29,32,32,22,0,115
2019-01-21,3,POR,29,15,39,26,0,109,UTA,28,23,28,25,0,104
2019-01-23,2,DEN,24,34,22,28,0,108,UTA,30,35,23,26,0,114
2019-01-25,2,MIN,24,21,24,33,0,102,UTA,31,21,38,16,0,106
2019-01-27,2,UTA,25,28,37,35,0,125,MIN,22,28,35,26,0,111
2019-01-30,3,UTA,27,31,22,25,0,105,POR,45,29,35,23,0,132
2019-02-01,2,ATL,34,26,27,25,0,112,UTA,36,22,38,32,0,128
2019-02-02,1,HOU,31,32,28,34,0,125,UTA,27,23,19,29,0,98
2019-02-06,4,PHO,24,22,25,17,0,88,UTA,30,26,23,37,0,116
2019-02-09,3,SAS,24,24,27,30,0,105,UTA,23,39,24,39,0,125
2019-02-12,3,UTA,14,30,40,24,0,108,GSW,25,22,34,34,0,115
2019-02-22,10,UTA,34,23,38,34,10,147,OKC,35,31,27,36,10,148
2019-02-23,1,DAL,25,33,20,31,0,109,UTA,31,30,25,39,0,125
2019-02-27,4,LAC,33,23,27,22,0,105,UTA,26,23,34,28,0,111
2019-02-28,1,UTA,19,33,29,30,0,111,DEN,22,15,33,34,0,104
2019-03-02,2,MIL,26,20,32,33,0,111,UTA,23,30,20,42,0,115
2019-03-04,2,NOP,24,28,30,33,0,115,UTA,33,28,27,24,0,112
2019-03-06,2,UTA,25,33,27,29,0,114,NOP,23,24,29,28,0,104
2019-03-08,2,UTA,23,30,26,25,0,104,MEM,29,31,24,30,0,114
2019-03-11,3,OKC,22,28,27,21,0,98,UTA,21,16,26,26,0,89
2019-03-13,2,UTA,25,28,25,36,0,114,PHO,27,16,32,22,0,97
2019-03-14,1,MIN,25,30,26,19,0,100,UTA,34,30,27,29,0,120
2019-03-16,2,BRK,21,21,22,34,0,98,UTA,28,31,24,31,0,114
2019-03-18,2,UTA,31,26,34,25,0,116,WAS,24,21,26,24,0,95
2019-03-20,2,UTA,39,35,37,26,0,137,NYK,25,22,32,37,0,116
2019-03-21,1,UTA,28,26,37,23,0,114,ATL,29,36,21,31,0,117
2019-03-23,2,UTA,33,37,21,23,0,114,CHI,18,18,25,22,0,83
2019-03-25,2,PHO,21,22,31,18,0,92,UTA,26,36,26,37,0,125
2019-03-27,2,LAL,25,28,18,29,0,100,UTA,32,28,27,28,0,115
2019-03-29,2,WAS,30,32,28,34,0,124,UTA,39,31,22,36,0,128
2019-04-01,3,CHO,23,16,25,38,0,102,UTA,26,26,27,32,0,111
2019-04-03,2,UTA,25,31,28,34,0,118,PHO,31,22,23,21,0,97
2019-04-05,2,SAC,20,24,26,28,0,98,UTA,35,35,26,23,0,119
2019-04-07,2,UTA,27,32,24,26,0,109,LAL,34,20,27,32,0,113
2019-04-09,2,DEN,21,38,27,22,0,108,UTA,27,33,31,27,0,118
2019-04-10,1,UTA,26,40,31,29,11,137,LAC,39,31,32,24,17,143
2018-10-17,10,UTA,30,38,25,30,0,123,SAC,34,21,32,30,0,117
2018-10-19,2,SAC,32,31,27,39,0,129,NOP,40,32,38,39,0,149
2018-10-21,2,SAC,34,34,29,34,0,131,OKC,32,24,34,30,0,120
2018-10-23,2,SAC,26,29,26,31,0,112,DEN,33,35,37,21,0,126
2018-10-24,1,MEM,28,24,19,21,0,92,SAC,19,25,27,26,0,97
2018-10-26,2,WAS,27,34,24,27,0,112,SAC,28,27,24,37,0,116
2018-10-29,3,SAC,17,34,43,29,0,123,MIA,28,23,32,30,0,113
2018-10-30,1,SAC,26,33,26,22,0,107,ORL,31,25,16,27,0,99
2018-11-01,2,SAC,35,34,46,31,0,146,ATL,29,35,23,28,0,115
2018-11-04,3,SAC,30,20,32,27,0,109,MIL,39,33,36,36,0,144
2018-11-07,3,TOR,29,35,30,20,0,114,SAC,26,25,27,27,0,105
2018-11-09,2,MIN,31,30,20,29,0,110,SAC,29,34,29,29,0,121
2018-11-10,1,LAL,26,24,26,25,0,101,SAC,20,24,21,21,0,86
2018-11-12,2,SAS,24,31,21,23,0,99,SAC,25,31,21,27,0,104
2018-11-16,4,SAC,28,23,27,26,0,104,MEM,29,33,25,25,0,112
2018-11-17,1,SAC,29,30,27,26,0,112,HOU,36,35,38,23,0,132
2018-11-19,2,OKC,24,32,29,28,0,113,SAC,37,32,15,33,0,117
2018-11-21,2,SAC,34,26,24,35,0,119,UTA,23,31,29,27,0,110
2018-11-24,3,SAC,29,35,29,23,0,116,GSW,28,32,35,22,0,117
2018-11-25,1,UTA,30,29,32,42,0,133,SAC,26,24,30,32,0,112
2018-11-29,4,LAC,42,29,30,32,0,133,SAC,26,42,25,28,0,121
2018-12-01,2,IND,30,30,31,19,0,110,SAC,26,32,31,22,0,111
2018-12-04,3,SAC,36,32,31,23,0,122,PHO,9,31,27,38,0,105
2018-12-07,3,SAC,38,28,30,33,0,129,CLE,27,39,23,21,0,110
2018-12-08,1,SAC,31,21,18,27,0,97,IND,24,30,19,34,0,107
2018-12-10,2,SAC,26,19,36,27,0,108,CHI,33,23,18,15,0,89
2018-12-12,2,MIN,31,19,42,38,0,130,SAC,35,28,33,45,0,141
2018-12-14,2,GSW,42,34,27,27,0,130,SAC,38,26,33,28,0,125
2018-12-16,2,SAC,34,27,32,27,0,120,DAL,31,27,25,30,0,113
2018-12-17,1,SAC,23,21,33,28,0,105,MIN,38,36,29,29,0,132
2018-12-19,2,OKC,36,35,27,34,0,132,SAC,33,19,37,24,0,113
2018-12-21,2,MEM,32,21,21,25,0,99,SAC,24,16,25,37,0,102
2018-12-23,2,NOP,36,33,27,21,0,117,SAC,25,33,28,36,0,122
2018-12-26,3,SAC,27,29,29,33,0,118,LAC,39,32,31,25,0,127
2018-12-27,1,LAL,34,33,28,21,0,116,SAC,32,29,23,33,0,117
2018-12-30,3,SAC,31,37,28,18,0,114,LAL,37,27,28,29,0,121
2019-01-01,2,POR,26,38,19,20,10,113,SAC,25,25,27,26,5,108
2019-01-03,2,DEN,30,23,31,33,0,117,SAC,30,36,18,29,0,113
2019-01-05,2,GSW,43,27,26,31,0,127,SAC,29,40,34,20,0,123
2019-01-07,2,ORL,25,17,20,33,0,95,SAC,29,29,32,21,0,111
2019-01-08,1,SAC,32,40,14,25,0,111,PHO,35,18,33,29,0,115
2019-01-10,2,DET,21,27,26,28,0,102,SAC,34,31,26,21,0,112
2019-01-12,2,CHO,29,30,17,21,0,97,SAC,35,22,25,22,0,104
2019-01-14,2,POR,27,17,31,32,0,107,SAC,24,30,29,32,0,115
2019-01-17,3,SAC,25,25,23,22,0,95,CHO,20,43,20,31,0,114
2019-01-19,2,SAC,26,25,23,29,0,103,DET,30,27,25,19,0,101
2019-01-21,2,SAC,23,37,25,9,0,94,BRK,29,26,38,30,0,123
2019-01-22,1,SAC,34,22,22,27,0,105,TOR,29,31,28,32,0,120
2019-01-25,3,SAC,24,24,29,22,0,99,MEM,23,19,29,25,0,96
2019-01-27,2,SAC,21,30,25,32,0,108,LAC,34,33,20,35,0,122
2019-01-30,3,ATL,31,22,27,33,0,113,SAC,32,35,38,30,0,135
2019-02-02,3,PHI,26,26,27,29,0,108,SAC,32,30,24,29,0,115
2019-02-04,2,SAS,25,34,27,26,0,112,SAC,37,26,35,29,0,127
2019-02-06,2,HOU,32,44,28,23,0,127,SAC,28,17,29,27,0,101
2019-02-08,2,MIA,28,31,24,13,0,96,SAC,17,33,25,27,0,102
2019-02-10,2,PHO,23,21,28,32,0,104,SAC,33,30,24,30,0,117
2019-02-13,3,SAC,41,28,22,27,0,118,DEN,30,28,35,27,0,120
2019-02-21,8,SAC,30,32,29,32,0,123,GSW,35,25,29,36,0,125
2019-02-23,2,SAC,31,32,31,25,0,119,OKC,24,25,34,33,0,116
2019-02-25,2,SAC,30,23,27,25,0,105,MIN,19,44,30,19,0,112
2019-02-27,2,MIL,34,39,31,22,15,141,SAC,33,29,29,35,14,140
2019-03-01,2,LAC,26,26,35,29,0,116,SAC,23,33,26,27,0,109
2019-03-04,3,NYK,25,26,29,28,0,108,SAC,34,21,31,29,0,115
2019-03-06,2,BOS,26,23,33,29,0,111,SAC,32,17,28,32,0,109
2019-03-09,3,SAC,23,25,32,22,0,102,NYK,30,16,22,26,0,94
2019-03-11,2,SAC,20,40,21,34,0,115,WAS,28,31,31,31,0,121
2019-03-14,3,SAC,38,24,29,29,0,120,BOS,25,31,37,33,0,126
2019-03-15,1,SAC,29,29,31,25,0,114,PHI,33,29,37,24,0,123
2019-03-17,2,CHI,23,17,31,31,0,102,SAC,24,32,43,30,0,129
2019-03-19,2,BRK,25,33,20,45,0,123,SAC,38,28,37,18,0,121
2019-03-21,2,DAL,29,22,25,24,0,100,SAC,27,26,31,32,0,116
2019-03-23,2,PHO,32,21,22,28,0,103,SAC,19,28,32,33,0,112
2019-03-24,1,SAC,20,29,28,29,0,106,LAL,22,26,39,24,0,111
2019-03-26,2,SAC,25,29,33,38,0,125,DAL,23,33,33,32,0,121
2019-03-28,2,SAC,26,36,26,30,0,118,NOP,30,34,29,28,0,121
2019-03-30,2,SAC,32,28,33,15,0,108,HOU,35,28,28,28,0,119
2019-03-31,1,SAC,28,30,31,24,0,113,SAS,30,27,30,19,0,106
2019-04-02,2,HOU,33,29,29,39,0,130,SAC,23,23,31,28,0,105
2019-04-04,2,CLE,22,29,33,20,0,104,SAC,29,28,36,24,0,117
2019-04-05,1,SAC,20,24,26,28,0,98,UTA,35,35,26,23,0,119
2019-04-07,2,NOP,32,34,36,31,0,133,SAC,39,29,34,27,0,129
2019-04-10,3,SAC,39,48,26,18,0,131,POR,30,32,36,38,0,136
2018-10-17,10,ATL,24,25,35,23,0,107,NYK,23,49,34,20,0,126
2018-10-19,2,NYK,24,26,26,29,0,105,BRK,33,24,17,33,0,107
2018-10-20,1,BOS,31,19,27,26,0,103,NYK,18,30,22,31,0,101
2018-10-22,2,NYK,29,23,35,26,0,113,MIL,33,38,17,36,0,124
2018-10-24,2,NYK,27,18,20,22,0,87,MIA,16,31,45,18,0,110
2018-10-26,2,GSW,25,28,28,47,0,128,NYK,25,28,31,16,0,100
2018-10-29,3,BRK,26,18,23,29,0,96,NYK,26,26,33,30,0,115
2018-10-31,2,IND,28,22,27,30,0,107,NYK,25,27,29,20,0,101
2018-11-02,2,NYK,33,23,33,29,0,118,DAL,27,32,18,29,0,106
2018-11-04,2,NYK,17,33,28,17,0,95,WAS,24,34,23,27,0,108
2018-11-05,1,CHI,24,23,31,24,6,116,NYK,21,26,25,30,6,115
2018-11-07,2,NYK,26,26,35,25,0,112,ATL,26,29,18,34,0,107
2018-11-10,3,NYK,25,28,29,30,0,112,TOR,25,39,36,28,0,128
2018-11-11,1,ORL,30,35,22,28,0,115,NYK,10,30,20,29,0,89
2018-11-14,3,NYK,22,27,31,23,0,103,OKC,37,28,35,28,0,128
2018-11-16,2,NYK,32,32,32,28,0,124,NOP,16,38,34,41,0,129
2018-11-18,2,NYK,31,35,26,25,0,117,ORL,44,23,31,33,0,131
2018-11-20,2,POR,33,25,31,29,0,118,NYK,35,25,25,29,0,114
2018-11-21,1,NYK,26,39,19,33,0,117,BOS,18,31,20,40,0,109
2018-11-23,2,NOP,34,26,30,19,0,109,NYK,28,31,28,27,0,114
2018-11-25,2,NYK,21,22,35,25,0,103,MEM,26,26,19,27,0,98
2018-11-27,2,NYK,19,24,27,38,0,108,DET,24,27,30,34,0,115
2018-11-28,1,NYK,27,21,20,23,0,91,PHI,41,27,25,24,0,117
2018-12-01,3,MIL,35,31,31,27,10,134,NYK,28,33,32,31,12,136
2018-12-03,2,WAS,26,26,34,24,0,110,NYK,32,29,19,27,0,107
2018-12-06,3,NYK,30,28,26,16,0,100,BOS,38,31,30,29,0,128
2018-12-08,2,BRK,30,26,38,18,0,112,NYK,23,22,32,27,0,104
2018-12-09,1,CHO,27,34,38,20,0,119,NYK,24,23,31,29,0,107
2018-12-12,3,NYK,23,31,32,20,0,106,CLE,39,26,21,27,0,113
2018-12-14,2,NYK,16,37,25,35,13,126,CHO,33,39,21,20,11,124
2018-12-16,2,NYK,26,27,20,26,0,99,IND,28,28,23,31,0,110
2018-12-17,1,PHO,28,31,41,28,0,128,NYK,32,34,17,27,0,110
2018-12-19,2,NYK,33,28,24,24,0,109,PHI,38,31,30,32,0,131
2018-12-21,2,ATL,28,32,27,27,0,114,NYK,39,30,20,18,0,107
2018-12-25,4,MIL,22,26,36,25,0,109,NYK,24,22,22,27,0,95
2018-12-27,2,NYK,28,20,29,19,0,96,MIL,24,29,34,25,0,112
2018-12-29,2,NYK,17,17,32,31,0,97,UTA,39,32,26,32,0,129
2019-01-01,3,NYK,32,24,28,24,0,108,DEN,28,27,27,33,0,115
2019-01-04,3,NYK,39,24,23,33,0,119,LAL,25,34,33,20,0,112
2019-01-07,3,NYK,30,23,23,25,0,101,POR,30,24,32,25,0,111
2019-01-08,1,NYK,25,24,19,27,0,95,GSW,31,30,33,28,0,122
2019-01-11,3,IND,31,33,32,25,0,121,NYK,22,30,30,24,0,106
2019-01-13,2,PHI,36,30,17,25,0,108,NYK,24,26,32,23,0,105
2019-01-17,4,NYK,30,33,26,11,0,100,WAS,20,33,24,24,0,101
2019-01-21,4,OKC,34,33,36,24,0,127,NYK,16,31,35,27,0,109
2019-01-23,2,HOU,28,30,30,26,0,114,NYK,31,32,15,32,0,110
2019-01-25,2,NYK,37,23,22,17,0,99,BRK,30,30,27,22,0,109
2019-01-27,2,MIA,25,27,29,25,0,106,NYK,26,32,12,27,0,97
2019-01-28,1,NYK,24,29,18,21,0,92,CHO,30,24,17,30,0,101
2019-01-30,2,DAL,24,31,35,24,0,114,NYK,20,27,23,20,0,90
2019-02-01,2,BOS,25,31,24,33,0,113,NYK,20,27,26,26,0,99
2019-02-03,2,MEM,19,23,32,22,0,96,NYK,22,19,21,22,0,84
2019-02-05,2,DET,36,27,15,27,0,105,NYK,28,26,17,21,0,92
2019-02-08,3,NYK,22,32,30,19,0,103,DET,41,22,26,31,0,120
2019-02-09,1,TOR,25,21,28,30,0,104,NYK,23,19,27,30,0,99
2019-02-11,2,NYK,22,26,31,25,0,104,CLE,30,33,26,18,0,107
2019-02-13,2,PHI,37,34,29,26,0,126,NYK,33,22,36,20,0,111
2019-02-14,1,NYK,28,26,28,24,0,106,ATL,13,38,22,18,0,91
2019-02-22,8,MIN,29,37,28,21,0,115,NYK,33,25,25,21,0,104
2019-02-24,2,SAS,26,27,30,35,0,118,NYK,30,32,32,36,0,130
2019-02-26,2,ORL,34,27,29,13,0,103,NYK,20,36,22,30,0,108
2019-02-28,2,CLE,27,30,28,40,0,125,NYK,31,28,38,21,0,118
2019-03-03,3,NYK,20,26,32,29,0,107,LAC,38,44,19,27,0,128
2019-03-04,1,NYK,25,26,29,28,0,108,SAC,34,21,31,29,0,115
2019-03-06,2,NYK,22,25,17,32,0,96,PHO,16,33,32,26,0,107
2019-03-09,3,SAC,23,25,32,22,0,102,NYK,30,16,22,26,0,94
2019-03-10,1,NYK,22,23,20,27,0,92,MIN,23,32,25,23,0,103
2019-03-12,2,NYK,29,23,21,25,0,98,IND,27,28,30,18,0,103
2019-03-15,3,NYK,20,21,28,14,0,83,SAS,31,25,26,27,0,109
2019-03-17,2,LAL,30,36,30,27,0,123,NYK,41,22,31,30,0,124
2019-03-18,1,NYK,29,25,15,23,0,92,TOR,38,35,28,27,0,128
2019-03-20,2,UTA,39,35,37,26,0,137,NYK,25,22,32,37,0,116
2019-03-22,2,DEN,37,19,26,29,0,111,NYK,18,24,20,31,0,93
2019-03-24,2,LAC,29,31,29,35,0,124,NYK,24,35,25,29,0,113
2019-03-28,4,TOR,30,25,32,30,0,117,NYK,18,18,28,28,0,92
2019-03-30,2,MIA,29,26,24,21,0,100,NYK,33,28,18,13,0,92
2019-04-01,2,CHI,19,28,30,28,0,105,NYK,37,27,27,22,0,113
2019-04-03,2,NYK,26,19,29,26,0,100,ORL,26,32,27,29,0,114
2019-04-05,2,NYK,16,27,21,32,0,96,HOU,32,40,31,17,0,120
2019-04-07,2,WAS,23,33,33,21,0,110,NYK,29,23,27,34,0,113
2019-04-09,2,NYK,39,18,17,22,0,96,CHI,24,26,18,18,0,86
2019-04-10,1,DET,36,29,27,23,0,115,NYK,22,19,18,30,0,89
2018-10-17,10,NOP,35,36,30,30,0,131,HOU,29,25,30,28,0,112
2018-10-19,2,SAC,32,31,27,39,0,129,NOP,40,32,38,39,0,149
2018-10-23,4,LAC,26,36,22,25,0,109,NOP,27,32,32,25,0,116
2018-10-26,3,BRK,30,36,25,24,0,115,NOP,32,25,31,29,0,117
2018-10-27,1,UTA,28,36,38,30,0,132,NOP,31,18,33,29,0,111
2018-10-29,2,NOP,24,21,31,35,0,111,DEN,20,38,26,32,0,116
2018-10-31,2,NOP,37,26,29,29,0,121,GSW,43,27,37,24,0,131
2018-11-01,1,NOP,31,34,34,20,0,119,POR,35,35,32,30,0,132
2018-11-03,2,NOP,17,22,29,27,0,95,SAS,24,34,29,22,0,109
2018-11-05,2,NOP,28,35,23,30,0,116,OKC,36,26,38,22,0,122
2018-11-07,2,CHI,26,24,22,26,0,98,NOP,29,29,27,22,0,107
2018-11-10,3,PHO,26,27,29,17,0,99,NOP,33,28,30,28,0,119
2018-11-12,2,NOP,31,35,28,32,0,126,TOR,29,32,22,27,0,110
2018-11-14,2,NOP,28,26,27,19,0,100,MIN,38,29,18,22,0,107
2018-11-16,2,NYK,32,32,32,28,0,124,NOP,16,38,34,41,0,129
2018-11-17,1,DEN,35,32,21,27,0,115,NOP,37,33,28,27,0,125
2018-11-19,2,SAS,39,28,30,29,0,126,NOP,30,38,40,32,0,140
2018-11-21,2,NOP,23,34,30,33,0,120,PHI,38,29,29,25,0,121
2018-11-23,2,NOP,34,26,30,19,0,109,NYK,28,31,28,27,0,114
2018-11-24,1,NOP,34,34,23,23,0,114,WAS,37,31,22,34,0,124
2018-11-26,2,BOS,34,23,32,35,0,124,NOP,21,27,31,28,0,107
2018-11-28,2,WAS,24,23,34,23,0,104,NOP,31,36,31,27,0,125
2018-11-30,2,NOP,17,24,34,26,0,101,MIA,37,24,20,25,0,106
2018-12-02,2,NOP,29,36,22,32,0,119,CHO,30,26,21,32,0,109
2018-12-03,1,LAC,36,41,24,28,0,129,NOP,29,36,32,29,0,126
2018-12-05,2,DAL,31,22,27,26,0,106,NOP,32,37,28,35,0,132
2018-12-07,2,MEM,31,27,27,22,0,107,NOP,30,30,24,19,0,103
2018-12-09,2,NOP,28,28,35,25,0,116,DET,20,30,34,24,0,108
2018-12-10,1,NOP,21,32,19,28,0,100,BOS,28,31,24,30,0,113
2018-12-12,2,OKC,28,28,28,30,0,114,NOP,25,32,32,29,0,118
2018-12-16,4,MIA,33,24,28,17,0,102,NOP,28,23,22,23,0,96
2018-12-19,3,NOP,31,35,24,25,0,115,MIL,33,29,28,33,0,123
2018-12-21,2,NOP,34,31,23,16,0,104,LAL,34,35,25,18,0,112
2018-12-23,2,NOP,36,33,27,21,0,117,SAC,25,33,28,36,0,122
2018-12-26,3,NOP,30,34,30,25,0,119,DAL,33,34,23,32,0,122
2018-12-28,2,DAL,29,37,22,24,0,112,NOP,26,29,31,28,0,114
2018-12-29,1,HOU,30,23,24,31,0,108,NOP,20,30,26,28,0,104
2018-12-31,2,MIN,22,29,38,25,0,114,NOP,27,36,25,35,0,123
2019-01-02,2,NOP,29,29,29,34,0,121,BRK,39,34,32,21,0,126
2019-01-05,3,NOP,28,33,37,35,0,133,CLE,26,26,20,26,0,98
2019-01-07,2,MEM,27,24,22,22,0,95,NOP,31,22,33,28,0,114
2019-01-09,2,CLE,38,25,28,33,0,124,NOP,25,34,41,40,0,140
2019-01-12,3,NOP,29,23,37,17,0,106,MIN,27,27,33,23,0,110
2019-01-14,2,NOP,32,34,28,27,0,121,LAC,36,27,25,29,0,117
2019-01-16,2,NOP,39,32,38,31,0,140,GSW,31,35,44,37,0,147
2019-01-18,2,NOP,29,29,28,26,0,112,POR,32,42,30,24,0,128
2019-01-21,3,NOP,21,33,28,23,0,105,MEM,28,22,18,17,0,85
2019-01-23,2,DET,31,26,22,19,0,98,NOP,28,19,23,24,0,94
2019-01-24,1,NOP,28,25,29,34,0,116,OKC,28,37,33,24,0,122
2019-01-26,2,SAS,28,32,36,30,0,126,NOP,27,30,28,29,0,114
2019-01-29,3,NOP,28,31,35,27,0,121,HOU,35,31,25,25,0,116
2019-01-30,1,DEN,29,24,33,19,0,105,NOP,26,30,19,24,0,99
2019-02-02,3,NOP,24,26,28,30,0,108,SAS,35,28,31,19,0,113
2019-02-04,2,IND,25,28,30,26,0,109,NOP,20,30,24,33,0,107
2019-02-06,2,NOP,37,27,27,34,0,125,CHI,39,26,17,38,0,120
2019-02-08,2,MIN,35,27,26,29,0,117,NOP,22,40,28,32,0,122
2019-02-09,1,NOP,28,16,18,28,0,90,MEM,20,21,31,27,0,99
2019-02-12,3,ORL,39,24,29,26,0,118,NOP,17,29,15,27,0,88
2019-02-14,2,OKC,31,32,26,33,0,122,NOP,31,35,35,30,0,131
2019-02-22,8,NOP,35,36,23,17,0,111,IND,24,34,39,29,0,126
2019-02-23,1,LAL,35,22,27,31,0,115,NOP,42,27,31,28,0,128
2019-02-25,2,PHI,31,34,28,18,0,111,NOP,24,28,31,27,0,110
2019-02-27,2,NOP,28,29,35,27,0,119,LAL,35,28,32,30,0,125
2019-03-01,2,NOP,27,29,38,36,0,130,PHO,32,25,27,32,0,116
2019-03-02,1,NOP,27,40,29,24,0,120,DEN,39,32,22,19,0,112
2019-03-04,2,NOP,24,28,30,33,0,115,UTA,33,28,27,24,0,112
2019-03-06,2,UTA,25,33,27,29,0,114,NOP,23,24,29,28,0,104
2019-03-08,2,TOR,29,35,29,34,0,127,NOP,31,30,19,24,0,104
2019-03-10,2,NOP,33,33,20,30,0,116,ATL,26,39,29,34,0,128
2019-03-12,2,MIL,23,33,45,29,0,130,NOP,23,25,41,24,0,113
2019-03-15,3,POR,30,26,31,35,0,122,NOP,37,20,25,28,0,110
2019-03-16,1,PHO,34,32,23,33,16,138,NOP,31,29,25,37,14,136
2019-03-18,2,NOP,28,21,35,26,19,129,DAL,34,25,20,31,15,125
2019-03-20,2,NOP,25,21,21,29,0,96,ORL,39,29,30,21,0,119
2019-03-24,4,HOU,33,30,24,26,0,113,NOP,19,25,25,21,0,90
2019-03-26,2,ATL,42,28,32,28,0,130,NOP,34,23,30,33,0,120
2019-03-28,2,SAC,26,36,26,30,0,118,NOP,30,34,29,28,0,121
2019-03-31,3,LAL,26,35,44,25,0,130,NOP,26,36,22,18,0,102
2019-04-03,3,CHO,24,35,24,32,0,115,NOP,21,34,23,31,0,109
2019-04-05,2,NOP,38,38,23,18,9,126,PHO,31,34,31,21,16,133
2019-04-07,2,NOP,32,34,36,31,0,133,SAC,39,29,34,27,0,129
2019-04-09,2,GSW,18,38,32,24,0,112,NOP,19,37,23,24,0,103
2018-10-17,10,BRK,29,22,25,24,0,100,DET,24,27,32,20,0,103
2018-10-20,3,DET,25,35,25,33,0,118,CHI,27,31,26,32,0,116
2018-10-23,3,PHI,28,36,30,26,12,132,DET,27,34,26,33,13,133
2018-10-25,2,CLE,27,23,18,35,0,103,DET,30,28,22,30,0,110
2018-10-27,2,BOS,30,33,21,25,0,109,DET,21,20,26,22,0,89
2018-10-30,3,DET,28,30,13,34,0,105,BOS,31,25,25,27,0,108
2018-10-31,1,DET,22,38,23,27,9,119,BRK,28,26,23,33,10,120
2018-11-03,3,DET,24,23,25,27,0,99,PHI,30,39,16,24,0,109
2018-11-05,2,MIA,28,25,34,18,15,120,DET,27,26,27,25,10,115
2018-11-07,2,DET,26,32,20,25,0,103,ORL,31,20,29,16,0,96
2018-11-09,2,DET,40,34,29,21,0,124,ATL,20,31,26,32,0,109
2018-11-11,2,CHO,24,27,32,30,0,113,DET,27,22,26,28,0,103
2018-11-14,3,DET,26,27,24,29,0,106,TOR,31,34,23,16,0,104
2018-11-19,5,CLE,27,19,23,33,0,102,DET,38,28,27,20,0,113
2018-11-21,2,DET,29,28,26,41,0,124,HOU,31,25,37,33,0,126
2018-11-23,2,HOU,30,26,23,19,13,111,DET,34,27,17,20,18,116
2018-11-25,2,PHO,32,28,24,23,0,107,DET,27,35,21,35,0,118
2018-11-27,2,NYK,19,24,27,38,0,108,DET,24,27,30,34,0,115
2018-11-30,3,CHI,21,19,25,23,0,88,DET,34,21,24,28,0,107
2018-12-01,1,GSW,24,22,32,24,0,102,DET,24,30,31,26,0,111
2018-12-03,2,OKC,26,24,37,23,0,110,DET,17,23,19,24,0,83
2018-12-05,2,DET,21,24,19,28,0,92,MIL,30,26,28,31,0,115
2018-12-07,2,PHI,28,28,33,28,0,117,DET,27,41,22,21,0,111
2018-12-09,2,NOP,28,28,35,25,0,116,DET,20,30,34,24,0,108
2018-12-10,1,DET,29,18,29,26,0,102,PHI,38,18,31,29,0,116
2018-12-12,2,DET,25,30,38,14,0,107,CHO,37,23,22,26,0,108
2018-12-15,3,BOS,33,23,22,26,0,104,DET,33,24,28,28,0,113
2018-12-17,2,MIL,25,30,26,26,0,107,DET,27,16,34,27,0,104
2018-12-19,2,DET,27,26,25,40,11,129,MIN,26,36,30,26,5,123
2018-12-21,2,DET,21,19,25,21,0,86,CHO,25,20,30,23,0,98
2018-12-23,2,ATL,28,29,22,19,0,98,DET,21,22,23,29,0,95
2018-12-26,3,WAS,28,27,17,23,0,95,DET,27,27,31,21,0,106
2018-12-28,2,DET,21,24,24,19,0,88,IND,32,26,33,34,0,125
2018-12-30,2,DET,21,38,24,24,0,107,ORL,31,31,23,24,0,109
2019-01-01,2,DET,27,25,21,25,0,98,MIL,35,33,24,29,0,121
2019-01-02,1,DET,26,25,21,29,0,101,MEM,24,31,12,27,0,94
2019-01-05,3,UTA,13,35,28,34,0,110,DET,31,22,25,27,0,105
2019-01-07,2,SAS,25,34,25,35,0,119,DET,31,20,22,34,0,107
2019-01-09,2,DET,24,23,30,23,0,100,LAL,20,35,34,24,0,113
2019-01-10,1,DET,21,27,26,28,0,102,SAC,34,31,26,21,0,112
2019-01-12,2,DET,37,28,25,19,0,109,LAC,24,30,26,24,0,104
2019-01-14,2,DET,31,28,15,20,0,94,UTA,27,26,22,25,0,100
2019-01-16,2,ORL,34,29,21,25,6,115,DET,26,32,32,19,11,120
2019-01-18,2,MIA,17,22,30,24,0,93,DET,30,23,12,33,0,98
2019-01-19,1,SAC,26,25,23,29,0,103,DET,30,27,25,19,0,101
2019-01-21,2,DET,17,17,30,23,0,87,WAS,29,21,31,20,0,101
2019-01-23,2,DET,31,26,22,19,0,98,NOP,28,19,23,24,0,94
2019-01-25,2,DET,28,26,31,16,0,101,DAL,23,39,26,18,0,106
2019-01-29,4,MIL,30,32,27,26,0,115,DET,22,27,28,28,0,105
2019-01-31,2,DAL,21,28,21,19,0,89,DET,19,26,18,30,0,93
2019-02-02,2,LAC,22,25,29,35,0,111,DET,40,25,22,14,0,101
2019-02-04,2,DEN,36,19,28,20,0,103,DET,34,34,29,32,0,129
2019-02-05,1,DET,36,27,15,27,0,105,NYK,28,26,17,21,0,92
2019-02-08,3,NYK,22,32,30,19,0,103,DET,41,22,26,31,0,120
2019-02-11,3,WAS,27,32,20,33,0,112,DET,36,25,29,31,0,121
2019-02-13,2,DET,29,23,20,38,0,110,BOS,28,29,34,27,0,118
2019-02-22,9,DET,33,35,32,25,0,125,ATL,34,36,25,27,0,122
2019-02-23,1,DET,20,34,30,35,0,119,MIA,29,17,30,20,0,96
2019-02-25,2,IND,20,31,26,32,0,109,DET,36,19,29,29,0,113
2019-02-27,2,DET,27,21,19,26,0,93,SAS,32,19,27,27,0,105
2019-03-02,3,DET,42,29,29,29,0,129,CLE,23,15,34,21,0,93
2019-03-03,1,TOR,19,26,33,22,7,107,DET,24,24,25,27,12,112
2019-03-06,3,MIN,35,29,24,26,0,114,DET,22,38,30,41,0,131
2019-03-08,2,DET,24,25,20,43,0,112,CHI,30,36,14,24,0,104
2019-03-10,2,CHI,32,23,25,28,0,108,DET,31,30,42,28,0,131
2019-03-11,1,DET,19,16,27,13,0,75,BRK,27,34,27,15,0,103
2019-03-13,2,DET,18,31,8,17,0,74,MIA,30,24,33,21,0,108
2019-03-15,2,LAL,22,18,22,35,0,97,DET,27,19,31,34,0,111
2019-03-17,2,TOR,21,26,37,23,0,107,DET,25,25,28,32,0,110
2019-03-18,1,DET,32,29,27,31,0,119,CLE,25,35,27,39,0,126
2019-03-21,3,DET,29,29,29,31,0,118,PHO,32,28,20,18,0,98
2019-03-23,2,DET,28,28,36,20,0,112,POR,32,27,30,28,0,117
2019-03-24,1,DET,28,21,28,37,0,114,GSW,29,34,34,24,0,121
2019-03-26,2,DET,9,30,23,30,0,92,DEN,27,39,15,14,0,95
2019-03-28,2,ORL,27,19,25,27,0,98,DET,30,30,34,21,0,115
2019-03-30,2,POR,14,20,25,31,0,90,DET,11,20,35,33,0,99
2019-04-01,2,DET,33,22,25,22,0,102,IND,23,36,28,24,0,111
2019-04-03,2,IND,18,26,34,30,0,108,DET,15,21,26,27,0,89
2019-04-05,2,DET,34,32,30,14,0,110,OKC,30,35,32,26,0,123
2019-04-07,2,CHO,32,28,23,21,0,104,DET,27,15,33,16,0,91
2019-04-09,2,MEM,32,25,22,14,0,93,DET,20,18,26,36,0,100
2019-04-10,1,DET,36,29,27,23,0,115,NYK,22,19,18,30,0,89
2018-10-17,10,ATL,24,25,35,23,0,107,NYK,23,49,34,20,0,126
2018-10-19,2,ATL,33,28,21,35,0,117,MEM,37,40,29,25,0,131
2018-10-21,2,ATL,24,40,28,41,0,133,CLE,34,26,26,25,0,111
2018-10-24,3,DAL,42,16,29,17,0,104,ATL,22,26,32,31,0,111
2018-10-27,3,CHI,22,19,26,30,0,97,ATL,25,19,19,22,0,85
2018-10-29,2,ATL,25,22,13,32,0,92,PHI,20,27,31,35,0,113
2018-10-30,1,ATL,31,26,30,27,0,114,CLE,35,23,41,37,0,136
2018-11-01,2,SAC,35,34,46,31,0,146,ATL,29,35,23,28,0,115
2018-11-03,2,MIA,31,37,25,25,0,118,ATL,41,33,28,21,0,123
2018-11-06,3,ATL,25,29,23,25,0,102,CHO,23,28,30,32,0,113
2018-11-07,1,NYK,26,26,35,25,0,112,ATL,26,29,18,34,0,107
2018-11-09,2,DET,40,34,29,21,0,124,ATL,20,31,26,32,0,109
2018-11-11,2,ATL,22,31,22,31,0,106,LAL,28,24,32,23,0,107
2018-11-13,2,ATL,23,29,24,27,0,103,GSW,20,29,33,28,0,110
2018-11-15,2,ATL,23,34,16,20,0,93,DEN,35,38,36,29,0,138
2018-11-17,2,ATL,24,32,16,17,0,89,IND,25,22,26,24,0,97
2018-11-19,2,LAC,29,32,28,38,0,127,ATL,34,30,32,23,0,119
2018-11-21,2,TOR,29,26,31,38,0,124,ATL,24,20,29,35,0,108
2018-11-23,2,BOS,45,16,21,32,0,114,ATL,23,22,19,32,0,96
2018-11-25,2,CHO,43,23,31,26,0,123,ATL,32,33,35,24,0,124
2018-11-27,2,ATL,35,33,32,15,0,115,MIA,38,14,34,27,0,113
2018-11-28,1,ATL,28,21,26,19,0,94,CHO,24,31,31,22,0,108
2018-11-30,2,ATL,26,20,30,33,0,109,OKC,28,38,25,33,0,124
2018-12-03,3,GSW,34,27,36,31,0,128,ATL,17,30,30,34,0,111
2018-12-05,2,WAS,33,39,31,28,0,131,ATL,25,24,45,23,0,117
2018-12-08,3,DEN,35,21,21,21,0,98,ATL,25,26,35,20,0,106
2018-12-12,4,ATL,26,26,26,29,0,107,DAL,28,23,30,33,0,114
2018-12-14,2,ATL,19,37,26,26,0,108,BOS,42,25,41,21,0,129
2018-12-16,2,ATL,23,43,30,31,0,127,BRK,42,30,39,33,0,144
2018-12-18,2,WAS,24,30,28,28,0,110,ATL,35,23,24,36,0,118
2018-12-21,3,ATL,28,32,27,27,0,114,NYK,39,30,20,18,0,107
2018-12-23,2,ATL,28,29,22,19,0,98,DET,21,22,23,29,0,95
2018-12-26,3,IND,32,32,31,34,0,129,ATL,31,36,21,33,0,121
2018-12-28,2,ATL,42,29,18,23,11,123,MIN,27,32,30,23,8,120
2018-12-29,1,CLE,26,25,23,34,0,108,ATL,23,34,27,27,0,111
2018-12-31,2,ATL,25,35,21,27,0,108,IND,33,30,34,19,0,116
2019-01-02,2,ATL,29,24,31,14,0,98,WAS,35,29,24,26,0,114
2019-01-04,2,ATL,14,29,36,33,0,112,MIL,43,33,42,26,0,144
2019-01-06,2,MIA,16,21,21,24,0,82,ATL,23,15,41,27,0,106
2019-01-08,2,ATL,31,26,20,24,0,101,TOR,28,28,24,24,0,104
2019-01-09,1,ATL,38,19,23,20,0,100,BRK,23,28,35,30,0,116
2019-01-11,2,ATL,32,22,35,34,0,123,PHI,30,26,32,33,0,121
2019-01-13,2,MIL,35,29,31,38,0,133,ATL,32,23,29,30,0,114
2019-01-15,2,OKC,29,30,41,26,0,126,ATL,25,45,27,45,0,142
2019-01-19,4,BOS,28,32,23,30,0,113,ATL,36,31,22,16,0,105
2019-01-21,2,ORL,28,32,31,31,0,122,ATL,31,26,21,25,0,103
2019-01-23,2,ATL,42,24,32,23,0,121,CHI,25,35,23,18,0,101
2019-01-26,3,ATL,30,34,26,21,0,111,POR,40,23,30,27,0,120
2019-01-28,2,ATL,32,31,31,29,0,123,LAC,25,36,22,35,0,118
2019-01-30,2,ATL,31,22,27,33,0,113,SAC,32,35,38,30,0,135
2019-02-01,2,ATL,34,26,27,25,0,112,UTA,36,22,38,32,0,128
2019-02-02,1,ATL,33,25,28,32,0,118,PHO,30,27,31,24,0,112
2019-02-04,2,ATL,35,26,38,38,0,137,WAS,20,37,32,40,0,129
2019-02-07,3,TOR,22,38,28,31,0,119,ATL,33,35,17,16,0,101
2019-02-09,2,CHO,46,27,33,23,0,129,ATL,31,37,18,34,0,120
2019-02-10,1,ORL,26,37,35,26,0,124,ATL,25,23,26,34,0,108
2019-02-12,2,LAL,32,37,26,18,0,113,ATL,38,27,35,17,0,117
2019-02-14,2,NYK,28,26,28,24,0,106,ATL,13,38,22,18,0,91
2019-02-22,8,DET,33,35,32,25,0,125,ATL,34,36,25,27,0,122
2019-02-23,1,PHO,33,26,28,25,0,112,ATL,33,30,23,34,0,120
2019-02-25,2,ATL,28,32,25,26,0,111,HOU,39,21,35,24,0,119
2019-02-27,2,MIN,40,28,27,23,5,123,ATL,33,27,26,32,13,131
2019-03-01,2,CHI,26,31,38,29,16,168,ATL,33,27,24,40,16,161
2019-03-03,2,ATL,35,32,29,27,0,123,CHI,32,28,31,27,0,118
2019-03-04,1,ATL,31,30,24,28,0,113,MIA,32,29,24,29,0,114
2019-03-06,2,SAS,27,26,27,31,0,111,ATL,23,33,21,27,0,104
2019-03-09,3,BRK,26,30,27,31,0,114,ATL,23,24,30,35,0,112
2019-03-10,1,NOP,33,33,20,30,0,116,ATL,26,39,29,34,0,128
2019-03-13,3,MEM,28,32,30,21,0,111,ATL,33,39,38,22,0,132
2019-03-16,3,ATL,36,26,30,28,0,120,BOS,43,31,31,24,0,129
2019-03-17,1,ATL,25,21,22,23,0,91,ORL,28,28,19,26,0,101
2019-03-19,2,HOU,25,28,31,37,0,121,ATL,25,22,25,33,0,105
2019-03-21,2,UTA,28,26,37,23,0,114,ATL,29,36,21,31,0,117
2019-03-23,2,PHI,41,27,32,27,0,127,ATL,34,40,26,29,0,129
2019-03-26,3,ATL,42,28,32,28,0,130,NOP,34,23,30,33,0,120
2019-03-29,3,POR,38,22,30,28,0,118,ATL,30,21,25,22,0,98
2019-03-31,2,MIL,43,28,26,25,13,135,ATL,26,42,30,24,14,136
2019-04-02,2,ATL,31,25,34,21,0,111,SAS,33,25,28,31,0,117
2019-04-03,1,PHI,38,30,26,28,0,122,ATL,42,30,26,32,0,130
2019-04-05,2,ATL,18,30,32,33,0,113,ORL,42,39,32,36,0,149
2019-04-07,2,ATL,21,24,27,35,0,107,MIL,28,26,31,30,0,115
2019-04-10,3,IND,35,38,36,26,0,135,ATL,28,41,34,31,0,134
2018-10-18,10,CHI,41,17,18,32,0,108,PHI,38,27,37,25,0,127
2018-10-20,2,DET,25,35,25,33,0,118,CHI,27,31,26,32,0,116
2018-10-22,2,CHI,28,33,23,25,0,109,DAL,31,28,29,27,0,115
2018-10-24,2,CHO,27,26,29,28,0,110,CHI,24,30,34,24,0,112
2018-10-26,2,CHI,25,29,21,31,0,106,CHO,23,45,34,33,0,135
2018-10-27,1,CHI,22,19,26,30,0,97,ATL,25,19,19,22,0,85
2018-10-29,2,GSW,44,48,33,24,0,149,CHI,28,22,39,35,0,124
2018-10-31,2,DEN,28,23,29,18,10,108,CHI,24,24,30,20,9,107
2018-11-02,2,IND,22,38,27,20,0,107,CHI,37,21,22,25,0,105
2018-11-03,1,HOU,27,27,21,21,0,96,CHI,28,28,7,25,0,88
2018-11-05,2,CHI,24,23,31,24,6,116,NYK,21,26,25,30,6,115
2018-11-07,2,CHI,26,24,22,26,0,98,NOP,29,29,27,22,0,107
2018-11-10,3,CLE,23,30,24,21,0,98,CHI,37,16,26,20,0,99
2018-11-12,2,DAL,25,31,22,25,0,103,CHI,20,29,26,23,0,98
2018-11-14,2,CHI,24,11,24,23,0,82,BOS,19,32,26,34,0,111
2018-11-16,2,CHI,40,23,17,24,0,104,MIL,27,18,46,32,0,123
2018-11-17,1,TOR,27,30,32,33,0,122,CHI,18,26,12,27,0,83
2018-11-21,4,PHO,28,41,24,23,0,116,CHI,25,39,30,30,0,124
2018-11-23,2,MIA,28,32,18,25,0,103,CHI,26,13,30,27,0,96
2018-11-24,1,CHI,22,28,29,17,0,96,MIN,20,29,35,27,0,111
2018-11-26,2,SAS,27,25,28,28,0,108,CHI,27,23,33,24,0,107
2018-11-28,2,CHI,40,22,27,24,0,113,MIL,30,33,29,24,0,116
2018-11-30,2,CHI,21,19,25,23,0,88,DET,34,21,24,28,0,107
2018-12-01,1,CHI,22,24,29,30,0,105,HOU,38,18,31,34,0,121
2018-12-04,3,CHI,21,24,22,23,0,90,IND,23,20,27,26,0,96
2018-12-07,3,OKC,28,34,29,21,0,112,CHI,34,36,17,27,0,114
2018-12-08,1,BOS,35,29,29,40,0,133,CHI,17,26,17,17,0,77
2018-12-10,2,SAC,26,19,36,27,0,108,CHI,33,23,18,15,0,89
2018-12-13,3,CHI,26,20,25,20,0,91,ORL,24,27,26,20,0,97
2018-12-15,2,CHI,21,22,31,24,0,98,SAS,28,34,16,15,0,93
2018-12-17,2,CHI,22,22,25,27,0,96,OKC,31,33,24,33,0,121
2018-12-19,2,BRK,22,18,31,25,0,96,CHI,27,12,32,22,0,93
2018-12-21,2,ORL,20,19,24,17,0,80,CHI,19,27,27,17,0,90
2018-12-23,2,CHI,28,26,30,28,0,112,CLE,29,30,15,18,0,92
2018-12-26,3,MIN,29,31,23,36,0,119,CHI,18,19,28,29,0,94
2018-12-28,2,CHI,20,20,34,27,0,101,WAS,22,20,30,20,0,92
2018-12-30,2,CHI,20,19,26,24,0,89,TOR,14,26,28,27,0,95
2019-01-02,3,ORL,32,30,28,22,0,112,CHI,16,29,17,22,0,84
2019-01-04,2,IND,18,36,21,30,14,119,CHI,30,28,20,27,11,116
2019-01-06,2,BRK,28,27,33,29,0,117,CHI,21,34,27,18,0,100
2019-01-09,3,CHI,29,22,34,27,0,112,POR,30,26,39,29,0,124
2019-01-11,2,CHI,17,38,21,33,0,109,GSW,43,33,40,30,0,146
2019-01-12,1,CHI,19,34,29,20,0,102,UTA,29,22,30,29,0,110
2019-01-15,3,CHI,18,25,25,32,0,100,LAL,19,25,32,31,0,107
2019-01-17,2,CHI,30,17,26,32,0,105,DEN,28,33,42,32,0,135
2019-01-19,2,MIA,31,24,28,34,0,117,CHI,30,27,19,27,0,103
2019-01-21,2,CHI,31,17,28,28,0,104,CLE,18,24,25,21,0,88
2019-01-23,2,ATL,42,24,32,23,0,121,CHI,25,35,23,18,0,101
2019-01-25,2,LAC,27,25,28,26,0,106,CHI,20,36,26,19,0,101
2019-01-27,2,CLE,27,24,28,25,0,104,CHI,29,24,26,22,0,101
2019-01-29,2,CHI,19,35,25,38,0,117,BRK,20,30,33,39,0,122
2019-01-30,1,CHI,31,19,28,27,0,105,MIA,21,27,20,21,0,89
2019-02-02,3,CHI,26,34,26,32,0,118,CHO,27,24,37,37,0,125
2019-02-06,4,NOP,37,27,27,34,0,125,CHI,39,26,17,38,0,120
2019-02-08,2,CHI,32,23,38,32,0,125,BRK,27,21,32,26,0,106
2019-02-09,1,WAS,34,42,30,28,0,134,CHI,32,29,35,29,0,125
2019-02-11,2,MIL,22,28,29,33,0,112,CHI,21,28,22,28,0,99
2019-02-13,2,MEM,32,30,21,27,0,110,CHI,36,31,25,30,0,122
2019-02-22,9,CHI,24,27,38,21,0,110,ORL,26,27,29,27,0,109
2019-02-23,1,BOS,33,18,30,35,0,116,CHI,28,36,30,32,0,126
2019-02-25,2,MIL,25,38,27,27,0,117,CHI,38,16,26,26,0,106
2019-02-27,2,CHI,20,26,29,34,0,109,MEM,20,26,28,33,0,107
2019-03-01,2,CHI,26,31,38,29,16,168,ATL,33,27,24,40,16,161
2019-03-03,2,ATL,35,32,29,27,0,123,CHI,32,28,31,27,0,118
2019-03-05,2,CHI,17,25,33,21,0,96,IND,27,22,28,28,0,105
2019-03-06,1,PHI,30,27,29,21,0,107,CHI,30,27,25,26,0,108
2019-03-08,2,DET,24,25,20,43,0,112,CHI,30,36,14,24,0,104
2019-03-10,2,CHI,32,23,25,28,0,108,DET,31,30,42,28,0,131
2019-03-12,2,LAL,16,39,43,25,0,123,CHI,34,26,24,23,0,107
2019-03-15,3,CHI,34,29,21,37,0,121,LAC,29,28,45,26,0,128
2019-03-17,2,CHI,23,17,31,31,0,102,SAC,24,32,43,30,0,129
2019-03-18,1,CHI,34,22,30,30,0,116,PHO,20,23,30,28,0,101
2019-03-20,2,WAS,28,32,21,32,7,120,CHI,35,25,25,28,13,126
2019-03-23,3,UTA,33,37,21,23,0,114,CHI,18,18,25,22,0,83
2019-03-26,3,CHI,18,23,31,31,0,103,TOR,26,30,29,27,0,112
2019-03-27,1,POR,27,32,28,31,0,118,CHI,14,27,24,33,0,98
2019-03-30,3,TOR,26,41,26,31,0,124,CHI,28,28,19,26,0,101
2019-04-01,2,CHI,19,28,30,28,0,105,NYK,37,27,27,22,0,113
2019-04-03,2,CHI,26,30,27,32,0,115,WAS,28,29,30,27,0,114
2019-04-06,3,PHI,24,33,29,30,0,116,CHI,20,29,19,28,0,96
2019-04-09,3,NYK,39,18,17,22,0,96,CHI,24,26,18,18,0,86
2019-04-10,1,CHI,20,22,22,45,0,109,PHI,32,30,35,28,0,125
2018-10-17,10,MIA,31,20,27,23,0,101,ORL,25,29,25,25,0,104
2018-10-18,1,MIA,24,34,27,28,0,113,WAS,25,34,30,23,0,112
2018-10-20,2,CHO,34,38,20,21,0,113,MIA,29,23,30,30,0,112
2018-10-24,4,NYK,27,18,20,22,0,87,MIA,16,31,45,18,0,110
2018-10-27,3,POR,22,20,37,32,0,111,MIA,33,24,32,31,0,120
2018-10-29,2,SAC,17,34,43,29,0,123,MIA,28,23,32,30,0,113
2018-10-30,1,MIA,29,26,18,40,0,113,CHO,31,34,27,33,0,125
2018-11-03,4,MIA,31,37,25,25,0,118,ATL,41,33,28,21,0,123
2018-11-05,2,MIA,28,25,34,18,15,120,DET,27,26,27,25,10,115
2018-11-07,2,SAS,20,22,22,24,0,88,MIA,27,23,25,20,0,95
2018-11-09,2,IND,24,27,33,26,0,110,MIA,26,33,21,22,0,102
2018-11-10,1,WAS,25,33,25,33,0,116,MIA,35,26,24,25,0,110
2018-11-12,2,PHI,32,32,32,28,0,124,MIA,26,36,28,24,0,114
2018-11-14,2,MIA,37,24,29,30,0,120,BRK,21,28,23,35,0,107
2018-11-16,2,MIA,27,16,24,24,0,91,IND,18,32,22,27,0,99
2018-11-18,2,LAL,34,33,25,21,0,113,MIA,21,31,24,21,0,97
2018-11-20,2,BRK,20,19,35,30,0,104,MIA,13,29,35,15,0,92
2018-11-23,3,MIA,28,32,18,25,0,103,CHI,26,13,30,27,0,96
2018-11-25,2,MIA,29,25,35,26,0,115,TOR,36,27,38,24,0,125
2018-11-27,2,ATL,35,33,32,15,0,115,MIA,38,14,34,27,0,113
2018-11-30,3,NOP,17,24,34,26,0,101,MIA,37,24,20,25,0,106
2018-12-02,2,UTA,35,20,22,23,0,100,MIA,27,26,27,22,0,102
2018-12-04,2,ORL,27,19,30,29,0,105,MIA,25,25,12,28,0,90
2018-12-07,3,MIA,34,26,29,26,0,115,PHO,36,14,23,25,0,98
2018-12-08,1,MIA,34,31,26,30,0,121,LAC,30,32,28,8,0,98
2018-12-10,2,MIA,23,35,25,22,0,105,LAL,27,28,29,24,0,108
2018-12-12,2,MIA,15,18,20,31,0,84,UTA,40,20,32,19,0,111
2018-12-14,2,MIA,29,22,20,29,0,100,MEM,28,21,24,24,0,97
2018-12-16,2,MIA,33,24,28,17,0,102,NOP,28,23,22,23,0,96
2018-12-20,4,HOU,33,25,18,23,0,99,MIA,21,32,29,19,0,101
2018-12-22,2,MIL,8,30,20,29,0,87,MIA,21,16,35,22,0,94
2018-12-23,1,MIA,28,25,37,25,0,115,ORL,17,27,27,20,0,91
2018-12-26,3,TOR,23,21,37,25,0,106,MIA,31,27,21,25,0,104
2018-12-28,2,CLE,30,22,17,25,0,94,MIA,29,27,26,36,0,118
2018-12-30,2,MIN,30,25,31,27,0,113,MIA,19,35,23,27,0,104
2019-01-02,3,MIA,22,36,35,24,0,117,CLE,23,20,30,19,0,92
2019-01-04,2,WAS,24,34,28,23,0,109,MIA,31,30,34,20,0,115
2019-01-06,2,MIA,16,21,21,24,0,82,ATL,23,15,41,27,0,106
2019-01-08,2,DEN,24,25,27,27,0,103,MIA,18,34,24,23,0,99
2019-01-10,2,BOS,24,19,29,27,0,99,MIA,28,33,22,32,0,115
2019-01-12,2,MEM,34,27,22,25,0,108,MIA,30,33,28,21,0,112
2019-01-15,3,MIA,23,22,18,23,0,86,MIL,30,39,24,31,0,124
2019-01-18,3,MIA,17,22,30,24,0,93,DET,30,23,12,33,0,98
2019-01-19,1,MIA,31,24,28,34,0,117,CHI,30,27,19,27,0,103
2019-01-21,2,MIA,23,27,18,31,0,99,BOS,33,17,37,20,0,107
2019-01-23,2,LAC,27,27,23,34,0,111,MIA,31,23,18,27,0,99
2019-01-25,2,MIA,27,21,32,20,0,100,CLE,23,30,17,24,0,94
2019-01-27,2,MIA,25,27,29,25,0,106,NYK,26,32,12,27,0,97
2019-01-30,3,CHI,31,19,28,27,0,105,MIA,21,27,20,21,0,89
2019-02-01,2,OKC,31,41,22,24,0,118,MIA,24,29,21,28,0,102
2019-02-02,1,IND,21,32,31,11,0,95,MIA,27,27,23,11,0,88
2019-02-05,3,MIA,34,28,32,24,0,118,POR,30,25,24,29,0,108
2019-02-08,3,MIA,28,31,24,13,0,96,SAC,17,33,25,27,0,102
2019-02-10,2,MIA,34,25,23,36,0,118,GSW,24,30,36,30,0,120
2019-02-11,1,MIA,27,22,21,17,0,87,DEN,35,19,29,20,0,103
2019-02-13,2,MIA,29,28,32,23,0,112,DAL,25,33,16,27,0,101
2019-02-21,8,MIA,21,29,25,27,0,102,PHI,29,28,16,33,0,106
2019-02-23,2,DET,20,34,30,35,0,119,MIA,29,17,30,20,0,96
2019-02-25,2,PHO,23,29,32,40,0,124,MIA,29,34,24,34,0,121
2019-02-27,2,GSW,22,37,33,33,0,125,MIA,32,42,26,26,0,126
2019-02-28,1,MIA,32,37,29,20,0,118,HOU,33,22,31,35,0,121
2019-03-02,2,BRK,23,21,20,24,0,88,MIA,28,26,30,33,0,117
2019-03-04,2,ATL,31,30,24,28,0,113,MIA,32,29,24,29,0,114
2019-03-06,2,MIA,29,14,18,30,0,91,CHO,18,25,15,26,0,84
2019-03-08,2,CLE,29,28,26,27,0,110,MIA,28,29,37,32,0,126
2019-03-10,2,TOR,32,36,23,34,0,125,MIA,27,27,25,25,0,104
2019-03-13,3,DET,18,31,8,17,0,74,MIA,30,24,33,21,0,108
2019-03-15,2,MIL,19,23,37,34,0,113,MIA,37,25,18,18,0,98
2019-03-17,2,CHO,20,19,21,15,0,75,MIA,19,20,22,32,0,93
2019-03-18,1,MIA,27,31,28,30,0,116,OKC,25,30,20,32,0,107
2019-03-20,2,MIA,24,38,28,20,0,110,SAS,22,25,31,27,0,105
2019-03-22,2,MIA,32,19,18,18,0,87,MIL,33,30,31,22,0,116
2019-03-23,1,MIA,25,27,26,35,0,113,WAS,27,26,26,29,0,108
2019-03-26,3,ORL,18,24,34,28,0,104,MIA,32,19,19,29,0,99
2019-03-28,2,DAL,29,30,23,17,0,99,MIA,26,23,26,30,0,105
2019-03-30,2,MIA,29,26,24,21,0,100,NYK,33,28,18,13,0,92
2019-04-01,2,MIA,17,30,30,28,0,105,BOS,36,25,27,22,0,110
2019-04-03,2,BOS,29,24,30,29,0,112,MIA,31,18,32,21,0,102
2019-04-05,2,MIA,35,34,22,18,0,109,MIN,36,25,29,21,0,111
2019-04-07,2,MIA,26,31,22,24,6,109,TOR,25,25,28,25,14,117
2019-04-09,2,PHI,20,22,18,39,0,99,MIA,34,27,30,31,0,122
2019-04-10,1,MIA,23,24,24,23,0,94,BRK,32,31,29,21,0,113
2018-10-17,10,MEM,16,23,19,25,0,83,IND,27,29,20,35,0,111
2018-10-19,2,ATL,33,28,21,35,0,117,MEM,37,40,29,25,0,131
2018-10-22,3,MEM,19,28,23,22,0,92,UTA,22,24,17,21,0,84
2018-10-24,2,MEM,28,24,19,21,0,92,SAC,19,25,27,26,0,97
2018-10-27,3,PHO,18,25,28,25,0,96,MEM,26,42,19,30,0,117
2018-10-30,3,WAS,24,21,27,23,0,95,MEM,22,24,32,29,0,107
2018-11-02,3,MEM,29,24,30,27,0,110,UTA,31,29,18,22,0,100
2018-11-04,2,MEM,28,28,25,19,0,100,PHO,21,31,25,25,0,102
2018-11-05,1,MEM,31,27,15,28,0,101,GSW,29,29,34,25,0,117
2018-11-07,2,DEN,29,18,23,17,0,87,MEM,22,28,20,19,0,89
2018-11-10,3,PHI,26,37,17,22,4,106,MEM,21,29,24,28,10,112
2018-11-12,2,UTA,20,20,34,22,0,96,MEM,16,27,26,19,0,88
2018-11-14,2,MEM,29,19,36,32,0,116,MIL,19,26,35,33,0,113
2018-11-16,2,SAC,28,23,27,26,0,104,MEM,29,33,25,25,0,112
2018-11-18,2,MEM,17,30,28,25,0,100,MIN,20,23,19,25,0,87
2018-11-19,1,DAL,21,28,25,14,0,88,MEM,25,28,21,24,0,98
2018-11-21,2,MEM,30,31,20,23,0,104,SAS,32,27,18,26,0,103
2018-11-23,2,MEM,22,30,18,28,9,107,LAC,16,28,31,23,14,112
2018-11-25,2,NYK,21,22,35,25,0,103,MEM,26,26,19,27,0,98
2018-11-27,2,TOR,31,28,34,29,0,122,MEM,32,39,26,17,0,114
2018-11-30,3,MEM,26,32,27,26,6,131,BRK,26,32,22,31,6,125
2018-12-02,2,MEM,25,19,24,27,0,95,PHI,26,28,24,25,0,103
2018-12-05,3,LAC,15,27,27,17,0,86,MEM,27,24,18,27,0,96
2018-12-07,2,MEM,31,27,27,22,0,107,NOP,30,30,24,19,0,103
2018-12-08,1,LAL,27,36,28,20,0,111,MEM,16,24,26,22,0,88
2018-12-10,2,MEM,22,28,33,16,0,99,DEN,26,29,29,21,0,105
2018-12-12,2,POR,26,14,23,20,0,83,MEM,15,27,26,24,0,92
2018-12-14,2,MIA,29,22,20,29,0,100,MEM,28,21,24,24,0,97
2018-12-15,1,HOU,36,25,18,26,0,105,MEM,29,11,25,32,0,97
2018-12-17,2,MEM,22,16,29,26,0,93,GSW,30,31,23,26,0,110
2018-12-19,2,MEM,18,34,19,21,0,92,POR,17,30,27,25,0,99
2018-12-21,2,MEM,32,21,21,25,0,99,SAC,24,16,25,37,0,102
2018-12-23,2,MEM,26,24,22,35,0,107,LAL,20,26,29,24,0,99
2018-12-26,3,CLE,9,23,21,34,0,87,MEM,21,24,20,30,0,95
2018-12-29,3,BOS,29,18,32,33,0,112,MEM,26,38,23,16,0,103
2018-12-31,2,MEM,18,20,35,28,0,101,HOU,27,34,25,27,0,113
2019-01-02,2,DET,26,25,21,29,0,101,MEM,24,31,12,27,0,94
2019-01-04,2,BRK,26,22,33,28,0,109,MEM,26,21,30,23,0,100
2019-01-05,1,MEM,25,19,22,22,0,88,SAS,27,37,24,20,0,108
2019-01-07,2,MEM,27,24,22,22,0,95,NOP,31,22,33,28,0,114
2019-01-09,2,SAS,18,13,33,22,0,86,MEM,22,20,30,24,0,96
2019-01-12,3,MEM,34,27,22,25,0,108,MIA,30,33,28,21,0,112
2019-01-14,2,MEM,29,19,22,24,0,94,HOU,24,30,33,25,0,112
2019-01-16,2,MIL,28,22,41,20,0,111,MEM,20,25,28,28,0,101
2019-01-18,2,MEM,24,38,29,25,0,116,BOS,35,23,38,26,0,122
2019-01-19,1,MEM,19,29,14,28,0,90,TOR,23,32,45,19,0,119
2019-01-21,2,NOP,21,33,28,23,0,105,MEM,28,22,18,17,0,85
2019-01-23,2,CHO,23,35,28,32,0,118,MEM,22,32,22,31,0,107
2019-01-25,2,SAC,24,24,29,22,0,99,MEM,23,19,29,25,0,96
2019-01-26,1,IND,19,23,27,34,0,103,MEM,24,29,25,28,0,106
2019-01-28,2,DEN,16,25,19,35,0,95,MEM,30,30,17,15,0,92
2019-01-30,2,MEM,16,28,25,24,4,97,MIN,24,20,27,22,6,99
2019-02-01,2,MEM,29,16,28,19,0,92,CHO,17,28,25,30,0,100
2019-02-03,2,MEM,19,23,32,22,0,96,NYK,22,19,21,22,0,84
2019-02-05,2,MIN,19,35,29,23,0,106,MEM,32,34,19,23,0,108
2019-02-07,2,MEM,32,21,19,23,0,95,OKC,27,24,32,34,0,117
2019-02-09,2,NOP,28,16,18,28,0,90,MEM,20,21,31,27,0,99
2019-02-12,3,SAS,20,37,37,14,0,108,MEM,33,25,28,21,0,107
2019-02-13,1,MEM,32,30,21,27,0,110,CHI,36,31,25,30,0,122
2019-02-22,9,LAC,36,29,18,29,0,112,MEM,23,30,33,20,0,106
2019-02-23,1,MEM,24,32,28,23,0,107,CLE,37,26,19,30,0,112
2019-02-25,2,LAL,31,25,25,24,0,105,MEM,34,27,26,23,0,110
2019-02-27,2,CHI,20,26,29,34,0,109,MEM,20,26,28,33,0,107
2019-03-02,3,MEM,33,29,28,21,0,111,DAL,21,28,18,14,0,81
2019-03-03,1,MEM,28,24,23,20,0,95,OKC,25,21,21,32,0,99
2019-03-05,2,POR,33,30,23,25,0,111,MEM,20,41,21,38,0,120
2019-03-08,3,UTA,23,30,26,25,0,104,MEM,29,31,24,30,0,114
2019-03-10,2,ORL,17,31,24,25,0,97,MEM,26,23,26,30,0,105
2019-03-13,3,MEM,28,32,30,21,0,111,ATL,33,39,38,22,0,132
2019-03-16,3,MEM,37,34,32,25,0,128,WAS,35,34,36,30,0,135
2019-03-20,4,HOU,25,28,25,37,10,125,MEM,38,25,34,18,11,126
2019-03-22,2,MEM,33,31,31,15,9,119,ORL,23,35,23,29,13,123
2019-03-23,1,MIN,25,24,35,28,0,112,MEM,25,25,18,31,0,99
2019-03-25,2,OKC,23,25,30,25,0,103,MEM,31,23,32,29,0,115
2019-03-27,2,GSW,31,35,23,29,0,118,MEM,37,23,24,19,0,103
2019-03-30,3,MEM,23,31,34,32,0,120,PHO,38,24,30,23,0,115
2019-03-31,1,MEM,19,27,22,28,0,96,LAC,25,36,26,26,0,113
2019-04-03,3,MEM,30,29,10,20,0,89,POR,28,34,24,30,0,116
2019-04-05,2,MEM,31,34,34,23,0,122,DAL,30,23,31,28,0,112
2019-04-07,2,DAL,24,28,31,29,17,129,MEM,26,30,32,24,15,127
2019-04-09,2,MEM,32,25,22,14,0,93,DET,20,18,26,36,0,100
2019-04-10,1,GSW,41,27,22,27,0,117,MEM,45,41,28,18,0,132
2018-10-16,10,OKC,23,24,32,21,0,100,GSW,31,26,26,25,0,108
2018-10-19,3,GSW,32,37,28,27,0,124,UTA,34,47,22,20,0,123
2018-10-21,2,GSW,25,24,21,28,0,98,DEN,17,30,33,20,0,100
2018-10-22,1,PHO,23,24,34,22,0,103,GSW,32,38,36,17,0,123
2018-10-24,2,WAS,37,34,26,25,0,122,GSW,46,34,35,29,0,144
2018-10-26,2,GSW,25,28,28,47,0,128,NYK,25,28,31,16,0,100
2018-10-28,2,GSW,32,31,30,27,0,120,BRK,29,20,28,37,0,114
2018-10-29,1,GSW,44,48,33,24,0,149,CHI,28,22,39,35,0,124
2018-10-31,2,NOP,37,26,29,29,0,121,GSW,43,27,37,24,0,131
2018-11-02,2,MIN,32,26,29,12,0,99,GSW,36,25,22,33,0,116
2018-11-05,3,MEM,31,27,15,28,0,101,GSW,29,29,34,25,0,117
2018-11-08,3,MIL,32,32,41,29,0,134,GSW,29,22,28,32,0,111
2018-11-10,2,BRK,30,23,21,26,0,100,GSW,36,29,29,22,0,116
2018-11-12,2,GSW,30,31,20,25,10,116,LAC,34,30,26,16,15,121
2018-11-13,1,ATL,23,29,24,27,0,103,GSW,20,29,33,28,0,110
2018-11-15,2,GSW,19,22,22,23,0,86,HOU,25,22,29,31,0,107
2018-11-17,2,GSW,22,37,27,23,0,109,DAL,26,31,25,30,0,112
2018-11-18,1,GSW,27,21,22,22,0,92,SAS,33,23,23,25,0,104
2018-11-21,3,OKC,23,37,27,36,0,123,GSW,18,28,33,16,0,95
2018-11-23,2,POR,27,17,29,24,0,97,GSW,24,35,33,33,0,125
2018-11-24,1,SAC,29,35,29,23,0,116,GSW,28,32,35,22,0,117
2018-11-26,2,ORL,25,39,19,27,0,110,GSW,26,21,32,37,0,116
2018-11-29,3,GSW,25,33,30,31,9,128,TOR,38,29,29,23,12,131
2018-12-01,2,GSW,24,22,32,24,0,102,DET,24,30,31,26,0,111
2018-12-03,2,GSW,34,27,36,31,0,128,ATL,17,30,30,34,0,111
2018-12-05,2,GSW,31,27,37,34,0,129,CLE,25,39,22,19,0,105
2018-12-07,2,GSW,27,30,26,22,0,105,MIL,22,29,25,19,0,95
2018-12-10,3,MIN,24,33,20,31,0,108,GSW,30,33,28,25,0,116
2018-12-12,2,TOR,31,26,25,31,0,113,GSW,22,19,26,26,0,93
2018-12-14,2,GSW,42,34,27,27,0,130,SAC,38,26,33,28,0,125
2018-12-17,3,MEM,22,16,29,26,0,93,GSW,30,31,23,26,0,110
2018-12-19,2,GSW,21,34,25,23,0,103,UTA,24,32,28,24,0,108
2018-12-22,3,DAL,31,30,26,29,0,116,GSW,28,30,36,26,0,120
2018-12-23,1,LAC,36,35,23,33,0,127,GSW,36,31,36,26,0,129
2018-12-25,2,LAL,32,33,26,36,0,127,GSW,25,25,32,19,0,101
2018-12-27,2,POR,27,25,23,27,8,110,GSW,28,18,25,31,7,109
2018-12-29,2,GSW,30,28,35,22,0,115,POR,27,23,33,22,0,105
2018-12-31,2,GSW,31,38,39,24,0,132,PHO,27,25,35,22,0,109
2019-01-03,3,HOU,22,31,39,27,16,135,GSW,34,36,28,21,15,134
2019-01-05,2,GSW,43,27,26,31,0,127,SAC,29,40,34,20,0,123
2019-01-08,3,NYK,25,24,19,27,0,95,GSW,31,30,33,28,0,122
2019-01-11,3,CHI,17,38,21,33,0,109,GSW,43,33,40,30,0,146
2019-01-13,2,GSW,25,37,30,27,0,119,DAL,29,25,34,26,0,114
2019-01-15,2,GSW,51,28,33,30,0,142,DEN,38,22,23,28,0,111
2019-01-16,1,NOP,39,32,38,31,0,140,GSW,31,35,44,37,0,147
2019-01-18,2,GSW,28,24,29,31,0,112,LAC,25,26,21,22,0,94
2019-01-21,3,GSW,29,36,45,20,0,130,LAL,24,31,25,31,0,111
2019-01-24,3,GSW,37,30,37,22,0,126,WAS,28,31,33,26,0,118
2019-01-26,2,GSW,29,32,29,25,0,115,BOS,26,33,25,27,0,111
2019-01-28,2,GSW,40,29,32,31,0,132,IND,22,26,31,21,0,100
2019-01-31,3,PHI,30,23,42,18,0,113,GSW,35,25,26,18,0,104
2019-02-02,2,LAL,24,34,28,15,0,101,GSW,33,30,25,27,0,115
2019-02-06,4,SAS,31,21,31,19,0,102,GSW,33,33,49,26,0,141
2019-02-08,2,GSW,26,34,22,35,0,117,PHO,31,22,32,22,0,107
2019-02-10,2,MIA,34,25,23,36,0,118,GSW,24,30,36,30,0,120
2019-02-12,2,UTA,14,30,40,24,0,108,GSW,25,22,34,34,0,115
2019-02-13,1,GSW,33,28,34,12,0,107,POR,31,33,30,35,0,129
2019-02-21,8,SAC,30,32,29,32,0,123,GSW,35,25,29,36,0,125
2019-02-23,2,HOU,35,26,31,26,0,118,GSW,20,34,32,26,0,112
2019-02-25,2,GSW,34,34,30,23,0,121,CHO,30,30,28,22,0,110
2019-02-27,2,GSW,22,37,33,33,0,125,MIA,32,42,26,26,0,126
2019-02-28,1,GSW,22,29,30,15,0,96,ORL,28,31,11,33,0,103
2019-03-02,2,GSW,31,24,38,27,0,120,PHI,32,35,23,27,0,117
2019-03-05,3,BOS,32,41,32,23,0,128,GSW,24,24,28,19,0,95
2019-03-08,3,DEN,20,30,25,30,0,105,GSW,30,37,23,32,0,122
2019-03-10,2,PHO,16,40,23,36,0,115,GSW,29,28,23,31,0,111
2019-03-13,3,GSW,33,21,31,21,0,106,HOU,23,29,26,26,0,104
2019-03-16,3,GSW,40,24,23,23,0,110,OKC,27,19,25,17,0,88
2019-03-18,2,GSW,25,22,31,27,0,105,SAS,25,33,24,29,0,111
2019-03-19,1,GSW,30,29,32,26,0,117,MIN,27,20,28,32,0,107
2019-03-21,2,IND,19,24,19,27,0,89,GSW,19,34,35,24,0,112
2019-03-23,2,DAL,37,37,34,18,0,126,GSW,22,24,24,21,0,91
2019-03-24,1,DET,28,21,28,37,0,114,GSW,29,34,34,24,0,121
2019-03-27,3,GSW,31,35,23,29,0,118,MEM,37,23,24,19,0,103
2019-03-29,2,GSW,32,36,18,29,15,130,MIN,27,27,32,29,16,131
2019-03-31,2,CHO,27,22,23,18,0,90,GSW,35,36,34,32,0,137
2019-04-02,2,DEN,24,19,21,38,0,102,GSW,30,29,27,30,0,116
2019-04-04,2,GSW,39,21,34,14,0,108,LAL,12,30,24,24,0,90
2019-04-05,1,CLE,26,23,35,30,0,114,GSW,36,32,31,21,0,120
2019-04-07,2,LAC,28,27,18,31,0,104,GSW,32,30,42,27,0,131
2019-04-09,2,GSW,18,38,32,24,0,112,NOP,19,37,23,24,0,103
2019-04-10,1,GSW,41,27,22,27,0,117,MEM,45,41,28,18,0,132
2018-10-17,10,DEN,29,30,15,33,0,107,LAC,24,30,18,26,0,98
2018-10-20,3,PHO,16,33,30,12,0,91,DEN,30,35,27,27,0,119
2018-10-21,1,GSW,25,24,21,28,0,98,DEN,17,30,33,20,0,100
2018-10-23,2,SAC,26,29,26,31,0,112,DEN,33,35,37,21,0,126
2018-10-25,2,DEN,26,31,32,25,0,114,LAL,22,36,29,34,0,121
2018-10-29,4,NOP,24,21,31,35,0,111,DEN,20,38,26,32,0,116
2018-10-31,2,DEN,28,23,29,18,10,108,CHI,24,24,30,20,9,107
2018-11-01,1,DEN,15,35,33,27,0,110,CLE,27,15,24,25,0,91
2018-11-03,2,UTA,25,21,27,15,0,88,DEN,25,22,21,35,0,103
2018-11-05,2,BOS,34,22,25,26,0,107,DEN,19,35,34,27,0,115
2018-11-07,2,DEN,29,18,23,17,0,87,MEM,22,28,20,19,0,89
2018-11-09,2,BRK,34,21,27,30,0,112,DEN,24,23,29,34,0,110
2018-11-11,2,MIL,33,30,36,22,0,121,DEN,35,24,29,26,0,114
2018-11-13,2,HOU,27,27,32,23,0,109,DEN,30,25,21,23,0,99
2018-11-15,2,ATL,23,34,16,20,0,93,DEN,35,38,36,29,0,138
2018-11-17,2,DEN,35,32,21,27,0,115,NOP,37,33,28,27,0,125
2018-11-19,2,DEN,29,27,21,21,0,98,MIL,25,21,32,26,0,104
2018-11-21,2,DEN,23,27,35,18,0,103,MIN,25,31,18,27,0,101
2018-11-23,2,ORL,19,22,27,19,0,87,DEN,21,33,26,32,0,112
2018-11-24,1,DEN,33,30,16,26,0,105,OKC,23,19,24,32,0,98
2018-11-27,3,LAL,26,24,21,14,0,85,DEN,30,28,31,28,0,117
2018-11-30,3,DEN,38,30,23,22,0,113,POR,26,27,32,27,0,112
2018-12-03,3,DEN,27,32,27,20,0,106,TOR,24,23,31,25,0,103
2018-12-05,2,DEN,31,25,32,24,12,124,ORL,28,26,32,26,6,118
2018-12-07,2,DEN,25,28,26,28,0,107,CHO,24,40,23,26,0,113
2018-12-08,1,DEN,35,21,21,21,0,98,ATL,25,26,35,20,0,106
2018-12-10,2,MEM,22,28,33,16,0,99,DEN,26,29,29,21,0,105
2018-12-14,4,OKC,32,20,24,22,0,98,DEN,39,21,22,27,0,109
2018-12-16,2,TOR,23,24,25,14,0,86,DEN,23,16,29,27,0,95
2018-12-18,2,DAL,33,36,26,23,0,118,DEN,34,40,31,21,0,126
2018-12-22,4,DEN,26,33,27,25,0,111,LAC,34,34,35,29,0,132
2018-12-26,4,DEN,26,27,22,28,0,103,SAS,34,21,22,34,0,111
2018-12-28,2,SAS,23,24,28,24,0,99,DEN,31,30,17,24,0,102
2018-12-29,1,DEN,36,26,28,32,0,122,PHO,16,33,29,40,0,118
2019-01-01,3,NYK,32,24,28,24,0,108,DEN,28,27,27,33,0,115
2019-01-03,2,DEN,30,23,31,33,0,117,SAC,30,36,18,29,0,113
2019-01-05,2,CHO,26,30,28,26,0,110,DEN,31,27,31,34,0,123
2019-01-07,2,DEN,35,25,29,24,0,113,HOU,33,37,26,29,0,125
2019-01-08,1,DEN,24,25,27,27,0,103,MIA,18,34,24,23,0,99
2019-01-10,2,LAC,25,29,22,24,0,100,DEN,37,28,28,28,0,121
2019-01-12,2,DEN,23,24,22,24,0,93,PHO,31,29,21,21,0,102
2019-01-13,1,POR,32,28,28,25,0,113,DEN,34,24,35,23,0,116
2019-01-15,2,GSW,51,28,33,30,0,142,DEN,38,22,23,28,0,111
2019-01-17,2,CHI,30,17,26,32,0,105,DEN,28,33,42,32,0,135
2019-01-19,2,CLE,25,21,30,26,0,102,DEN,37,33,31,23,0,124
2019-01-23,4,DEN,24,34,22,28,0,108,UTA,30,35,23,26,0,114
2019-01-25,2,PHO,32,23,26,14,0,95,DEN,37,33,28,34,0,132
2019-01-26,1,PHI,37,31,28,14,0,110,DEN,41,36,30,19,0,126
2019-01-28,2,DEN,16,25,19,35,0,95,MEM,30,30,17,15,0,92
2019-01-30,2,DEN,29,24,33,19,0,105,NOP,26,30,19,24,0,99
2019-02-01,2,HOU,43,28,24,27,0,122,DEN,35,48,30,23,0,136
2019-02-02,1,DEN,29,32,28,18,0,107,MIN,38,26,24,18,0,106
2019-02-04,2,DEN,36,19,28,20,0,103,DET,34,34,29,32,0,129
2019-02-06,2,DEN,35,25,27,43,0,130,BRK,30,42,36,27,0,135
2019-02-08,2,DEN,23,33,26,28,0,110,PHI,33,23,27,34,0,117
2019-02-11,3,MIA,27,22,21,17,0,87,DEN,35,19,29,20,0,103
2019-02-13,2,SAC,41,28,22,27,0,118,DEN,30,28,35,27,0,120
2019-02-22,9,DEN,25,27,39,23,0,114,DAL,30,21,23,30,0,104
2019-02-24,2,LAC,27,29,21,19,0,96,DEN,34,30,33,26,0,123
2019-02-26,2,OKC,26,25,27,34,0,112,DEN,29,35,27,30,0,121
2019-02-28,2,UTA,19,33,29,30,0,111,DEN,22,15,33,34,0,104
2019-03-02,2,NOP,27,40,29,24,0,120,DEN,39,32,22,19,0,112
2019-03-04,2,DEN,17,31,21,34,0,103,SAS,36,22,27,19,0,104
2019-03-06,2,DEN,43,23,19,30,0,115,LAL,25,24,28,22,0,99
2019-03-08,2,DEN,20,30,25,30,0,105,GSW,30,37,23,32,0,122
2019-03-12,4,MIN,20,28,30,29,0,107,DEN,31,27,36,39,0,133
2019-03-14,2,DAL,29,28,32,10,0,99,DEN,26,25,28,21,0,100
2019-03-16,2,IND,36,24,15,25,0,100,DEN,25,32,22,23,0,102
2019-03-18,2,DEN,24,31,25,34,0,114,BOS,22,30,28,25,0,105
2019-03-21,3,DEN,33,28,24,28,0,113,WAS,30,23,32,23,0,108
2019-03-22,1,DEN,37,19,26,29,0,111,NYK,18,24,20,31,0,93
2019-03-24,2,DEN,23,23,21,21,0,88,IND,27,35,30,32,0,124
2019-03-26,2,DET,9,30,23,30,0,92,DEN,27,39,15,14,0,95
2019-03-28,2,DEN,25,19,21,20,0,85,HOU,22,40,25,25,0,112
2019-03-29,1,DEN,33,23,30,29,0,115,OKC,29,23,23,30,0,105
2019-03-31,2,WAS,23,30,22,20,0,95,DEN,34,28,10,18,0,90
2019-04-02,2,DEN,24,19,21,38,0,102,GSW,30,29,27,30,0,116
2019-04-03,1,SAS,24,19,21,21,0,85,DEN,28,33,25,27,0,113
2019-04-05,2,POR,29,21,37,23,0,110,DEN,22,34,28,35,0,119
2019-04-07,2,DEN,25,24,32,27,0,108,POR,29,31,26,29,0,115
2019-04-09,2,DEN,21,38,27,22,0,108,UTA,27,33,31,27,0,118
2019-04-10,1,MIN,21,29,29,16,0,95,DEN,22,29,22,26,0,99
2018-10-17,10,BRK,29,22,25,24,0,100,DET,24,27,32,20,0,103
2018-10-19,2,NYK,24,26,26,29,0,105,BRK,33,24,17,33,0,107
2018-10-20,1,BRK,29,29,27,27,0,112,IND,33,34,28,37,0,132
2018-10-24,4,BRK,24,21,38,19,0,102,CLE,17,28,17,24,0,86
2018-10-26,2,BRK,30,36,25,24,0,115,NOP,32,25,31,29,0,117
2018-10-28,2,GSW,32,31,30,27,0,120,BRK,29,20,28,37,0,114
2018-10-29,1,BRK,26,18,23,29,0,96,NYK,26,26,33,30,0,115
2018-10-31,2,DET,22,38,23,27,9,119,BRK,28,26,23,33,10,120
2018-11-02,2,HOU,25,31,35,28,0,119,BRK,32,29,25,25,0,111
2018-11-04,2,PHI,21,26,28,22,0,97,BRK,18,33,41,30,0,122
2018-11-06,2,BRK,24,28,24,28,0,104,PHO,22,20,24,16,0,82
2018-11-09,3,BRK,34,21,27,30,0,112,DEN,24,23,29,34,0,110
2018-11-10,1,BRK,30,23,21,26,0,100,GSW,36,29,29,22,0,116
2018-11-12,2,BRK,31,22,32,28,0,113,MIN,30,27,36,27,0,120
2018-11-14,2,MIA,37,24,29,30,0,120,BRK,21,28,23,35,0,107
2018-11-16,2,BRK,26,30,35,24,0,115,WAS,30,24,25,25,0,104
2018-11-17,1,LAC,32,28,30,37,0,127,BRK,37,30,30,22,0,119
2018-11-20,3,BRK,20,19,35,30,0,104,MIA,13,29,35,15,0,92
2018-11-21,1,BRK,32,18,31,32,0,113,DAL,34,27,24,34,0,119
2018-11-23,2,MIN,22,32,35,23,0,112,BRK,26,23,23,30,0,102
2018-11-25,2,PHI,25,29,35,38,0,127,BRK,32,36,34,23,0,125
2018-11-28,3,UTA,17,26,27,31,0,101,BRK,16,26,36,13,0,91
2018-11-30,2,MEM,26,32,27,26,6,131,BRK,26,32,22,31,6,125
2018-12-01,1,BRK,19,20,19,30,0,88,WAS,24,18,26,34,0,102
2018-12-03,2,CLE,30,26,24,19,0,99,BRK,29,21,26,21,0,97
2018-12-05,2,OKC,24,22,29,39,0,114,BRK,26,36,31,19,0,112
2018-12-07,2,TOR,20,33,26,19,7,105,BRK,24,29,27,18,8,106
2018-12-08,1,BRK,30,26,38,18,0,112,NYK,23,22,32,27,0,104
2018-12-12,4,BRK,31,26,37,33,0,127,PHI,29,27,28,40,0,124
2018-12-14,2,WAS,31,28,26,33,0,118,BRK,27,43,31,24,0,125
2018-12-16,2,ATL,23,43,30,31,0,127,BRK,42,30,39,33,0,144
2018-12-18,2,LAL,32,25,26,27,0,110,BRK,33,29,28,25,0,115
2018-12-19,1,BRK,22,18,31,25,0,96,CHI,27,12,32,22,0,93
2018-12-21,2,IND,37,22,25,30,0,114,BRK,27,22,31,26,0,106
2018-12-23,2,PHO,31,25,18,29,0,103,BRK,38,25,28,20,0,111
2018-12-26,3,CHO,29,22,26,37,7,132,BRK,22,34,23,35,7,134
2018-12-28,2,BRK,17,25,23,22,0,87,CHO,33,21,19,27,0,100
2018-12-29,1,BRK,23,29,34,29,0,115,MIL,29,42,35,23,0,129
2019-01-02,4,NOP,29,29,29,34,0,121,BRK,39,34,32,21,0,126
2019-01-04,2,BRK,26,22,33,28,0,109,MEM,26,21,30,23,0,100
2019-01-06,2,BRK,28,27,33,29,0,117,CHI,21,34,27,18,0,100
2019-01-07,1,BRK,22,23,29,21,0,95,BOS,34,22,30,30,0,116
2019-01-09,2,ATL,38,19,23,20,0,100,BRK,23,28,35,30,0,116
2019-01-11,2,BRK,35,18,22,30,0,105,TOR,28,36,35,23,0,122
2019-01-14,3,BOS,25,20,21,36,0,102,BRK,27,19,44,19,0,109
2019-01-16,2,BRK,34,28,23,46,14,145,HOU,30,24,40,37,11,142
2019-01-18,2,BRK,25,29,32,31,0,117,ORL,32,35,28,20,0,115
2019-01-21,3,SAC,23,37,25,9,0,94,BRK,29,26,38,30,0,123
2019-01-23,2,ORL,25,31,30,24,0,110,BRK,26,30,33,25,0,114
2019-01-25,2,NYK,37,23,22,17,0,99,BRK,30,30,27,22,0,109
2019-01-28,3,BRK,26,24,38,16,0,104,BOS,32,28,29,23,0,112
2019-01-29,1,CHI,19,35,25,38,0,117,BRK,20,30,33,39,0,122
2019-01-31,2,BRK,25,26,38,25,0,114,SAS,29,23,33,32,0,117
2019-02-02,2,BRK,21,27,22,19,0,89,ORL,26,18,34,24,0,102
2019-02-04,2,MIL,23,28,36,26,0,113,BRK,17,25,22,30,0,94
2019-02-06,2,DEN,35,25,27,43,0,130,BRK,30,42,36,27,0,135
2019-02-08,2,CHI,32,23,38,32,0,125,BRK,27,21,32,26,0,106
2019-02-11,3,BRK,29,31,32,33,0,125,TOR,21,35,36,35,0,127
2019-02-13,2,BRK,30,25,29,25,9,148,CLE,29,29,26,25,9,139
2019-02-21,8,POR,23,27,34,29,0,113,BRK,21,29,22,27,0,99
2019-02-23,2,BRK,34,29,27,27,0,117,CHO,20,30,34,31,0,115
2019-02-25,2,SAS,20,18,21,26,0,85,BRK,28,24,29,20,0,101
2019-02-27,2,WAS,34,34,33,24,0,125,BRK,28,32,19,37,0,116
2019-03-01,2,CHO,31,37,30,25,0,123,BRK,32,18,36,26,0,112
2019-03-02,1,BRK,23,21,20,24,0,88,MIA,28,26,30,33,0,117
2019-03-04,2,DAL,21,26,26,15,0,88,BRK,31,34,34,28,0,127
2019-03-06,2,CLE,20,30,35,22,0,107,BRK,31,24,25,33,0,113
2019-03-09,3,BRK,26,30,27,31,0,114,ATL,23,24,30,35,0,112
2019-03-11,2,DET,19,16,27,13,0,75,BRK,27,34,27,15,0,103
2019-03-13,2,BRK,27,25,26,18,0,96,OKC,19,23,38,28,0,108
2019-03-16,3,BRK,21,21,22,34,0,98,UTA,28,31,24,31,0,114
2019-03-17,1,BRK,30,25,32,29,0,116,LAC,23,37,27,32,0,119
2019-03-19,2,BRK,25,33,20,45,0,123,SAC,38,28,37,18,0,121
2019-03-22,3,BRK,20,24,34,33,0,111,LAL,23,20,30,33,0,106
2019-03-25,3,BRK,27,35,28,30,12,144,POR,31,31,33,25,12,148
2019-03-28,3,BRK,23,35,24,28,0,110,PHI,38,30,30,25,0,123
2019-03-30,2,BOS,21,27,22,26,0,96,BRK,17,32,33,28,0,110
2019-04-01,2,MIL,35,24,32,40,0,131,BRK,20,34,35,32,0,121
2019-04-03,2,TOR,34,23,33,25,0,115,BRK,22,28,28,27,0,105
2019-04-06,3,BRK,34,32,42,25,0,133,MIL,26,39,31,32,0,128
2019-04-07,1,BRK,31,21,30,26,0,108,IND,25,19,25,27,0,96
2019-04-10,3,MIA,23,24,24,23,0,94,BRK,32,31,29,21,0,113
2018-10-17,10,DEN,29,30,15,33,0,107,LAC,24,30,18,26,0,98
2018-10-19,2,OKC,20,26,31,15,0,92,LAC,27,21,23,37,0,108
2018-10-21,2,HOU,24,29,31,28,0,112,LAC,29,25,39,22,0,115
2018-10-23,2,LAC,26,36,22,25,0,109,NOP,27,32,32,25,0,116
2018-10-26,3,LAC,31,39,26,37,0,133,HOU,30,31,22,30,0,113
2018-10-28,2,WAS,20,34,23,27,0,104,LAC,28,41,28,39,0,136
2018-10-30,2,LAC,33,34,10,33,0,110,OKC,25,29,39,35,0,128
2018-11-01,2,LAC,30,27,29,27,0,113,PHI,34,38,18,32,0,122
2018-11-02,1,LAC,22,35,30,33,0,120,ORL,22,22,28,23,0,95
2018-11-05,3,MIN,33,26,25,25,0,109,LAC,31,32,29,28,0,120
2018-11-08,3,LAC,28,29,24,24,0,105,POR,37,24,23,32,0,116
2018-11-10,2,MIL,24,40,20,35,7,126,LAC,33,29,27,30,9,128
2018-11-12,2,GSW,30,31,20,25,10,116,LAC,34,30,26,16,15,121
2018-11-15,3,SAS,28,32,24,27,0,111,LAC,29,32,30,25,0,116
2018-11-17,2,LAC,32,28,30,37,0,127,BRK,37,30,30,22,0,119
2018-11-19,2,LAC,29,32,28,38,0,127,ATL,34,30,32,23,0,119
2018-11-20,1,LAC,40,33,22,23,0,118,WAS,21,33,32,39,0,125
2018-11-23,3,MEM,22,30,18,28,9,107,LAC,16,28,31,23,14,112
2018-11-25,2,LAC,24,21,38,21,0,104,POR,28,30,16,26,0,100
2018-11-28,3,PHO,22,27,25,25,0,99,LAC,26,23,40,26,0,115
2018-11-29,1,LAC,42,29,30,32,0,133,SAC,26,42,25,28,0,121
2018-12-02,3,LAC,35,23,22,30,0,110,DAL,34,28,26,26,0,114
2018-12-03,1,LAC,36,41,24,28,0,129,NOP,29,36,32,29,0,126
2018-12-05,2,LAC,15,27,27,17,0,86,MEM,27,24,18,27,0,96
2018-12-08,3,MIA,34,31,26,30,0,121,LAC,30,32,28,8,0,98
2018-12-10,2,LAC,21,37,30,23,12,123,PHO,29,27,30,25,8,119
2018-12-11,1,TOR,36,34,33,20,0,123,LAC,23,34,17,25,0,99
2018-12-13,2,LAC,27,30,20,10,0,87,SAS,38,28,32,27,0,125
2018-12-15,2,LAC,25,25,19,35,0,104,OKC,30,31,25,24,0,110
2018-12-17,2,POR,37,21,42,31,0,131,LAC,29,31,28,39,0,127
2018-12-20,3,DAL,27,27,28,39,0,121,LAC,30,35,24,36,0,125
2018-12-22,2,DEN,26,33,27,25,0,111,LAC,34,34,35,29,0,132
2018-12-23,1,LAC,36,35,23,33,0,127,GSW,36,31,36,26,0,129
2018-12-26,3,SAC,27,29,29,33,0,118,LAC,39,32,31,25,0,127
2018-12-28,2,LAC,28,23,31,36,0,118,LAL,23,31,26,27,0,107
2018-12-29,1,SAS,32,24,39,27,0,122,LAC,30,26,19,36,0,111
2019-01-01,3,PHI,41,35,25,18,0,119,LAC,28,30,30,25,0,113
2019-01-04,3,LAC,38,30,23,30,0,121,PHO,19,25,34,33,0,111
2019-01-06,2,ORL,28,19,20,29,0,96,LAC,18,27,25,36,0,106
2019-01-08,2,CHO,24,33,20,32,0,109,LAC,33,29,24,42,0,128
2019-01-10,2,LAC,25,29,22,24,0,100,DEN,37,28,28,28,0,121
2019-01-12,2,DET,37,28,25,19,0,109,LAC,24,30,26,24,0,104
2019-01-14,2,NOP,32,34,28,27,0,121,LAC,36,27,25,29,0,117
2019-01-16,2,UTA,31,25,32,41,0,129,LAC,22,27,23,37,0,109
2019-01-18,2,GSW,28,24,29,31,0,112,LAC,25,26,21,22,0,94
2019-01-20,2,LAC,38,22,20,23,0,103,SAS,26,27,20,22,0,95
2019-01-22,2,LAC,29,27,17,25,0,98,DAL,26,32,20,28,0,106
2019-01-23,1,LAC,27,27,23,34,0,111,MIA,31,23,18,27,0,99
2019-01-25,2,LAC,27,25,28,26,0,106,CHI,20,36,26,19,0,101
2019-01-27,2,SAC,21,30,25,32,0,108,LAC,34,33,20,35,0,122
2019-01-28,1,ATL,32,31,31,29,0,123,LAC,25,36,22,35,0,118
2019-01-31,3,LAL,32,22,33,25,11,123,LAC,26,27,22,37,8,120
2019-02-02,2,LAC,22,25,29,35,0,111,DET,40,25,22,14,0,101
2019-02-03,1,LAC,23,28,29,23,0,103,TOR,23,42,32,24,0,121
2019-02-05,2,LAC,26,27,31,33,0,117,CHO,25,33,34,23,0,115
2019-02-07,2,LAC,31,22,20,19,0,92,IND,36,35,27,18,0,116
2019-02-09,2,LAC,20,33,28,42,0,123,BOS,43,31,12,26,0,112
2019-02-11,2,LAC,26,29,36,29,0,120,MIN,29,34,36,31,0,130
2019-02-13,2,PHO,22,29,28,28,0,107,LAC,32,35,33,34,0,134
2019-02-22,9,LAC,36,29,18,29,0,112,MEM,23,30,33,20,0,106
2019-02-24,2,LAC,27,29,21,19,0,96,DEN,34,30,33,26,0,123
2019-02-25,1,DAL,22,35,31,24,0,112,LAC,29,34,28,30,0,121
2019-02-27,2,LAC,33,23,27,22,0,105,UTA,26,23,34,28,0,111
2019-03-01,2,LAC,26,26,35,29,0,116,SAC,23,33,26,27,0,109
2019-03-03,2,NYK,20,26,32,29,0,107,LAC,38,44,19,27,0,128
2019-03-04,1,LAC,26,35,30,22,0,113,LAL,34,23,28,20,0,105
2019-03-08,4,OKC,32,24,28,26,0,110,LAC,36,32,20,30,0,118
2019-03-11,3,BOS,19,30,36,30,0,115,LAC,25,37,39,39,0,140
2019-03-12,1,POR,23,27,35,40,0,125,LAC,30,22,32,20,0,104
2019-03-15,3,CHI,34,29,21,37,0,121,LAC,29,28,45,26,0,128
2019-03-17,2,BRK,30,25,32,29,0,116,LAC,23,37,27,32,0,119
2019-03-19,2,IND,16,33,26,34,0,109,LAC,25,30,34,26,0,115
2019-03-22,3,LAC,25,33,34,18,0,110,CLE,40,20,23,25,0,108
2019-03-24,2,LAC,29,31,29,35,0,124,NYK,24,35,25,29,0,113
2019-03-26,2,LAC,42,33,25,22,0,122,MIN,23,32,30,26,0,111
2019-03-28,2,LAC,25,21,31,41,0,118,MIL,28,39,33,28,0,128
2019-03-30,2,CLE,29,23,31,25,0,108,LAC,29,36,28,39,0,132
2019-03-31,1,MEM,19,27,22,28,0,96,LAC,25,36,26,26,0,113
2019-04-03,3,HOU,39,29,34,33,0,135,LAC,26,27,20,30,0,103
2019-04-05,2,LAL,35,26,23,38,0,122,LAC,30,37,19,31,0,117
2019-04-07,2,LAC,28,27,18,31,0,104,GSW,32,30,42,27,0,131
2019-04-10,3,UTA,26,40,31,29,11,137,LAC,39,31,32,24,17,143
2018-10-18,10,LAL,31,32,28,28,0,119,POR,34,31,28,35,0,128
2018-10-20,2,SAS,22,28,32,26,0,108,POR,22,37,38,24,0,121
2018-10-22,2,WAS,28,34,16,33,14,125,POR,32,30,15,34,13,124
2018-10-25,3,POR,33,25,33,37,0,128,ORL,22,26,36,30,0,114
2018-10-27,2,POR,22,20,37,32,0,111,MIA,33,24,32,31,0,120
2018-10-29,2,POR,23,22,26,32,0,103,IND,16,33,20,24,0,93
2018-10-30,1,POR,19,32,34,19,0,104,HOU,15,21,26,23,0,85
2018-11-01,2,NOP,31,34,34,20,0,119,POR,35,35,32,30,0,132
2018-11-03,2,LAL,28,28,32,26,0,114,POR,29,28,16,37,0,110
2018-11-04,1,MIN,27,18,19,17,0,81,POR,30,31,31,19,0,111
2018-11-06,2,MIL,31,20,26,26,0,103,POR,33,24,34,27,0,118
2018-11-08,2,LAC,28,29,24,24,0,105,POR,37,24,23,32,0,116
2018-11-11,3,BOS,21,16,33,24,0,94,POR,26,28,29,17,0,100
2018-11-14,3,POR,33,22,34,28,0,117,LAL,26,33,38,29,0,126
2018-11-16,2,POR,21,22,24,29,0,96,MIN,29,26,28,29,0,112
2018-11-18,2,POR,32,30,29,28,0,119,WAS,25,16,29,39,0,109
2018-11-20,2,POR,33,25,31,29,0,118,NYK,35,25,25,29,0,114
2018-11-21,1,POR,20,30,29,21,0,100,MIL,31,41,37,34,0,143
2018-11-23,2,POR,27,17,29,24,0,97,GSW,24,35,33,33,0,125
2018-11-25,2,LAC,24,21,38,21,0,104,POR,28,30,16,26,0,100
2018-11-28,3,ORL,30,33,21,28,0,112,POR,33,22,40,20,0,115
2018-11-30,2,DEN,38,30,23,22,0,113,POR,26,27,32,27,0,112
2018-12-02,2,POR,33,22,35,28,0,118,SAS,32,30,35,34,0,131
2018-12-04,2,POR,20,25,28,29,0,102,DAL,34,26,27,24,0,111
2018-12-06,2,PHO,9,32,18,27,0,86,POR,34,28,25,21,0,108
2018-12-08,2,MIN,27,24,29,25,0,105,POR,30,23,28,32,0,113
2018-12-11,3,POR,29,25,24,26,0,104,HOU,27,24,30,30,0,111
2018-12-12,1,POR,26,14,23,20,0,83,MEM,15,27,26,24,0,92
2018-12-14,2,TOR,23,27,39,33,0,122,POR,28,30,33,37,0,128
2018-12-17,3,POR,37,21,42,31,0,131,LAC,29,31,28,39,0,127
2018-12-19,2,MEM,18,34,19,21,0,92,POR,17,30,27,25,0,99
2018-12-21,2,UTA,33,22,28,37,0,120,POR,26,23,19,22,0,90
2018-12-23,2,DAL,27,25,28,27,11,118,POR,25,37,26,19,14,121
2018-12-25,2,POR,24,23,23,26,0,96,UTA,24,35,24,34,0,117
2018-12-27,2,POR,27,25,23,27,8,110,GSW,28,18,25,31,7,109
2018-12-29,2,GSW,30,28,35,22,0,115,POR,27,23,33,22,0,105
2018-12-30,1,PHI,20,21,26,28,0,95,POR,31,39,36,23,0,129
2019-01-01,2,POR,26,38,19,20,10,113,SAC,25,25,27,26,5,108
2019-01-04,3,OKC,28,29,36,18,0,111,POR,28,34,25,22,0,109
2019-01-05,1,HOU,30,16,31,24,0,101,POR,30,29,27,24,0,110
2019-01-07,2,NYK,30,23,23,25,0,101,POR,30,24,32,25,0,111
2019-01-09,2,CHI,29,22,34,27,0,112,POR,30,26,39,29,0,124
2019-01-11,2,CHO,27,22,19,28,0,96,POR,37,33,31,26,0,127
2019-01-13,2,POR,32,28,28,25,0,113,DEN,34,24,35,23,0,116
2019-01-14,1,POR,27,17,31,32,0,107,SAC,24,30,29,32,0,115
2019-01-16,2,CLE,26,29,30,27,0,112,POR,30,32,38,29,0,129
2019-01-18,2,NOP,29,29,28,26,0,112,POR,32,42,30,24,0,128
2019-01-21,3,POR,29,15,39,26,0,109,UTA,28,23,28,25,0,104
2019-01-22,1,POR,25,30,32,27,0,114,OKC,25,37,31,30,0,123
2019-01-24,2,POR,30,26,32,32,0,120,PHO,31,21,24,30,0,106
2019-01-26,2,ATL,30,34,26,21,0,111,POR,40,23,30,27,0,120
2019-01-30,4,UTA,27,31,22,25,0,105,POR,45,29,35,23,0,132
2019-02-05,6,MIA,34,28,32,24,0,118,POR,30,25,24,29,0,108
2019-02-07,2,SAS,34,23,33,28,0,118,POR,31,39,26,31,0,127
2019-02-10,3,POR,24,33,35,9,0,101,DAL,25,22,31,24,0,102
2019-02-11,1,POR,26,23,33,29,0,111,OKC,36,32,19,33,0,120
2019-02-13,2,GSW,33,28,34,12,0,107,POR,31,33,30,35,0,129
2019-02-21,8,POR,23,27,34,29,0,113,BRK,21,29,22,27,0,99
2019-02-23,2,POR,27,32,41,30,0,130,PHI,25,31,26,33,0,115
2019-02-25,2,POR,29,42,17,35,0,123,CLE,18,30,36,26,0,110
2019-02-27,2,POR,25,18,31,23,0,97,BOS,24,18,22,28,0,92
2019-03-01,2,POR,24,30,30,33,0,117,TOR,31,30,32,26,0,119
2019-03-03,2,POR,32,24,25,37,0,118,CHO,25,25,30,28,0,108
2019-03-05,2,POR,33,30,23,25,0,111,MEM,20,41,21,38,0,120
2019-03-07,2,OKC,31,27,27,28,16,129,POR,30,31,22,30,8,121
2019-03-09,2,PHO,23,24,30,43,0,120,POR,24,42,36,25,0,127
2019-03-12,3,POR,23,27,35,40,0,125,LAC,30,22,32,20,0,104
2019-03-15,3,POR,30,26,31,35,0,122,NOP,37,20,25,28,0,110
2019-03-16,1,POR,21,29,26,27,0,103,SAS,23,25,24,36,0,108
2019-03-18,2,IND,31,17,24,26,0,98,POR,28,27,33,18,0,106
2019-03-20,2,DAL,17,35,31,35,0,118,POR,26,39,36,25,0,126
2019-03-23,3,DET,28,28,36,20,0,112,POR,32,27,30,28,0,117
2019-03-25,2,BRK,27,35,28,30,12,144,POR,31,31,33,25,12,148
2019-03-27,2,POR,27,32,28,31,0,118,CHI,14,27,24,33,0,98
2019-03-29,2,POR,38,22,30,28,0,118,ATL,30,21,25,22,0,98
2019-03-30,1,POR,14,20,25,31,0,90,DET,11,20,35,33,0,99
2019-04-01,2,POR,38,37,22,35,0,132,MIN,23,41,36,22,0,122
2019-04-03,2,MEM,30,29,10,20,0,89,POR,28,34,24,30,0,116
2019-04-05,2,POR,29,21,37,23,0,110,DEN,22,34,28,35,0,119
2019-04-07,2,DEN,25,24,32,27,0,108,POR,29,31,26,29,0,115
2019-04-09,2,POR,26,27,20,31,0,104,LAL,25,23,26,27,0,101
2019-04-10,1,SAC,39,48,26,18,0,131,POR,30,32,36,38,0,136
2018-10-17,10,MEM,16,23,19,25,0,83,IND,27,29,20,35,0,111
2018-10-19,2,IND,25,28,23,25,0,101,MIL,30,32,31,25,0,118
2018-10-20,1,BRK,29,29,27,27,0,112,IND,33,34,28,37,0,132
2018-10-22,2,IND,28,21,24,18,0,91,MIN,25,25,22,29,0,101
2018-10-24,2,IND,28,34,26,28,0,116,SAS,22,28,21,25,0,96
2018-10-27,3,IND,30,30,28,31,0,119,CLE,30,25,28,24,0,107
2018-10-29,2,POR,23,22,26,32,0,103,IND,16,33,20,24,0,93
2018-10-31,2,IND,28,22,27,30,0,107,NYK,25,27,29,20,0,101
2018-11-02,2,IND,22,38,27,20,0,107,CHI,37,21,22,25,0,105
2018-11-03,1,BOS,28,17,27,29,0,101,IND,18,27,27,30,0,102
2018-11-05,2,HOU,29,24,16,29,0,98,IND,22,33,20,19,0,94
2018-11-07,2,PHI,29,21,28,22,0,100,IND,23,27,21,23,0,94
2018-11-09,2,IND,24,27,33,26,0,110,MIA,26,33,21,22,0,102
2018-11-11,2,IND,31,23,27,22,0,103,HOU,32,44,26,13,0,115
2018-11-16,5,MIA,27,16,24,24,0,91,IND,18,32,22,27,0,99
2018-11-17,1,ATL,24,32,16,17,0,89,IND,25,22,26,24,0,97
2018-11-19,2,UTA,19,28,23,24,0,94,IND,32,25,29,35,0,121
2018-11-21,2,IND,30,30,24,25,0,109,CHO,35,33,37,22,0,127
2018-11-23,2,SAS,29,25,28,29,0,111,IND,23,22,24,31,0,100
2018-11-26,3,IND,33,25,31,32,0,121,UTA,25,22,23,18,0,88
2018-11-27,1,IND,26,35,20,28,0,109,PHO,26,28,23,27,0,104
2018-11-29,2,IND,15,35,25,21,0,96,LAL,38,18,27,21,0,104
2018-12-01,2,IND,30,30,31,19,0,110,SAC,26,32,31,22,0,111
2018-12-04,3,CHI,21,24,22,23,0,90,IND,23,20,27,26,0,96
2018-12-07,3,IND,28,29,29,26,0,112,ORL,25,20,25,20,0,90
2018-12-08,1,SAC,31,21,18,27,0,97,IND,24,30,19,34,0,107
2018-12-10,2,WAS,33,17,25,26,0,101,IND,29,30,28,22,0,109
2018-12-12,2,MIL,23,20,27,27,0,97,IND,29,29,27,28,0,113
2018-12-14,2,IND,24,25,31,33,0,113,PHI,34,25,18,24,0,101
2018-12-16,2,NYK,26,27,20,26,0,99,IND,28,28,23,31,0,110
2018-12-18,2,CLE,21,24,22,25,0,92,IND,19,25,24,23,0,91
2018-12-19,1,IND,34,24,27,11,0,96,TOR,24,26,25,24,0,99
2018-12-21,2,IND,37,22,25,30,0,114,BRK,27,22,31,26,0,106
2018-12-23,2,WAS,25,21,18,25,0,89,IND,27,26,31,21,0,105
2018-12-26,3,IND,32,32,31,34,0,129,ATL,31,36,21,33,0,121
2018-12-28,2,DET,21,24,24,19,0,88,IND,32,26,33,34,0,125
2018-12-31,3,ATL,25,35,21,27,0,108,IND,33,30,34,19,0,116
2019-01-04,4,IND,18,36,21,30,14,119,CHI,30,28,20,27,11,116
2019-01-06,2,IND,35,28,21,21,0,105,TOR,37,33,26,25,0,121
2019-01-08,2,IND,38,25,29,31,0,123,CLE,16,27,36,36,0,115
2019-01-09,1,IND,23,30,27,28,0,108,BOS,29,39,37,30,0,135
2019-01-11,2,IND,31,33,32,25,0,121,NYK,22,30,30,24,0,106
2019-01-15,4,PHO,19,32,22,24,0,97,IND,38,24,34,35,0,131
2019-01-17,2,PHI,28,26,32,34,0,120,IND,25,23,23,25,0,96
2019-01-19,2,DAL,23,19,27,30,0,99,IND,24,34,26,27,0,111
2019-01-20,1,CHO,26,15,30,24,0,95,IND,34,22,27,37,0,120
2019-01-23,3,TOR,16,31,28,31,0,106,IND,24,35,25,26,0,110
2019-01-26,3,IND,19,23,27,34,0,103,MEM,24,29,25,28,0,106
2019-01-28,2,GSW,40,29,32,31,0,132,IND,22,26,31,21,0,100
2019-01-30,2,IND,25,20,24,20,0,89,WAS,35,24,23,25,0,107
2019-01-31,1,IND,19,29,25,27,0,100,ORL,24,27,18,38,0,107
2019-02-02,2,IND,21,32,31,11,0,95,MIA,27,27,23,11,0,88
2019-02-04,2,IND,25,28,30,26,0,109,NOP,20,30,24,33,0,107
2019-02-05,1,LAL,26,20,27,21,0,94,IND,33,36,32,35,0,136
2019-02-07,2,LAC,31,22,20,19,0,92,IND,36,35,27,18,0,116
2019-02-09,2,CLE,17,25,18,30,0,90,IND,30,24,20,31,0,105
2019-02-11,2,CHO,19,19,33,19,0,90,IND,32,22,23,22,0,99
2019-02-13,2,MIL,26,29,21,30,0,106,IND,18,29,32,18,0,97
2019-02-22,9,NOP,35,36,23,17,0,111,IND,24,34,39,29,0,126
2019-02-23,1,IND,29,36,24,30,0,119,WAS,21,29,30,32,0,112
2019-02-25,2,IND,20,31,26,32,0,109,DET,36,19,29,29,0,113
2019-02-27,2,IND,27,26,25,23,0,101,DAL,28,25,26,31,0,110
2019-02-28,1,MIN,35,25,30,25,0,115,IND,26,38,28,30,0,122
2019-03-02,2,ORL,27,28,28,34,0,117,IND,27,33,27,25,0,112
2019-03-05,3,CHI,17,25,33,21,0,96,IND,27,22,28,28,0,105
2019-03-07,2,IND,24,26,22,26,0,98,MIL,32,22,30,33,0,117
2019-03-10,3,IND,25,34,11,19,0,89,PHI,26,25,21,34,0,106
2019-03-12,2,NYK,29,23,21,25,0,98,IND,27,28,30,18,0,103
2019-03-14,2,OKC,29,34,25,18,0,106,IND,22,28,31,27,0,108
2019-03-16,2,IND,36,24,15,25,0,100,DEN,25,32,22,23,0,102
2019-03-18,2,IND,31,17,24,26,0,98,POR,28,27,33,18,0,106
2019-03-19,1,IND,16,33,26,34,0,109,LAC,25,30,34,26,0,115
2019-03-21,2,IND,19,24,19,27,0,89,GSW,19,34,35,24,0,112
2019-03-24,3,DEN,23,23,21,21,0,88,IND,27,35,30,32,0,124
2019-03-27,3,IND,27,27,15,30,0,99,OKC,29,16,31,31,0,107
2019-03-29,2,IND,25,35,31,21,0,112,BOS,35,28,26,25,0,114
2019-03-30,1,ORL,32,24,34,31,0,121,IND,28,29,35,24,0,116
2019-04-01,2,DET,33,22,25,22,0,102,IND,23,36,28,24,0,111
2019-04-03,2,IND,18,26,34,30,0,108,DET,15,21,26,27,0,89
2019-04-05,2,BOS,24,34,33,26,0,117,IND,27,20,27,23,0,97
2019-04-07,2,BRK,31,21,30,26,0,108,IND,25,19,25,27,0,96
2019-04-10,3,IND,35,38,36,26,0,135,ATL,28,41,34,31,0,134
2018-10-17,10,MIN,23,29,31,25,0,108,SAS,31,25,25,31,0,112
2018-10-20,3,SAS,22,28,32,26,0,108,POR,22,37,38,24,0,121
2018-10-22,2,SAS,40,25,34,29,15,143,LAL,26,34,36,32,14,142
2018-10-24,2,IND,28,34,26,28,0,116,SAS,22,28,21,25,0,96
2018-10-27,3,LAL,36,24,28,18,0,106,SAS,29,25,33,23,0,110
2018-10-29,2,DAL,18,27,29,28,6,108,SAS,20,33,23,26,11,113
2018-10-31,2,SAS,28,32,34,26,0,120,PHO,15,24,27,24,0,90
2018-11-03,3,NOP,17,22,29,27,0,95,SAS,24,34,29,22,0,109
2018-11-04,1,ORL,36,27,28,26,0,117,SAS,26,28,20,36,0,110
2018-11-07,3,SAS,20,22,22,24,0,88,MIA,27,23,25,20,0,95
2018-11-10,3,HOU,21,29,21,18,0,89,SAS,20,32,20,24,0,96
2018-11-12,2,SAS,24,31,21,23,0,99,SAC,25,31,21,27,0,104
2018-11-14,2,SAS,19,29,22,26,0,96,PHO,34,18,35,29,0,116
2018-11-15,1,SAS,28,32,24,27,0,111,LAC,29,32,30,25,0,116
2018-11-18,3,GSW,27,21,22,22,0,92,SAS,33,23,23,25,0,104
2018-11-19,1,SAS,39,28,30,29,0,126,NOP,30,38,40,32,0,140
2018-11-21,2,MEM,30,31,20,23,0,104,SAS,32,27,18,26,0,103
2018-11-23,2,SAS,29,25,28,29,0,111,IND,23,22,24,31,0,100
2018-11-24,1,SAS,36,32,34,27,0,129,MIL,37,30,28,40,0,135
2018-11-26,2,SAS,27,25,28,28,0,108,CHI,27,23,33,24,0,107
2018-11-28,2,SAS,25,9,24,31,0,89,MIN,28,29,35,36,0,128
2018-11-30,2,HOU,39,31,40,26,0,136,SAS,23,24,27,31,0,105
2018-12-02,2,POR,33,22,35,28,0,118,SAS,32,30,35,34,0,131
2018-12-04,2,SAS,20,27,31,27,0,105,UTA,34,29,41,35,0,139
2018-12-05,1,SAS,23,22,37,31,0,113,LAL,31,19,28,43,0,121
2018-12-07,2,LAL,36,36,27,21,0,120,SAS,32,36,21,44,0,133
2018-12-09,2,UTA,18,18,36,25,0,97,SAS,23,31,28,28,0,110
2018-12-11,2,PHO,20,26,18,22,0,86,SAS,29,30,29,23,0,111
2018-12-13,2,LAC,27,30,20,10,0,87,SAS,38,28,32,27,0,125
2018-12-15,2,CHI,21,22,31,24,0,98,SAS,28,34,16,15,0,93
2018-12-17,2,PHI,32,17,22,25,0,96,SAS,29,31,33,30,0,123
2018-12-19,2,SAS,31,35,38,25,0,129,ORL,24,20,33,13,0,90
2018-12-21,2,MIN,21,23,27,27,0,98,SAS,29,33,25,37,0,124
2018-12-22,1,SAS,26,17,26,32,0,101,HOU,28,13,43,24,0,108
2018-12-26,4,DEN,26,27,22,28,0,103,SAS,34,21,22,34,0,111
2018-12-28,2,SAS,23,24,28,24,0,99,DEN,31,30,17,24,0,102
2018-12-29,1,SAS,32,24,39,27,0,122,LAC,30,26,19,36,0,111
2018-12-31,2,BOS,23,29,30,29,0,111,SAS,17,29,46,28,0,120
2019-01-03,3,TOR,19,32,24,32,0,107,SAS,38,29,29,29,0,125
2019-01-05,2,MEM,25,19,22,22,0,88,SAS,27,37,24,20,0,108
2019-01-07,2,SAS,25,34,25,35,0,119,DET,31,20,22,34,0,107
2019-01-09,2,SAS,18,13,33,22,0,86,MEM,22,20,30,24,0,96
2019-01-10,1,OKC,23,40,30,37,11,147,SAS,33,37,35,25,11,154
2019-01-12,2,SAS,31,29,20,32,0,112,OKC,23,28,35,36,0,122
2019-01-14,2,CHO,28,21,27,32,0,108,SAS,24,19,29,21,0,93
2019-01-16,2,SAS,20,25,30,30,0,105,DAL,35,21,24,21,0,101
2019-01-18,2,SAS,28,30,30,28,0,116,MIN,31,27,32,23,0,113
2019-01-20,2,LAC,38,22,20,23,0,103,SAS,26,27,20,22,0,95
2019-01-23,3,SAS,35,29,32,24,0,120,PHI,34,33,29,26,0,122
2019-01-26,3,SAS,28,32,36,30,0,126,NOP,27,30,28,29,0,114
2019-01-27,1,WAS,26,43,17,33,0,119,SAS,36,34,29,33,0,132
2019-01-29,2,PHO,33,34,24,33,0,124,SAS,33,37,26,30,0,126
2019-01-31,2,BRK,25,26,38,25,0,114,SAS,29,23,33,32,0,117
2019-02-02,2,NOP,24,26,28,30,0,108,SAS,35,28,31,19,0,113
2019-02-04,2,SAS,25,34,27,26,0,112,SAC,37,26,35,29,0,127
2019-02-06,2,SAS,31,21,31,19,0,102,GSW,33,33,49,26,0,141
2019-02-07,1,SAS,34,23,33,28,0,118,POR,31,39,26,31,0,127
2019-02-09,2,SAS,24,24,27,30,0,105,UTA,23,39,24,39,0,125
2019-02-12,3,SAS,20,37,37,14,0,108,MEM,33,25,28,21,0,107
2019-02-22,10,SAS,23,33,35,26,0,117,TOR,26,29,33,32,0,120
2019-02-24,2,SAS,26,27,30,35,0,118,NYK,30,32,32,36,0,130
2019-02-25,1,SAS,20,18,21,26,0,85,BRK,28,24,29,20,0,101
2019-02-27,2,DET,27,21,19,26,0,93,SAS,32,19,27,27,0,105
2019-03-02,3,OKC,25,38,15,24,0,102,SAS,38,34,20,24,0,116
2019-03-04,2,DEN,17,31,21,34,0,103,SAS,36,22,27,19,0,104
2019-03-06,2,SAS,27,26,27,31,0,111,ATL,23,33,21,27,0,104
2019-03-10,4,MIL,32,28,23,31,0,114,SAS,25,29,33,34,0,121
2019-03-12,2,SAS,34,26,24,28,0,112,DAL,24,29,21,31,0,105
2019-03-15,3,NYK,20,21,28,14,0,83,SAS,31,25,26,27,0,109
2019-03-16,1,POR,21,29,26,27,0,103,SAS,23,25,24,36,0,108
2019-03-18,2,GSW,25,22,31,27,0,105,SAS,25,33,24,29,0,111
2019-03-20,2,MIA,24,38,28,20,0,110,SAS,22,25,31,27,0,105
2019-03-22,2,SAS,24,23,34,24,0,105,HOU,36,26,19,30,0,111
2019-03-24,2,SAS,31,23,30,31,0,115,BOS,24,23,25,24,0,96
2019-03-26,2,SAS,23,36,21,26,10,116,CHO,29,26,27,24,19,125
2019-03-28,2,CLE,28,25,28,29,0,110,SAS,27,17,40,32,0,116
2019-03-31,3,SAC,28,30,31,24,0,113,SAS,30,27,30,19,0,106
2019-04-02,2,ATL,31,25,34,21,0,111,SAS,33,25,28,31,0,117
2019-04-03,1,SAS,24,19,21,21,0,85,DEN,28,33,25,27,0,113
2019-04-05,2,SAS,37,40,28,24,0,129,WAS,32,26,30,24,0,112
2019-04-07,2,SAS,24,38,17,33,0,112,CLE,24,22,17,27,0,90
2019-04-10,3,DAL,16,21,28,29,0,94,SAS,30,27,23,25,0,105
2018-10-17,10,NOP,35,36,30,30,0,131,HOU,29,25,30,28,0,112
2018-10-20,3,HOU,31,35,32,26,0,124,LAL,28,34,35,18,0,115
2018-10-21,1,HOU,24,29,31,28,0,112,LAC,29,25,39,22,0,115
2018-10-24,3,UTA,24,28,23,25,0,100,HOU,29,15,22,23,0,89
2018-10-26,2,LAC,31,39,26,37,0,133,HOU,30,31,22,30,0,113
2018-10-30,4,POR,19,32,34,19,0,104,HOU,15,21,26,23,0,85
2018-11-02,3,HOU,25,31,35,28,0,119,BRK,32,29,25,25,0,111
2018-11-03,1,HOU,27,27,21,21,0,96,CHI,28,28,7,25,0,88
2018-11-05,2,HOU,29,24,16,29,0,98,IND,22,33,20,19,0,94
2018-11-08,3,HOU,19,26,15,20,0,80,OKC,29,30,21,18,0,98
2018-11-10,2,HOU,21,29,21,18,0,89,SAS,20,32,20,24,0,96
2018-11-11,1,IND,31,23,27,22,0,103,HOU,32,44,26,13,0,115
2018-11-13,2,HOU,27,27,32,23,0,109,DEN,30,25,21,23,0,99
2018-11-15,2,GSW,19,22,22,23,0,86,HOU,25,22,29,31,0,107
2018-11-17,2,SAC,29,30,27,26,0,112,HOU,36,35,38,23,0,132
2018-11-21,4,DET,29,28,26,41,0,124,HOU,31,25,37,33,0,126
2018-11-23,2,HOU,30,26,23,19,13,111,DET,34,27,17,20,18,116
2018-11-24,1,HOU,30,28,25,25,0,108,CLE,29,34,30,24,0,117
2018-11-26,2,HOU,42,23,33,27,6,131,WAS,30,37,27,31,10,135
2018-11-28,2,DAL,36,38,22,32,0,128,HOU,28,28,33,19,0,108
2018-11-30,2,HOU,39,31,40,26,0,136,SAS,23,24,27,31,0,105
2018-12-01,1,CHI,22,24,29,30,0,105,HOU,38,18,31,34,0,121
2018-12-03,2,HOU,24,38,20,9,0,91,MIN,24,24,38,17,0,103
2018-12-06,3,HOU,18,27,11,35,0,91,UTA,27,26,38,27,0,118
2018-12-08,2,HOU,30,27,27,20,0,104,DAL,32,24,28,23,0,107
2018-12-11,3,POR,29,25,24,26,0,104,HOU,27,24,30,30,0,111
2018-12-13,2,LAL,24,32,32,23,0,111,HOU,29,33,28,36,0,126
2018-12-15,2,HOU,36,25,18,26,0,105,MEM,29,11,25,32,0,97
2018-12-17,2,UTA,23,14,36,24,0,97,HOU,25,25,33,19,0,102
2018-12-19,2,WAS,28,30,32,28,0,118,HOU,34,36,31,35,0,136
2018-12-20,1,HOU,33,25,18,23,0,99,MIA,21,32,29,19,0,101
2018-12-22,2,SAS,26,17,26,32,0,101,HOU,28,13,43,24,0,108
2018-12-25,3,OKC,22,38,28,21,0,109,HOU,22,30,34,27,0,113
2018-12-27,2,BOS,24,31,31,27,0,113,HOU,35,22,35,35,0,127
2018-12-29,2,HOU,30,23,24,31,0,108,NOP,20,30,26,28,0,104
2018-12-31,2,MEM,18,20,35,28,0,101,HOU,27,34,25,27,0,113
2019-01-03,3,HOU,22,31,39,27,16,135,GSW,34,36,28,21,15,134
2019-01-05,2,HOU,30,16,31,24,0,101,POR,30,29,27,24,0,110
2019-01-07,2,DEN,35,25,29,24,0,113,HOU,33,37,26,29,0,125
2019-01-09,2,MIL,26,28,38,24,0,116,HOU,29,31,23,26,0,109
2019-01-11,2,CLE,22,27,32,32,0,113,HOU,42,35,36,28,0,141
2019-01-13,2,HOU,26,33,29,21,0,109,ORL,18,34,34,30,0,116
2019-01-14,1,MEM,29,19,22,24,0,94,HOU,24,30,33,25,0,112
2019-01-16,2,BRK,34,28,23,46,14,145,HOU,30,24,40,37,11,142
2019-01-19,3,LAL,39,25,22,34,14,134,HOU,26,20,36,38,18,138
2019-01-21,2,HOU,26,24,13,30,0,93,PHI,30,35,29,27,0,121
2019-01-23,2,HOU,28,30,30,26,0,114,NYK,31,32,15,32,0,110
2019-01-25,2,TOR,20,41,28,30,0,119,HOU,33,37,26,25,0,121
2019-01-27,2,ORL,34,27,21,16,0,98,HOU,18,35,21,29,0,103
2019-01-29,2,NOP,28,31,35,27,0,121,HOU,35,31,25,25,0,116
2019-02-01,3,HOU,43,28,24,27,0,122,DEN,35,48,30,23,0,136
2019-02-02,1,HOU,31,32,28,34,0,125,UTA,27,23,19,29,0,98
2019-02-04,2,HOU,32,31,31,24,0,118,PHO,28,29,23,30,0,110
2019-02-06,2,HOU,32,44,28,23,0,127,SAC,28,17,29,27,0,101
2019-02-09,3,OKC,25,23,42,27,0,117,HOU,28,42,20,22,0,112
2019-02-11,2,DAL,22,28,28,26,0,104,HOU,25,39,28,28,0,120
2019-02-13,2,HOU,29,29,26,27,0,111,MIN,28,24,35,34,0,121
2019-02-21,8,HOU,32,26,32,16,0,106,LAL,22,30,31,28,0,111
2019-02-23,2,HOU,35,26,31,26,0,118,GSW,20,34,32,26,0,112
2019-02-25,2,ATL,28,32,25,26,0,111,HOU,39,21,35,24,0,119
2019-02-27,2,HOU,41,21,28,28,0,118,CHO,33,36,25,19,0,113
2019-02-28,1,MIA,32,37,29,20,0,118,HOU,33,22,31,35,0,121
2019-03-03,3,HOU,33,32,35,15,0,115,BOS,23,20,35,26,0,104
2019-03-05,2,HOU,23,32,14,38,0,107,TOR,19,18,34,24,0,95
2019-03-08,3,PHI,21,23,21,26,0,91,HOU,37,22,28,20,0,107
2019-03-10,2,HOU,25,33,23,13,0,94,DAL,26,28,18,21,0,93
2019-03-11,1,CHO,19,25,36,26,0,106,HOU,38,33,22,25,0,118
2019-03-13,2,GSW,33,21,31,21,0,106,HOU,23,29,26,26,0,104
2019-03-15,2,PHO,31,26,28,17,0,102,HOU,26,29,28,25,0,108
2019-03-17,2,MIN,30,19,29,24,0,102,HOU,26,24,43,24,0,117
2019-03-19,2,HOU,25,28,31,37,0,121,ATL,25,22,25,33,0,105
2019-03-20,1,HOU,25,28,25,37,10,125,MEM,38,25,34,18,11,126
2019-03-22,2,SAS,24,23,34,24,0,105,HOU,36,26,19,30,0,111
2019-03-24,2,HOU,33,30,24,26,0,113,NOP,19,25,25,21,0,90
2019-03-26,2,HOU,25,28,18,23,0,94,MIL,20,38,32,18,0,108
2019-03-28,2,DEN,25,19,21,20,0,85,HOU,22,40,25,25,0,112
2019-03-30,2,SAC,32,28,33,15,0,108,HOU,35,28,28,28,0,119
2019-04-02,3,HOU,33,29,29,39,0,130,SAC,23,23,31,28,0,105
2019-04-03,1,HOU,39,29,34,33,0,135,LAC,26,27,20,30,0,103
2019-04-05,2,NYK,16,27,21,32,0,96,HOU,32,40,31,17,0,120
2019-04-07,2,PHO,24,23,30,36,0,113,HOU,34,43,40,32,0,149
2019-04-09,2,HOU,32,28,33,18,0,111,OKC,26,25,29,32,0,112
2018-10-16,10,OKC,23,24,32,21,0,100,GSW,31,26,26,25,0,108
2018-10-19,3,OKC,20,26,31,15,0,92,LAC,27,21,23,37,0,108
2018-10-21,2,SAC,34,34,29,34,0,131,OKC,32,24,34,30,0,120
2018-10-25,4,BOS,16,18,40,27,0,101,OKC,22,28,23,22,0,95
2018-10-28,3,PHO,20,28,28,34,0,110,OKC,30,32,34,21,0,117
2018-10-30,2,LAC,33,34,10,33,0,110,OKC,25,29,39,35,0,128
2018-11-01,2,OKC,24,20,29,38,0,111,CHO,22,26,29,30,0,107
2018-11-02,1,OKC,35,44,31,24,0,134,WAS,30,20,35,26,0,111
2018-11-05,3,NOP,28,35,23,30,0,116,OKC,36,26,38,22,0,122
2018-11-07,2,OKC,23,25,23,24,0,95,CLE,20,20,24,22,0,86
2018-11-08,1,HOU,19,26,15,20,0,80,OKC,29,30,21,18,0,98
2018-11-10,2,OKC,22,23,25,26,0,96,DAL,23,34,25,29,0,111
2018-11-12,2,PHO,13,27,35,26,0,101,OKC,32,32,22,32,0,118
2018-11-14,2,NYK,22,27,31,23,0,103,OKC,37,28,35,28,0,128
2018-11-17,3,OKC,30,17,32,31,0,110,PHO,25,17,23,35,0,100
2018-11-19,2,OKC,24,32,29,28,0,113,SAC,37,32,15,33,0,117
2018-11-21,2,OKC,23,37,27,36,0,123,GSW,18,28,33,16,0,95
2018-11-23,2,CHO,31,26,23,24,0,104,OKC,33,29,27,20,0,109
2018-11-24,1,DEN,33,30,16,26,0,105,OKC,23,19,24,32,0,98
2018-11-28,4,CLE,28,19,15,21,0,83,OKC,21,26,26,27,0,100
2018-11-30,2,ATL,26,20,30,33,0,109,OKC,28,38,25,33,0,124
2018-12-03,3,OKC,26,24,37,23,0,110,DET,17,23,19,24,0,83
2018-12-05,2,OKC,24,22,29,39,0,114,BRK,26,36,31,19,0,112
2018-12-07,2,OKC,28,34,29,21,0,112,CHI,34,36,17,27,0,114
2018-12-10,3,UTA,22,24,29,38,0,113,OKC,30,27,42,23,0,122
2018-12-12,2,OKC,28,28,28,30,0,114,NOP,25,32,32,29,0,118
2018-12-14,2,OKC,32,20,24,22,0,98,DEN,39,21,22,27,0,109
2018-12-15,1,LAC,25,25,19,35,0,104,OKC,30,31,25,24,0,110
2018-12-17,2,CHI,22,22,25,27,0,96,OKC,31,33,24,33,0,121
2018-12-19,2,OKC,36,35,27,34,0,132,SAC,33,19,37,24,0,113
2018-12-22,3,OKC,26,32,35,14,0,107,UTA,32,29,20,25,0,106
2018-12-23,1,MIN,35,18,33,28,0,114,OKC,25,38,17,32,0,112
2018-12-25,2,OKC,22,38,28,21,0,109,HOU,22,30,34,27,0,113
2018-12-28,3,OKC,36,22,23,37,0,118,PHO,29,28,27,18,0,102
2018-12-30,2,OKC,28,31,14,30,0,103,DAL,27,30,27,21,0,105
2018-12-31,1,DAL,21,22,32,27,0,102,OKC,32,28,32,30,0,122
2019-01-02,2,OKC,25,34,19,29,0,107,LAL,25,32,25,18,0,100
2019-01-04,2,OKC,28,29,36,18,0,111,POR,28,34,25,22,0,109
2019-01-06,2,WAS,28,26,36,26,0,116,OKC,25,25,29,19,0,98
2019-01-08,2,MIN,29,35,32,23,0,119,OKC,23,41,29,24,0,117
2019-01-10,2,OKC,23,40,30,37,11,147,SAS,33,37,35,25,11,154
2019-01-12,2,SAS,31,29,20,32,0,112,OKC,23,28,35,36,0,122
2019-01-15,3,OKC,29,30,41,26,0,126,ATL,25,45,27,45,0,142
2019-01-17,2,LAL,27,40,28,27,16,138,OKC,39,24,33,26,6,128
2019-01-19,2,OKC,33,26,29,29,0,117,PHI,25,31,23,36,0,115
2019-01-21,2,OKC,34,33,36,24,0,127,NYK,16,31,35,27,0,109
2019-01-22,1,POR,25,30,32,27,0,114,OKC,25,37,31,30,0,123
2019-01-24,2,NOP,28,25,29,34,0,116,OKC,28,37,33,24,0,122
2019-01-27,3,MIL,25,17,37,33,0,112,OKC,31,25,33,29,0,118
2019-01-29,2,OKC,32,37,22,35,0,126,ORL,35,28,31,23,0,117
2019-02-01,3,OKC,31,41,22,24,0,118,MIA,24,29,21,28,0,102
2019-02-03,2,OKC,29,29,35,36,0,129,BOS,31,35,33,35,0,134
2019-02-05,2,ORL,32,37,23,30,0,122,OKC,31,31,36,34,0,132
2019-02-07,2,MEM,32,21,19,23,0,95,OKC,27,24,32,34,0,117
2019-02-09,2,OKC,25,23,42,27,0,117,HOU,28,42,20,22,0,112
2019-02-11,2,POR,26,23,33,29,0,111,OKC,36,32,19,33,0,120
2019-02-14,3,OKC,31,32,26,33,0,122,NOP,31,35,35,30,0,131
2019-02-22,8,UTA,34,23,38,34,10,147,OKC,35,31,27,36,10,148
2019-02-23,1,SAC,31,32,31,25,0,119,OKC,24,25,34,33,0,116
2019-02-26,3,OKC,26,25,27,34,0,112,DEN,29,35,27,30,0,121
2019-02-28,2,PHI,37,23,26,22,0,108,OKC,26,23,30,25,0,104
2019-03-02,2,OKC,25,38,15,24,0,102,SAS,38,34,20,24,0,116
2019-03-03,1,MEM,28,24,23,20,0,95,OKC,25,21,21,32,0,99
2019-03-05,2,OKC,24,33,30,33,0,120,MIN,30,41,31,29,0,131
2019-03-07,2,OKC,31,27,27,28,16,129,POR,30,31,22,30,8,121
2019-03-08,1,OKC,32,24,28,26,0,110,LAC,36,32,20,30,0,118
2019-03-11,3,OKC,22,28,27,21,0,98,UTA,21,16,26,26,0,89
2019-03-13,2,BRK,27,25,26,18,0,96,OKC,19,23,38,28,0,108
2019-03-14,1,OKC,29,34,25,18,0,106,IND,22,28,31,27,0,108
2019-03-16,2,GSW,40,24,23,23,0,110,OKC,27,19,25,17,0,88
2019-03-18,2,MIA,27,31,28,30,0,116,OKC,25,30,20,32,0,107
2019-03-20,2,TOR,39,24,29,18,13,123,OKC,31,24,23,32,4,114
2019-03-22,2,OKC,22,26,35,33,0,116,TOR,29,29,22,29,0,109
2019-03-25,3,OKC,23,25,30,25,0,103,MEM,31,23,32,29,0,115
2019-03-27,2,IND,27,27,15,30,0,99,OKC,29,16,31,31,0,107
2019-03-29,2,DEN,33,23,30,29,0,115,OKC,29,23,23,30,0,105
2019-03-31,2,DAL,31,27,22,26,0,106,OKC,24,32,19,28,0,103
2019-04-02,2,LAL,28,27,23,25,0,103,OKC,34,25,35,25,0,119
2019-04-05,3,DET,34,32,30,14,0,110,OKC,30,35,32,26,0,123
2019-04-07,2,OKC,38,24,33,37,0,132,MIN,31,29,37,29,0,126
2019-04-09,2,HOU,32,28,33,18,0,111,OKC,26,25,29,32,0,112
2019-04-10,1,OKC,29,39,30,29,0,127,MIL,31,27,31,27,0,116
2018-10-17,10,CLE,25,22,28,29,0,104,TOR,28,32,30,26,0,116
2018-10-19,2,BOS,25,28,26,22,0,101,TOR,18,31,33,31,0,113
2018-10-20,1,TOR,24,33,33,27,0,117,WAS,22,32,28,31,0,113
2018-10-22,2,CHO,22,25,32,27,0,106,TOR,31,31,35,30,0,127
2018-10-24,2,MIN,19,29,26,31,0,105,TOR,26,31,26,29,0,112
2018-10-26,2,DAL,26,34,29,18,0,107,TOR,39,30,23,24,0,116
2018-10-29,3,TOR,29,24,27,29,0,109,MIL,30,32,33,29,0,124
2018-10-30,1,PHI,26,27,33,26,0,112,TOR,35,32,38,24,0,129
2018-11-02,3,TOR,23,25,29,30,0,107,PHO,26,26,19,27,0,98
2018-11-04,2,TOR,42,29,30,20,0,121,LAL,17,32,31,27,0,107
2018-11-05,1,TOR,30,35,29,30,0,124,UTA,31,23,18,39,0,111
2018-11-07,2,TOR,29,35,30,20,0,114,SAC,26,25,27,27,0,105
2018-11-10,3,NYK,25,28,29,30,0,112,TOR,25,39,36,28,0,128
2018-11-12,2,NOP,31,35,28,32,0,126,TOR,29,32,22,27,0,110
2018-11-14,2,DET,26,27,24,29,0,106,TOR,31,34,23,16,0,104
2018-11-16,2,TOR,27,25,30,25,9,116,BOS,30,24,24,29,16,123
2018-11-17,1,TOR,27,30,32,33,0,122,CHI,18,26,12,27,0,83
2018-11-20,3,TOR,29,18,26,20,0,93,ORL,17,20,38,16,0,91
2018-11-21,1,TOR,29,26,31,38,0,124,ATL,24,20,29,35,0,108
2018-11-23,2,WAS,26,36,25,20,0,107,TOR,38,32,31,24,0,125
2018-11-25,2,MIA,29,25,35,26,0,115,TOR,36,27,38,24,0,125
2018-11-27,2,TOR,31,28,34,29,0,122,MEM,32,39,26,17,0,114
2018-11-29,2,GSW,25,33,30,31,9,128,TOR,38,29,29,23,12,131
2018-12-01,2,TOR,21,26,30,29,0,106,CLE,21,19,27,28,0,95
2018-12-03,2,DEN,27,32,27,20,0,106,TOR,24,23,31,25,0,103
2018-12-05,2,PHI,29,20,28,25,0,102,TOR,23,30,25,35,0,113
2018-12-07,2,TOR,20,33,26,19,7,105,BRK,24,29,27,18,8,106
2018-12-09,2,MIL,25,26,28,25,0,104,TOR,30,19,25,25,0,99
2018-12-11,2,TOR,36,34,33,20,0,123,LAC,23,34,17,25,0,99
2018-12-12,1,TOR,31,26,25,31,0,113,GSW,22,19,26,26,0,93
2018-12-14,2,TOR,23,27,39,33,0,122,POR,28,30,33,37,0,128
2018-12-16,2,TOR,23,24,25,14,0,86,DEN,23,16,29,27,0,95
2018-12-19,3,IND,34,24,27,11,0,96,TOR,24,26,25,24,0,99
2018-12-21,2,CLE,28,24,41,17,0,110,TOR,34,25,40,27,0,126
2018-12-22,1,TOR,30,29,20,22,0,101,PHI,29,36,26,35,0,126
2018-12-26,4,TOR,23,21,37,25,0,106,MIA,31,27,21,25,0,104
2018-12-28,2,TOR,29,19,15,24,0,87,ORL,25,32,35,24,0,116
2018-12-30,2,CHI,20,19,26,24,0,89,TOR,14,26,28,27,0,95
2019-01-01,2,UTA,24,29,32,31,0,116,TOR,26,25,44,27,0,122
2019-01-03,2,TOR,19,32,24,32,0,107,SAS,38,29,29,29,0,125
2019-01-05,2,TOR,27,29,35,32,0,123,MIL,34,23,25,34,0,116
2019-01-06,1,IND,35,28,21,21,0,105,TOR,37,33,26,25,0,121
2019-01-08,2,ATL,31,26,20,24,0,101,TOR,28,28,24,24,0,104
2019-01-11,3,BRK,35,18,22,30,0,105,TOR,28,36,35,23,0,122
2019-01-13,2,TOR,36,25,37,26,7,140,WAS,21,29,34,40,7,138
2019-01-16,3,TOR,36,17,30,25,0,108,BOS,30,34,23,30,0,117
2019-01-17,1,PHO,20,29,29,31,0,109,TOR,32,25,20,34,0,111
2019-01-19,2,MEM,19,29,14,28,0,90,TOR,23,32,45,19,0,119
2019-01-22,3,SAC,34,22,22,27,0,105,TOR,29,31,28,32,0,120
2019-01-23,1,TOR,16,31,28,31,0,106,IND,24,35,25,26,0,110
2019-01-25,2,TOR,20,41,28,30,0,119,HOU,33,37,26,25,0,121
2019-01-27,2,TOR,38,32,15,38,0,123,DAL,32,26,30,32,0,120
2019-01-31,4,MIL,22,34,31,18,0,105,TOR,25,22,29,16,0,92
2019-02-03,3,LAC,23,28,29,23,0,103,TOR,23,42,32,24,0,121
2019-02-05,2,TOR,40,32,28,19,0,119,PHI,28,27,27,25,0,107
2019-02-07,2,TOR,22,38,28,31,0,119,ATL,33,35,17,16,0,101
2019-02-09,2,TOR,25,21,28,30,0,104,NYK,23,19,27,30,0,99
2019-02-11,2,BRK,29,31,32,33,0,125,TOR,21,35,36,35,0,127
2019-02-13,2,WAS,26,39,28,27,0,120,TOR,30,29,44,26,0,129
2019-02-22,9,SAS,23,33,35,26,0,117,TOR,26,29,33,32,0,120
2019-02-24,2,ORL,25,28,27,33,0,113,TOR,15,35,21,27,0,98
2019-02-26,2,BOS,32,13,23,27,0,95,TOR,30,36,29,23,0,118
2019-03-01,3,POR,24,30,30,33,0,117,TOR,31,30,32,26,0,119
2019-03-03,2,TOR,19,26,33,22,7,107,DET,24,24,25,27,12,112
2019-03-05,2,HOU,23,32,14,38,0,107,TOR,19,18,34,24,0,95
2019-03-08,3,TOR,29,35,29,34,0,127,NOP,31,30,19,24,0,104
2019-03-10,2,TOR,32,36,23,34,0,125,MIA,27,27,25,25,0,104
2019-03-11,1,TOR,24,31,22,24,0,101,CLE,25,34,32,35,0,126
2019-03-14,3,LAL,25,29,30,14,0,98,TOR,33,32,25,21,0,111
2019-03-17,3,TOR,21,26,37,23,0,107,DET,25,25,28,32,0,110
2019-03-18,1,NYK,29,25,15,23,0,92,TOR,38,35,28,27,0,128
2019-03-20,2,TOR,39,24,29,18,13,123,OKC,31,24,23,32,4,114
2019-03-22,2,OKC,22,26,35,33,0,116,TOR,29,29,22,29,0,109
2019-03-24,2,CHO,27,31,37,20,0,115,TOR,32,25,26,31,0,114
2019-03-26,2,CHI,18,23,31,31,0,103,TOR,26,30,29,27,0,112
2019-03-28,2,TOR,30,25,32,30,0,117,NYK,18,18,28,28,0,92
2019-03-30,2,TOR,26,41,26,31,0,124,CHI,28,28,19,26,0,101
2019-04-01,2,ORL,36,16,23,34,0,109,TOR,29,33,33,26,0,121
2019-04-03,2,TOR,34,23,33,25,0,115,BRK,22,28,28,27,0,105
2019-04-05,2,TOR,34,31,21,25,0,111,CHO,33,24,33,23,0,113
2019-04-07,2,MIA,26,31,22,24,6,109,TOR,25,25,28,25,14,117
2019-04-09,2,TOR,26,43,29,22,0,120,MIN,28,19,31,22,0,100
2018-10-17,10,MIA,31,20,27,23,0,101,ORL,25,29,25,25,0,104
2018-10-19,2,CHO,22,29,31,38,0,120,ORL,10,21,23,34,0,88
2018-10-20,1,ORL,32,20,34,29,0,115,PHI,30,33,26,27,0,116
2018-10-22,2,ORL,28,20,27,18,0,93,BOS,19,26,25,20,0,90
2018-10-25,3,POR,33,25,33,37,0,128,ORL,22,26,36,30,0,114
2018-10-27,2,ORL,25,26,17,23,0,91,MIL,30,35,28,20,0,113
2018-10-30,3,SAC,26,33,26,22,0,107,ORL,31,25,16,27,0,99
2018-11-02,3,LAC,22,35,30,33,0,120,ORL,22,22,28,23,0,95
2018-11-04,2,ORL,36,27,28,26,0,117,SAS,26,28,20,36,0,110
2018-11-05,1,CLE,21,26,32,21,0,100,ORL,30,28,12,32,0,102
2018-11-07,2,DET,26,32,20,25,0,103,ORL,31,20,29,16,0,96
2018-11-09,2,WAS,25,23,26,34,0,108,ORL,32,31,26,28,0,117
2018-11-11,2,ORL,30,35,22,28,0,115,NYK,10,30,20,29,0,89
2018-11-12,1,ORL,30,25,28,26,0,109,WAS,30,25,28,34,0,117
2018-11-14,2,PHI,30,22,35,19,0,106,ORL,27,26,23,35,0,111
2018-11-17,3,LAL,31,22,28,36,0,117,ORL,25,37,38,30,0,130
2018-11-18,1,NYK,31,35,26,25,0,117,ORL,44,23,31,33,0,131
2018-11-20,2,TOR,29,18,26,20,0,93,ORL,17,20,38,16,0,91
2018-11-23,3,ORL,19,22,27,19,0,87,DEN,21,33,26,32,0,112
2018-11-25,2,ORL,19,32,35,22,0,108,LAL,29,23,19,33,0,104
2018-11-26,1,ORL,25,39,19,27,0,110,GSW,26,21,32,37,0,116
2018-11-28,2,ORL,30,33,21,28,0,112,POR,33,22,40,20,0,115
2018-11-30,2,ORL,21,30,24,24,0,99,PHO,25,23,23,14,0,85
2018-12-04,4,ORL,27,19,30,29,0,105,MIA,25,25,12,28,0,90
2018-12-05,1,DEN,31,25,32,24,12,124,ORL,28,26,32,26,6,118
2018-12-07,2,IND,28,29,29,26,0,112,ORL,25,20,25,20,0,90
2018-12-10,3,ORL,19,21,13,23,0,76,DAL,24,28,23,26,0,101
2018-12-13,3,CHI,26,20,25,20,0,91,ORL,24,27,26,20,0,97
2018-12-15,2,UTA,14,21,24,30,0,89,ORL,14,19,22,41,0,96
2018-12-19,4,SAS,31,35,38,25,0,129,ORL,24,20,33,13,0,90
2018-12-21,2,ORL,20,19,24,17,0,80,CHI,19,27,27,17,0,90
2018-12-23,2,MIA,28,25,37,25,0,115,ORL,17,27,27,20,0,91
2018-12-26,3,PHO,26,36,28,28,4,122,ORL,32,21,34,31,2,120
2018-12-28,2,TOR,29,19,15,24,0,87,ORL,25,32,35,24,0,116
2018-12-30,2,DET,21,38,24,24,0,107,ORL,31,31,23,24,0,109
2018-12-31,1,ORL,23,30,24,23,0,100,CHO,36,27,32,30,0,125
2019-01-02,2,ORL,32,30,28,22,0,112,CHI,16,29,17,22,0,84
2019-01-04,2,ORL,40,28,17,18,0,103,MIN,31,33,31,25,0,120
2019-01-06,2,ORL,28,19,20,29,0,96,LAC,18,27,25,36,0,106
2019-01-07,1,ORL,25,17,20,33,0,95,SAC,29,29,32,21,0,111
2019-01-09,2,ORL,32,31,12,18,0,93,UTA,19,27,32,28,0,106
2019-01-12,3,BOS,19,32,26,26,0,103,ORL,19,22,31,33,0,105
2019-01-13,1,HOU,26,33,29,21,0,109,ORL,18,34,34,30,0,116
2019-01-16,3,ORL,34,29,21,25,6,115,DET,26,32,32,19,11,120
2019-01-18,2,BRK,25,29,32,31,0,117,ORL,32,35,28,20,0,115
2019-01-19,1,MIL,33,26,28,31,0,118,ORL,24,22,36,26,0,108
2019-01-21,2,ORL,28,32,31,31,0,122,ATL,31,26,21,25,0,103
2019-01-23,2,ORL,25,31,30,24,0,110,BRK,26,30,33,25,0,114
2019-01-25,2,WAS,24,26,25,20,0,95,ORL,21,17,31,22,0,91
2019-01-27,2,ORL,34,27,21,16,0,98,HOU,18,35,21,29,0,103
2019-01-29,2,OKC,32,37,22,35,0,126,ORL,35,28,31,23,0,117
2019-01-31,2,IND,19,29,25,27,0,100,ORL,24,27,18,38,0,107
2019-02-02,2,BRK,21,27,22,19,0,89,ORL,26,18,34,24,0,102
2019-02-05,3,ORL,32,37,23,30,0,122,OKC,31,31,36,34,0,132
2019-02-07,2,MIN,31,27,27,27,0,112,ORL,32,39,31,20,0,122
2019-02-09,2,ORL,20,39,20,24,0,103,MIL,19,30,15,19,0,83
2019-02-10,1,ORL,26,37,35,26,0,124,ATL,25,23,26,34,0,108
2019-02-12,2,ORL,39,24,29,26,0,118,NOP,17,29,15,27,0,88
2019-02-14,2,CHO,18,18,31,22,0,89,ORL,33,38,27,29,0,127
2019-02-22,8,CHI,24,27,38,21,0,110,ORL,26,27,29,27,0,109
2019-02-24,2,ORL,25,28,27,33,0,113,TOR,15,35,21,27,0,98
2019-02-26,2,ORL,34,27,29,13,0,103,NYK,20,36,22,30,0,108
2019-02-28,2,GSW,22,29,30,15,0,96,ORL,28,31,11,33,0,103
2019-03-02,2,ORL,27,28,28,34,0,117,IND,27,33,27,25,0,112
2019-03-03,1,ORL,24,24,24,21,0,93,CLE,29,23,15,40,0,107
2019-03-05,2,ORL,34,30,18,24,0,106,PHI,39,31,24,20,0,114
2019-03-08,3,DAL,19,28,26,33,0,106,ORL,29,33,30,19,0,111
2019-03-10,2,ORL,17,31,24,25,0,97,MEM,26,23,26,30,0,105
2019-03-13,3,ORL,28,25,21,16,0,90,WAS,29,32,15,24,0,100
2019-03-14,1,CLE,20,21,22,28,0,91,ORL,36,25,27,32,0,120
2019-03-17,3,ATL,25,21,22,23,0,91,ORL,28,28,19,26,0,101
2019-03-20,3,NOP,25,21,21,29,0,96,ORL,39,29,30,21,0,119
2019-03-22,2,MEM,33,31,31,15,9,119,ORL,23,35,23,29,13,123
2019-03-25,3,PHI,31,29,17,21,0,98,ORL,31,26,32,30,0,119
2019-03-26,1,ORL,18,24,34,28,0,104,MIA,32,19,19,29,0,99
2019-03-28,2,ORL,27,19,25,27,0,98,DET,30,30,34,21,0,115
2019-03-30,2,ORL,32,24,34,31,0,121,IND,28,29,35,24,0,116
2019-04-01,2,ORL,36,16,23,34,0,109,TOR,29,33,33,26,0,121
2019-04-03,2,NYK,26,19,29,26,0,100,ORL,26,32,27,29,0,114
2019-04-05,2,ATL,18,30,32,33,0,113,ORL,42,39,32,36,0,149
2019-04-07,2,ORL,27,21,35,33,0,116,BOS,27,25,26,30,0,108
2019-04-10,3,ORL,30,32,35,25,0,122,CHO,25,33,30,26,0,114
