date,away_team,away_q1,away_q2,away_q3,away_q4,away_OT,away_final,home_team,home_q1,home_q2,home_q3,home_q4,home_OT,home_final
10/23/2019,CLE,24,17,24,20,0,85,ORL,28,27,16,23,0,94
10/26/2019,IND,28,20,26,25,0,99,CLE,26,39,25,20,0,110
10/28/2019,CLE,31,21,28,32,0,112,MIL,30,29,32,38,0,129
10/30/2019,CHI,26,27,29,29,0,111,CLE,25,25,30,37,0,117
11/1/2019,CLE,26,11,24,34,0,95,IND,19,23,26,34,0,102
11/3/2019,DAL,31,27,32,41,0,131,CLE,28,25,33,25,0,111
11/5/2019,BOS,32,29,28,30,0,119,CLE,24,28,31,30,0,113
11/8/2019,CLE,30,37,21,25,0,113,WAS,26,26,32,16,0,100
11/10/2019,CLE,31,23,24,30,0,108,NYK,19,17,27,24,0,87
11/12/2019,CLE,21,27,30,19,0,97,PHI,24,30,28,16,0,98
11/14/2019,MIA,34,34,26,14,0,108,CLE,22,22,30,23,0,97
11/17/2019,PHI,33,35,27,19,0,114,CLE,22,22,25,26,0,95
11/18/2019,CLE,20,31,20,34,0,105,NYK,32,32,30,29,0,123
11/20/2019,CLE,22,26,29,23,0,100,MIA,32,43,24,25,0,124
11/22/2019,CLE,26,16,29,30,0,101,DAL,29,37,45,32,0,143
11/23/2019,POR,19,23,27,35,0,104,CLE,19,30,27,34,0,110
11/25/2019,BRK,25,27,29,27,0,108,CLE,26,25,24,31,0,106
11/27/2019,ORL,27,32,28,29,0,116,CLE,27,25,21,31,0,104
11/29/2019,MIL,38,29,32,20,0,119,CLE,29,18,42,21,0,110
12/3/2019,DET,32,30,35,30,0,127,CLE,28,18,22,26,0,94
12/6/2019,ORL,24,28,16,25,0,93,CLE,25,22,23,17,0,87
12/7/2019,CLE,18,18,26,32,0,94,PHI,36,41,31,33,0,141
12/9/2019,CLE,18,22,26,22,0,88,BOS,29,24,30,27,0,110
12/11/2019,HOU,35,29,24,28,0,116,CLE,29,28,25,28,0,110
12/12/2019,CLE,28,25,25,25,14,117,SAS,19,24,25,35,6,109
12/14/2019,CLE,20,31,28,29,0,108,MIL,26,43,33,23,0,125
12/16/2019,CLE,29,25,30,29,0,113,TOR,37,29,38,29,0,133
12/18/2019,CHO,21,20,23,34,0,98,CLE,29,24,23,24,0,100
12/20/2019,MEM,27,24,36,20,0,107,CLE,25,30,26,33,0,114
12/23/2019,ATL,32,32,30,24,0,118,CLE,42,29,23,27,0,121
12/27/2019,CLE,22,25,34,36,0,117,BOS,33,29,30,37,0,129
12/28/2019,CLE,27,22,18,27,0,94,MIN,21,22,17,28,0,88
12/31/2019,CLE,25,18,26,28,0,97,TOR,27,32,27,31,0,117
1/2/2020,CHO,31,21,30,27,0,109,CLE,29,30,26,21,0,106
1/4/2020,OKC,34,32,25,30,0,121,CLE,27,26,26,27,0,106
1/5/2020,MIN,24,42,28,24,0,118,CLE,20,28,31,24,0,103
1/7/2020,DET,27,27,30,31,0,115,CLE,29,38,28,18,0,113
1/9/2020,CLE,26,24,31,21,13,115,DET,32,29,22,19,10,112
1/11/2020,CLE,23,28,34,26,0,111,DEN,18,24,29,32,0,103
1/13/2020,CLE,27,21,22,29,0,99,LAL,21,26,37,44,0,128
1/14/2020,CLE,26,24,21,32,0,103,LAC,31,35,40,22,0,128
1/17/2020,CLE,25,31,20,33,0,109,MEM,27,27,38,21,0,113
1/18/2020,CLE,33,40,29,14,0,116,CHI,31,25,31,31,0,118
1/20/2020,NYK,26,23,30,27,0,106,CLE,26,24,14,22,0,86
1/23/2020,WAS,29,39,32,24,0,124,CLE,24,37,25,26,0,112
1/25/2020,CHI,25,34,40,19,0,118,CLE,31,26,19,30,0,106
1/27/2020,CLE,24,29,36,26,0,115,DET,23,22,27,28,0,100
1/28/2020,NOP,40,34,30,21,0,125,CLE,34,31,25,21,0,111
1/30/2020,TOR,31,25,32,27,0,115,CLE,26,26,24,33,0,109
2/1/2020,GSW,31,30,44,26,0,131,CLE,32,27,19,34,0,112
2/3/2020,NYK,33,30,32,32,12,139,CLE,37,25,38,27,7,134
2/5/2020,CLE,28,25,28,22,0,103,OKC,29,32,23,25,0,109
2/9/2020,LAC,36,37,34,26,0,133,CLE,21,29,23,19,0,92
2/12/2020,ATL,19,29,32,25,0,105,CLE,33,32,33,29,0,127
2/21/2020,CLE,32,29,20,32,0,113,WAS,41,25,21,21,0,108
2/22/2020,CLE,32,20,26,27,0,105,MIA,38,44,24,18,0,124
2/24/2020,MIA,29,39,31,12,8,119,CLE,21,35,24,31,14,125
2/26/2020,PHI,17,27,24,26,0,94,CLE,28,27,22,31,0,108
2/28/2020,CLE,25,30,28,21,0,104,NOP,43,27,25,21,0,116
2/29/2020,IND,30,26,30,27,0,113,CLE,31,27,28,18,0,104
10/23/2019,BOS,25,23,20,25,0,93,PHI,20,29,28,30,0,107
10/25/2019,TOR,21,28,33,24,0,106,BOS,22,28,26,36,0,112
10/26/2019,BOS,22,24,36,36,0,118,NYK,24,27,25,19,0,95
10/30/2019,MIL,34,24,18,29,0,105,BOS,19,23,38,36,0,116
11/1/2019,NYK,23,27,24,28,0,102,BOS,22,27,26,29,0,104
11/5/2019,BOS,32,29,28,30,0,119,CLE,24,28,31,30,0,113
11/7/2019,BOS,30,22,33,23,0,108,CHO,20,23,24,20,0,87
11/9/2019,BOS,39,33,32,31,0,135,SAS,30,24,37,24,0,115
11/11/2019,DAL,21,33,25,27,0,106,BOS,25,29,30,32,0,116
11/13/2019,WAS,34,32,30,37,0,133,BOS,34,34,34,38,0,140
11/15/2019,BOS,23,29,24,29,0,105,GSW,32,19,20,29,0,100
11/17/2019,BOS,18,28,29,24,0,99,SAC,30,20,21,29,0,100
11/18/2019,BOS,26,31,23,19,0,99,PHO,22,20,23,20,0,85
11/20/2019,BOS,21,21,33,22,7,104,LAC,22,18,29,28,10,107
11/22/2019,BOS,13,21,23,35,0,92,DEN,27,18,25,26,0,96
11/25/2019,SAC,22,24,29,27,0,102,BOS,19,34,22,28,0,103
11/27/2019,BRK,23,40,23,24,0,110,BOS,30,27,34,30,0,121
11/29/2019,BOS,24,31,26,26,0,107,BRK,31,27,29,25,0,112
12/1/2019,BOS,31,27,23,32,0,113,NYK,30,28,27,19,0,104
12/4/2019,MIA,28,16,25,24,0,93,BOS,20,32,30,30,0,112
12/6/2019,DEN,26,19,19,31,0,95,BOS,33,20,32,23,0,108
12/9/2019,CLE,18,22,26,22,0,88,BOS,29,24,30,27,0,110
12/11/2019,BOS,32,25,37,23,0,117,IND,30,31,23,38,0,122
12/12/2019,PHI,28,28,25,34,0,115,BOS,34,25,21,29,0,109
12/18/2019,BOS,29,21,26,33,0,109,DAL,29,26,18,30,0,103
12/20/2019,DET,26,22,21,24,0,93,BOS,28,32,31,23,0,114
12/22/2019,CHO,37,19,21,16,0,93,BOS,30,29,25,35,0,119
12/25/2019,BOS,28,27,33,30,0,118,TOR,19,28,22,33,0,102
12/27/2019,CLE,22,25,34,36,0,117,BOS,33,29,30,37,0,129
12/28/2019,TOR,36,23,30,24,0,113,BOS,25,29,25,18,0,97
12/31/2019,BOS,24,26,30,29,0,109,CHO,18,25,30,19,0,92
1/3/2020,ATL,32,23,25,26,0,106,BOS,19,34,29,27,0,109
1/4/2020,BOS,30,25,30,26,0,111,CHI,28,24,21,31,0,104
1/6/2020,BOS,17,23,32,22,0,94,WAS,26,25,23,25,0,99
1/8/2020,SAS,34,31,34,30,0,129,BOS,22,25,36,31,0,114
1/9/2020,BOS,35,20,25,18,0,98,PHI,26,22,29,32,0,109
1/11/2020,NOP,24,33,25,23,0,105,BOS,41,31,42,26,0,140
1/13/2020,CHI,14,23,34,30,0,101,BOS,28,27,28,30,0,113
1/15/2020,DET,27,30,34,25,0,116,BOS,24,35,23,21,0,103
1/16/2020,BOS,20,38,29,36,0,123,MIL,36,40,30,22,0,128
1/18/2020,PHO,26,34,27,36,0,123,BOS,20,31,25,43,0,119
1/20/2020,LAL,30,25,25,27,0,107,BOS,33,36,35,35,0,139
1/22/2020,MEM,27,17,19,32,0,95,BOS,25,33,41,20,0,119
1/24/2020,BOS,24,29,29,27,0,109,ORL,30,27,20,21,0,98
1/26/2020,BOS,20,22,39,27,0,108,NOP,32,30,29,32,0,123
1/28/2020,BOS,36,17,27,29,0,109,MIA,28,20,28,25,0,101
1/30/2020,GSW,22,28,29,25,0,104,BOS,29,31,31,28,0,119
2/1/2020,PHI,19,32,16,28,0,95,BOS,32,27,27,30,0,116
2/3/2020,BOS,28,32,35,28,0,123,ATL,34,28,22,31,0,115
2/5/2020,ORL,24,32,24,20,0,100,BOS,32,25,30,29,0,116
2/7/2020,ATL,26,29,18,34,0,107,BOS,28,26,33,25,0,112
2/9/2020,BOS,28,24,32,28,0,112,OKC,32,29,23,27,0,111
2/11/2020,BOS,19,30,22,34,0,105,HOU,23,24,31,38,0,116
2/13/2020,LAC,32,26,29,27,13,133,BOS,30,30,31,23,13,141
2/21/2020,BOS,24,37,34,32,0,127,MIN,20,33,35,29,0,117
2/23/2020,BOS,19,35,33,25,0,112,LAL,28,28,31,27,0,114
2/25/2020,BOS,28,28,29,33,0,118,POR,24,24,22,36,0,106
2/26/2020,BOS,23,30,32,29,0,114,UTA,15,36,31,21,0,103
2/29/2020,HOU,19,26,36,23,7,111,BOS,28,28,22,26,6,110
10/23/2019,WAS,25,23,20,32,0,100,DAL,24,38,29,17,0,108
10/25/2019,WAS,28,24,26,19,0,97,OKC,24,22,24,15,0,85
10/26/2019,WAS,26,34,30,32,0,122,SAS,30,30,32,32,0,124
10/30/2019,HOU,35,41,35,48,0,159,WAS,34,43,40,41,0,158
11/2/2019,MIN,42,28,36,25,0,131,WAS,34,22,16,37,0,109
11/4/2019,DET,30,31,17,21,0,99,WAS,31,32,30,22,0,115
11/6/2019,WAS,26,36,18,26,0,106,IND,26,44,24,27,0,121
11/8/2019,CLE,30,37,21,25,0,113,WAS,26,26,32,16,0,100
11/13/2019,WAS,34,32,30,37,0,133,BOS,34,34,34,38,0,140
11/15/2019,WAS,39,37,26,35,0,137,MIN,30,43,19,24,0,116
11/17/2019,WAS,22,30,25,44,0,121,ORL,29,32,27,37,0,125
11/20/2019,SAS,38,31,29,34,0,132,WAS,35,28,38,37,0,138
11/22/2019,CHO,34,34,28,22,0,118,WAS,33,29,28,35,0,125
11/24/2019,SAC,24,33,33,23,0,113,WAS,27,30,28,21,0,106
11/26/2019,WAS,23,24,22,35,0,104,DEN,25,39,22,31,0,117
11/27/2019,WAS,36,38,34,32,0,140,PHO,34,35,26,37,0,132
11/29/2019,WAS,23,26,30,24,0,103,LAL,37,33,35,20,0,125
12/1/2019,WAS,35,22,41,27,0,125,LAC,39,43,34,34,0,150
12/3/2019,ORL,32,36,29,30,0,127,WAS,26,28,34,32,0,120
12/5/2019,PHI,33,22,26,32,0,113,WAS,25,40,26,28,0,119
12/6/2019,WAS,28,37,20,18,0,103,MIA,27,34,25,26,0,112
12/8/2019,LAC,35,30,35,35,0,135,WAS,25,39,29,26,0,119
12/10/2019,WAS,20,28,27,32,0,107,CHO,28,25,29,32,0,114
12/14/2019,WAS,30,24,30,27,0,111,MEM,35,34,35,24,0,128
12/16/2019,WAS,43,24,29,37,0,133,DET,31,30,30,28,0,119
12/18/2019,CHI,23,29,21,25,12,110,WAS,27,31,27,13,11,109
12/20/2019,WAS,23,29,33,33,0,118,TOR,40,28,28,26,0,122
12/21/2019,WAS,25,28,27,28,0,108,PHI,32,33,23,37,0,125
12/23/2019,WAS,32,31,31,27,0,121,NYK,37,27,27,24,0,115
12/26/2019,WAS,23,25,28,26,0,102,DET,31,37,38,26,0,132
12/28/2019,NYK,33,26,27,21,0,107,WAS,23,35,20,22,0,100
12/30/2019,MIA,39,24,18,24,0,105,WAS,29,42,19,33,0,123
1/1/2020,ORL,31,31,32,28,0,122,WAS,29,29,25,18,0,101
1/3/2020,POR,27,39,25,31,0,122,WAS,31,27,20,25,0,103
1/4/2020,DEN,19,36,35,24,0,114,WAS,31,30,34,33,0,128
1/6/2020,BOS,17,23,32,22,0,94,WAS,26,25,23,25,0,99
1/8/2020,WAS,23,29,20,17,0,89,ORL,32,37,28,26,0,123
1/10/2020,ATL,21,30,28,22,0,101,WAS,30,26,25,30,0,111
1/12/2020,UTA,23,32,38,34,0,127,WAS,34,32,25,25,0,116
1/15/2020,WAS,26,34,20,26,0,106,CHI,24,31,30,30,0,115
1/17/2020,WAS,26,25,25,35,0,111,TOR,38,27,35,40,0,140
1/20/2020,DET,35,23,23,19,0,100,WAS,30,30,23,23,0,106
1/22/2020,WAS,27,23,33,35,11,129,MIA,30,39,21,28,16,134
1/23/2020,WAS,29,39,32,24,0,124,CLE,24,37,25,26,0,112
1/26/2020,WAS,33,39,30,31,0,133,ATL,31,47,41,33,0,152
1/28/2020,WAS,28,35,41,27,0,131,MIL,42,46,29,34,0,151
1/30/2020,CHO,33,27,19,28,0,107,WAS,26,29,31,35,0,121
2/1/2020,BRK,36,25,23,23,0,107,WAS,27,32,22,32,0,113
2/3/2020,GSW,40,32,27,26,0,125,WAS,36,27,23,31,0,117
2/7/2020,DAL,33,31,29,25,0,118,WAS,29,33,30,27,0,119
2/9/2020,MEM,18,29,33,26,0,106,WAS,30,25,30,14,0,99
2/11/2020,CHI,26,36,20,32,0,114,WAS,36,33,31,26,0,126
2/12/2020,WAS,25,21,31,37,0,114,NYK,24,26,23,23,0,96
2/21/2020,CLE,32,29,20,32,0,113,WAS,41,25,21,21,0,108
2/23/2020,WAS,31,27,27,32,0,117,CHI,35,38,28,25,0,126
2/24/2020,MIL,30,27,38,28,14,137,WAS,25,22,35,41,11,134
2/26/2020,BRK,17,30,37,22,0,106,WAS,31,29,21,29,0,110
2/28/2020,WAS,28,32,21,38,0,119,UTA,31,27,32,39,0,129
3/1/2020,WAS,35,28,31,30,0,124,GSW,28,29,19,34,0,110
10/23/2019,CHI,28,27,40,30,0,125,CHO,37,26,33,30,0,126
10/25/2019,MIN,30,28,45,18,0,121,CHO,32,24,25,18,0,99
10/27/2019,CHO,28,34,18,21,0,101,LAL,30,33,24,33,0,120
10/28/2019,CHO,28,26,20,22,0,96,LAC,29,28,29,25,0,111
10/30/2019,CHO,30,31,32,25,0,118,SAC,33,33,18,27,0,111
11/2/2019,CHO,25,25,18,25,0,93,GSW,30,25,16,16,0,87
11/5/2019,IND,35,29,28,21,7,120,CHO,20,37,21,35,9,122
11/7/2019,BOS,30,22,33,23,0,108,CHO,20,23,24,20,0,87
11/9/2019,NOP,33,22,26,34,0,115,CHO,28,33,25,24,0,110
11/10/2019,CHO,24,34,23,25,0,106,PHI,33,20,35,26,0,114
11/13/2019,MEM,26,37,31,25,0,119,CHO,29,35,32,21,0,117
11/15/2019,DET,35,30,18,23,0,106,CHO,25,26,32,26,0,109
11/16/2019,CHO,20,27,28,28,0,103,NYK,23,32,21,26,0,102
11/18/2019,CHO,25,31,18,22,0,96,TOR,26,34,32,40,0,132
11/20/2019,CHO,26,25,22,18,0,91,BRK,26,30,26,19,0,101
11/22/2019,CHO,34,34,28,22,0,118,WAS,33,29,28,35,0,125
11/23/2019,CHI,34,22,13,47,0,116,CHO,23,26,25,41,0,115
11/25/2019,CHO,31,27,24,18,0,100,MIA,36,33,29,19,0,117
11/27/2019,DET,32,28,20,21,0,101,CHO,31,24,31,16,0,102
11/29/2019,CHO,38,24,23,25,0,110,DET,37,20,28,22,0,107
11/30/2019,CHO,25,24,26,21,0,96,MIL,32,34,35,36,0,137
12/2/2019,PHO,28,31,21,29,0,109,CHO,21,18,34,31,0,104
12/4/2019,GSW,20,34,22,15,0,91,CHO,28,30,28,20,0,106
12/6/2019,BRK,29,26,31,25,0,111,CHO,32,25,27,20,0,104
12/8/2019,ATL,24,27,37,34,0,122,CHO,27,26,30,24,0,107
12/10/2019,WAS,20,28,27,32,0,107,CHO,28,25,29,32,0,114
12/11/2019,CHO,26,27,31,29,0,113,BRK,34,30,22,22,0,108
12/13/2019,CHO,24,20,15,24,0,83,CHI,15,25,10,23,0,73
12/15/2019,CHO,20,24,22,19,0,85,IND,33,26,13,35,0,107
12/17/2019,SAC,21,26,32,23,0,102,CHO,26,27,27,30,0,110
12/18/2019,CHO,21,20,23,34,0,98,CLE,29,24,23,24,0,100
12/21/2019,UTA,31,25,28,30,0,114,CHO,33,31,22,21,0,107
12/22/2019,CHO,37,19,21,16,0,93,BOS,30,29,25,35,0,119
12/27/2019,OKC,26,27,19,22,10,104,CHO,18,25,22,29,8,102
12/29/2019,CHO,20,26,29,29,0,104,MEM,31,25,30,31,0,117
12/31/2019,BOS,24,26,30,29,0,109,CHO,18,25,30,19,0,92
1/2/2020,CHO,31,21,30,27,0,109,CLE,29,30,26,21,0,106
1/4/2020,CHO,32,25,23,23,20,123,DAL,20,24,40,19,17,120
1/6/2020,IND,27,15,37,36,0,115,CHO,29,15,21,39,0,104
1/8/2020,TOR,29,31,22,18,12,112,CHO,31,24,26,19,10,110
1/10/2020,CHO,13,25,24,30,0,92,UTA,29,32,26,22,0,109
1/12/2020,CHO,24,21,26,21,0,92,PHO,18,28,25,29,0,100
1/13/2020,CHO,26,20,43,23,0,112,POR,25,37,29,24,0,115
1/15/2020,CHO,25,17,27,17,0,86,DEN,28,29,17,26,0,100
1/20/2020,ORL,19,32,21,34,0,106,CHO,27,18,20,18,0,83
1/24/2020,MIL,24,26,28,38,0,116,CHO,31,24,23,25,0,103
1/28/2020,NYK,26,24,16,26,0,92,CHO,15,32,21,29,0,97
1/30/2020,CHO,33,27,19,28,0,107,WAS,26,29,31,35,0,121
2/1/2020,CHO,28,35,11,16,0,90,SAS,30,20,29,35,0,114
2/3/2020,ORL,25,31,29,27,0,112,CHO,24,30,23,23,0,100
2/4/2020,CHO,34,29,25,22,0,110,HOU,22,40,30,33,0,125
2/8/2020,DAL,31,33,30,22,0,116,CHO,10,33,22,35,0,100
2/10/2020,CHO,21,26,19,21,0,87,DET,11,26,22,17,0,76
2/12/2020,CHO,28,22,31,34,0,115,MIN,36,30,21,21,0,108
2/20/2020,CHO,33,27,19,24,0,103,CHI,20,24,29,20,0,93
2/22/2020,BRK,30,25,33,27,0,115,CHO,25,20,18,23,0,86
2/25/2020,CHO,25,19,11,25,0,80,IND,35,34,25,25,0,119
2/26/2020,NYK,27,19,29,26,0,101,CHO,30,26,29,22,0,107
2/28/2020,CHO,25,27,21,26,0,99,TOR,23,18,25,30,0,96
3/1/2020,MIL,26,19,25,23,0,93,CHO,20,23,25,17,0,85
10/23/2019,MIN,33,35,20,27,12,127,BRK,22,34,37,22,11,126
10/25/2019,MIN,30,28,45,18,0,121,CHO,32,24,25,18,0,99
10/27/2019,MIA,23,34,27,25,0,109,MIN,36,19,22,39,0,116
10/30/2019,MIN,24,19,35,17,0,95,PHI,32,30,30,25,0,117
11/2/2019,MIN,42,28,36,25,0,131,WAS,34,22,16,37,0,109
11/4/2019,MIL,31,33,38,32,0,134,MIN,27,30,25,24,0,106
11/6/2019,MIN,26,38,32,25,0,121,MEM,37,35,29,36,0,137
11/8/2019,GSW,31,30,25,24,9,119,MIN,29,31,20,30,15,125
11/10/2019,DEN,27,22,27,14,10,100,MIN,27,24,13,26,8,98
11/11/2019,MIN,41,25,26,28,0,120,DET,26,25,30,33,0,114
11/13/2019,SAS,24,35,36,19,0,114,MIN,26,40,40,23,0,129
11/15/2019,WAS,39,37,26,35,0,137,MIN,30,43,19,24,0,116
11/16/2019,HOU,31,33,29,32,0,125,MIN,30,32,23,20,0,105
11/18/2019,MIN,36,23,17,36,0,112,UTA,32,24,22,24,0,102
11/20/2019,UTA,26,22,25,30,0,103,MIN,19,27,22,27,0,95
11/23/2019,PHO,30,22,30,18,0,100,MIN,23,22,28,25,0,98
11/25/2019,MIN,38,16,39,32,0,125,ATL,30,34,26,23,0,113
11/27/2019,MIN,22,35,24,32,0,113,SAS,24,23,31,23,0,101
12/1/2019,MEM,25,23,38,29,0,115,MIN,21,26,32,28,0,107
12/4/2019,MIN,25,31,28,30,0,114,DAL,30,23,27,41,0,121
12/6/2019,MIN,27,31,39,25,5,127,OKC,30,23,41,28,17,139
12/8/2019,MIN,31,34,38,22,0,125,LAL,39,34,37,32,0,142
12/9/2019,MIN,31,33,21,24,0,109,PHO,33,28,33,31,0,125
12/11/2019,UTA,25,34,38,30,0,127,MIN,23,36,24,33,0,116
12/13/2019,LAC,33,32,37,22,0,124,MIN,29,29,23,36,0,117
12/18/2019,NOP,32,31,24,20,0,107,MIN,25,25,22,27,0,99
12/20/2019,MIN,20,31,24,25,0,100,DEN,33,28,21,27,0,109
12/21/2019,MIN,23,29,28,26,0,106,POR,27,34,22,30,0,113
12/23/2019,MIN,22,21,24,37,0,104,GSW,22,35,27,29,0,113
12/26/2019,MIN,21,29,21,19,7,105,SAC,26,22,31,11,7,104
12/28/2019,CLE,27,22,18,27,0,94,MIN,21,22,17,28,0,88
12/30/2019,BRK,29,21,30,23,12,115,MIN,27,22,25,29,19,122
1/1/2020,MIN,23,28,20,33,0,104,MIL,19,33,25,29,0,106
1/2/2020,GSW,19,22,26,17,0,84,MIN,34,24,23,18,0,99
1/5/2020,MIN,24,42,28,24,0,118,CLE,20,28,31,24,0,103
1/7/2020,MIN,32,24,28,28,0,112,MEM,27,24,31,37,0,119
1/9/2020,POR,34,13,27,28,0,102,MIN,28,31,41,16,0,116
1/11/2020,MIN,20,21,35,33,0,109,HOU,22,35,45,37,0,139
1/13/2020,OKC,30,33,29,25,0,117,MIN,33,27,19,25,0,104
1/15/2020,IND,24,30,22,28,0,104,MIN,30,29,18,22,0,99
1/17/2020,MIN,26,35,32,21,0,114,IND,32,35,32,17,0,116
1/18/2020,TOR,32,26,31,33,0,122,MIN,39,23,22,28,0,112
1/20/2020,DEN,26,29,26,26,0,107,MIN,29,25,25,21,0,100
1/22/2020,MIN,26,26,27,31,0,110,CHI,35,24,22,36,0,117
1/24/2020,HOU,36,27,31,37,0,131,MIN,26,34,24,40,0,124
1/25/2020,OKC,28,24,39,22,0,113,MIN,22,26,24,32,0,104
1/27/2020,SAC,24,26,28,41,14,133,MIN,37,31,29,22,10,129
2/1/2020,MIN,32,23,31,20,0,106,LAC,40,22,36,20,0,118
2/3/2020,MIN,20,30,34,25,0,109,SAC,29,36,28,20,0,113
2/5/2020,ATL,36,28,32,31,0,127,MIN,24,32,21,43,0,120
2/8/2020,LAC,31,28,29,27,0,115,MIN,40,41,31,30,0,142
2/10/2020,MIN,36,39,19,32,0,126,TOR,40,34,32,31,0,137
2/12/2020,CHO,28,22,31,34,0,115,MIN,36,30,21,21,0,108
2/21/2020,BOS,24,37,34,32,0,127,MIN,20,33,35,29,0,117
2/23/2020,MIN,38,27,22,29,0,116,DEN,43,30,24,31,0,128
2/24/2020,MIN,27,38,31,27,0,123,DAL,41,40,29,29,0,139
2/26/2020,MIN,29,28,38,34,0,129,MIA,28,32,34,32,0,126
2/28/2020,MIN,35,30,31,29,0,125,ORL,35,34,34,33,0,136
3/1/2020,DAL,28,35,18,30,0,111,MIN,24,20,21,26,0,91
10/23/2019,WAS,25,23,20,32,0,100,DAL,24,38,29,17,0,108
10/25/2019,DAL,27,45,23,28,0,123,NOP,41,23,29,23,0,116
10/27/2019,POR,25,34,36,26,0,121,DAL,40,31,24,24,0,119
10/29/2019,DAL,27,33,23,26,0,109,DEN,31,30,27,18,0,106
11/1/2019,LAL,20,28,28,27,16,119,DAL,25,33,27,18,7,110
11/3/2019,DAL,31,27,32,41,0,131,CLE,28,25,33,25,0,111
11/6/2019,ORL,28,28,23,27,0,106,DAL,25,29,32,21,0,107
11/8/2019,NYK,36,25,23,22,0,106,DAL,28,29,23,22,0,102
11/9/2019,DAL,31,37,36,34,0,138,MEM,34,28,29,31,0,122
11/11/2019,DAL,21,33,25,27,0,106,BOS,25,29,30,32,0,116
11/14/2019,DAL,23,30,34,16,0,103,NYK,27,31,29,19,0,106
11/16/2019,TOR,22,38,17,25,0,102,DAL,32,21,25,32,0,110
11/18/2019,SAS,22,27,30,31,0,110,DAL,36,23,34,24,0,117
11/20/2019,GSW,16,22,26,30,0,94,DAL,44,30,30,38,0,142
11/22/2019,CLE,26,16,29,30,0,101,DAL,29,37,45,32,0,143
11/24/2019,DAL,45,33,27,32,0,137,HOU,29,31,35,28,0,123
11/26/2019,LAC,34,28,31,21,0,114,DAL,27,19,31,22,0,99
11/29/2019,DAL,31,22,36,31,0,120,PHO,25,25,39,24,0,113
12/1/2019,DAL,25,34,35,20,0,114,LAL,30,32,17,21,0,100
12/3/2019,DAL,24,35,25,34,0,118,NOP,24,29,22,22,0,97
12/4/2019,MIN,25,31,28,30,0,114,DAL,30,23,27,41,0,121
12/7/2019,NOP,28,24,14,18,0,84,DAL,31,33,40,26,0,130
12/8/2019,SAC,36,30,26,18,0,110,DAL,27,19,32,28,0,106
12/12/2019,DAL,34,31,30,27,0,122,DET,29,29,27,26,0,111
12/14/2019,MIA,37,36,18,21,10,122,DAL,23,27,31,31,6,118
12/16/2019,DAL,36,23,27,34,0,120,MIL,22,34,20,40,0,116
12/18/2019,BOS,29,21,26,33,0,109,DAL,29,26,18,30,0,103
12/20/2019,DAL,35,28,25,29,0,117,PHI,28,29,20,21,0,98
12/22/2019,DAL,17,34,35,21,0,107,TOR,20,22,21,47,0,110
12/26/2019,SAS,24,23,27,24,0,98,DAL,20,32,27,23,0,102
12/28/2019,DAL,41,31,45,24,0,141,GSW,41,33,24,23,0,121
12/29/2019,DAL,19,24,26,26,0,95,LAL,25,29,30,24,0,108
12/31/2019,DAL,32,19,27,23,0,101,OKC,20,30,27,29,0,106
1/2/2020,BRK,30,35,28,18,0,111,DAL,31,29,33,30,0,123
1/4/2020,CHO,32,25,23,23,20,123,DAL,20,24,40,19,17,120
1/6/2020,CHI,27,28,27,28,0,110,DAL,33,28,27,30,0,118
1/8/2020,DEN,27,29,30,21,0,107,DAL,32,27,30,17,0,106
1/10/2020,LAL,45,34,20,30,0,129,DAL,27,31,28,28,0,114
1/11/2020,PHI,22,28,16,25,0,91,DAL,20,21,32,36,0,109
1/14/2020,DAL,36,29,29,30,0,124,GSW,26,21,24,26,0,97
1/15/2020,DAL,35,36,37,19,0,127,SAC,31,36,26,30,0,123
1/17/2020,POR,37,26,26,23,0,112,DAL,38,34,26,22,0,120
1/21/2020,LAC,24,36,22,28,0,110,DAL,24,25,29,29,0,107
1/23/2020,DAL,45,33,25,30,0,133,POR,37,26,27,35,0,125
1/25/2020,DAL,36,22,26,23,0,107,UTA,25,30,25,32,0,112
1/27/2020,DAL,25,34,29,19,0,107,OKC,22,25,30,20,0,97
1/28/2020,PHO,32,28,48,25,0,133,DAL,19,36,22,27,0,104
1/31/2020,DAL,28,32,25,36,0,121,HOU,35,30,36,27,0,128
2/1/2020,ATL,26,23,23,28,0,100,DAL,36,26,35,26,0,123
2/3/2020,DAL,25,28,29,30,0,112,IND,22,33,22,26,0,103
2/5/2020,MEM,31,28,41,21,0,121,DAL,32,24,22,29,0,107
2/7/2020,DAL,33,31,29,25,0,118,WAS,29,33,30,27,0,119
2/8/2020,DAL,31,33,30,22,0,116,CHO,10,33,22,35,0,100
2/10/2020,UTA,32,39,29,23,0,123,DAL,24,26,34,35,0,119
2/12/2020,SAC,28,24,25,34,0,111,DAL,32,31,33,34,0,130
2/21/2020,DAL,34,30,27,31,0,122,ORL,18,34,32,22,0,106
2/22/2020,DAL,35,31,20,21,0,107,ATL,21,37,19,34,0,111
2/24/2020,MIN,27,38,31,27,0,123,DAL,41,40,29,29,0,139
2/26/2020,DAL,36,23,29,21,0,109,SAS,20,29,28,26,0,103
2/28/2020,DAL,31,24,38,25,0,118,MIA,31,32,25,38,0,126
3/1/2020,DAL,28,35,18,30,0,111,MIN,24,20,21,26,0,91
10/24/2019,MIL,23,27,28,39,0,117,HOU,30,36,21,24,0,111
10/26/2019,MIA,29,24,29,39,10,131,MIL,33,37,23,28,5,126
10/28/2019,CLE,31,21,28,32,0,112,MIL,30,29,32,38,0,129
10/30/2019,MIL,34,24,18,29,0,105,BOS,19,23,38,36,0,116
11/1/2019,MIL,31,31,26,35,0,123,ORL,27,14,30,20,0,91
11/2/2019,TOR,17,33,40,15,0,105,MIL,36,30,29,20,0,115
11/4/2019,MIL,31,33,38,32,0,134,MIN,27,30,25,24,0,106
11/6/2019,MIL,28,42,28,31,0,129,LAC,30,29,30,35,0,124
11/8/2019,MIL,16,19,39,26,0,100,UTA,30,25,26,22,0,103
11/10/2019,MIL,21,29,37,34,0,121,OKC,24,32,24,39,0,119
11/14/2019,CHI,32,34,20,29,0,115,MIL,30,35,32,27,0,124
11/16/2019,MIL,26,23,22,31,0,102,IND,22,14,27,20,0,83
11/18/2019,MIL,29,31,24,31,0,115,CHI,26,30,25,20,0,101
11/20/2019,MIL,34,24,38,39,0,135,ATL,26,35,22,44,0,127
11/21/2019,POR,27,31,40,31,0,129,MIL,37,35,35,30,0,137
11/23/2019,DET,24,23,22,21,0,90,MIL,27,27,23,27,0,104
11/25/2019,UTA,25,32,26,35,0,118,MIL,23,25,42,32,0,122
11/27/2019,ATL,17,42,23,20,0,102,MIL,33,27,21,30,0,111
11/29/2019,MIL,38,29,32,20,0,119,CLE,29,18,42,21,0,110
11/30/2019,CHO,25,24,26,21,0,96,MIL,32,34,35,36,0,137
12/2/2019,NYK,15,30,17,26,0,88,MIL,33,39,28,32,0,132
12/4/2019,MIL,22,37,33,35,0,127,DET,24,24,24,31,0,103
12/6/2019,LAC,15,28,19,29,0,91,MIL,30,22,35,32,0,119
12/9/2019,ORL,20,20,33,28,0,101,MIL,31,21,28,30,0,110
12/11/2019,NOP,20,26,40,26,0,112,MIL,35,34,36,22,0,127
12/13/2019,MIL,35,29,26,37,0,127,MEM,29,33,33,19,0,114
12/14/2019,CLE,20,31,28,29,0,108,MIL,26,43,33,23,0,125
12/16/2019,DAL,36,23,27,34,0,120,MIL,22,34,20,40,0,116
12/19/2019,LAL,17,29,35,23,0,104,MIL,23,42,24,22,0,111
12/21/2019,MIL,37,31,27,28,0,123,NYK,23,31,16,32,0,102
12/22/2019,IND,22,33,18,16,0,89,MIL,21,38,24,34,0,117
12/25/2019,MIL,30,18,25,36,0,109,PHI,38,31,31,21,0,121
12/27/2019,MIL,32,31,21,28,0,112,ATL,19,21,23,23,0,86
12/28/2019,ORL,25,21,28,26,0,100,MIL,37,19,22,33,0,111
12/30/2019,MIL,31,24,40,28,0,123,CHI,20,32,25,25,0,102
1/1/2020,MIN,23,28,20,33,0,104,MIL,19,33,25,29,0,106
1/4/2020,SAS,31,35,25,27,0,118,MIL,29,42,32,24,0,127
1/6/2020,MIL,22,30,29,23,0,104,SAS,27,38,26,35,0,126
1/8/2020,MIL,19,28,34,26,0,107,GSW,19,20,33,26,0,98
1/10/2020,MIL,34,19,37,37,0,127,SAC,18,26,31,31,0,106
1/11/2020,MIL,32,32,33,25,0,122,POR,24,31,25,21,0,101
1/14/2020,NYK,23,17,36,26,0,102,MIL,29,36,43,20,0,128
1/16/2020,BOS,20,38,29,36,0,123,MIL,36,40,30,22,0,128
1/18/2020,MIL,30,27,36,24,0,117,BRK,22,20,29,26,0,97
1/20/2020,CHI,23,29,25,21,0,98,MIL,30,23,31,27,0,111
1/24/2020,MIL,24,26,28,38,0,116,CHO,31,24,23,25,0,103
1/28/2020,WAS,28,35,41,27,0,131,MIL,42,46,29,34,0,151
1/31/2020,DEN,35,25,40,27,0,127,MIL,43,24,24,24,0,115
2/2/2020,PHO,26,26,28,28,0,108,MIL,30,37,30,32,0,129
2/4/2020,MIL,26,32,42,20,0,120,NOP,33,28,24,23,0,108
2/6/2020,PHI,26,25,23,27,0,101,MIL,22,32,32,26,0,112
2/8/2020,MIL,29,33,21,28,0,111,ORL,24,22,25,24,0,95
2/10/2020,SAC,24,34,32,21,0,111,MIL,38,19,31,35,0,123
2/12/2020,MIL,20,25,26,40,0,111,IND,34,34,14,36,0,118
2/20/2020,MIL,32,38,28,28,0,126,DET,18,23,30,35,0,106
2/22/2020,PHI,21,29,23,25,0,98,MIL,31,25,37,26,0,119
2/24/2020,MIL,30,27,38,28,14,137,WAS,25,22,35,41,11,134
2/25/2020,MIL,25,25,34,24,0,108,TOR,27,25,19,26,0,97
2/28/2020,OKC,24,23,22,17,0,86,MIL,31,39,37,26,0,133
3/1/2020,MIL,26,19,25,23,0,93,CHO,20,23,25,17,0,85
10/23/2019,BOS,25,23,20,25,0,93,PHI,20,29,28,30,0,107
10/26/2019,PHI,28,26,29,34,0,117,DET,29,28,26,28,0,111
10/28/2019,PHI,31,32,19,23,0,105,ATL,40,25,18,20,0,103
10/30/2019,MIN,24,19,35,17,0,95,PHI,32,30,30,25,0,117
11/2/2019,PHI,27,30,35,37,0,129,POR,32,36,34,26,0,128
11/4/2019,PHI,31,30,21,27,0,109,PHO,29,26,26,33,0,114
11/6/2019,PHI,29,27,17,31,0,104,UTA,26,32,26,22,0,106
11/8/2019,PHI,24,33,27,13,0,97,DEN,18,24,23,35,0,100
11/10/2019,CHO,24,34,23,25,0,106,PHI,33,20,35,26,0,114
11/12/2019,CLE,21,27,30,19,0,97,PHI,24,30,28,16,0,98
11/13/2019,PHI,30,23,29,15,0,97,ORL,31,22,27,32,0,112
11/15/2019,PHI,29,20,34,24,12,119,OKC,24,30,26,27,20,127
11/17/2019,PHI,33,35,27,19,0,114,CLE,22,22,25,26,0,95
11/20/2019,NYK,25,26,28,25,0,104,PHI,27,26,21,35,0,109
11/22/2019,SAS,22,30,28,24,0,104,PHI,29,30,28,28,0,115
11/23/2019,MIA,13,22,24,27,0,86,PHI,28,27,37,21,0,113
11/25/2019,PHI,34,15,31,16,0,96,TOR,28,23,30,20,0,101
11/27/2019,SAC,18,28,19,26,0,91,PHI,25,22,29,21,0,97
11/29/2019,PHI,18,21,31,31,0,101,NYK,31,20,17,27,0,95
11/30/2019,IND,29,36,28,23,0,116,PHI,38,27,28,26,0,119
12/2/2019,UTA,23,19,24,28,0,94,PHI,31,29,25,18,0,103
12/5/2019,PHI,33,22,26,32,0,113,WAS,25,40,26,28,0,119
12/7/2019,CLE,18,18,26,32,0,94,PHI,36,41,31,33,0,141
12/8/2019,TOR,22,20,26,36,0,104,PHI,27,30,29,24,0,110
12/10/2019,DEN,27,23,26,16,0,92,PHI,26,29,28,14,0,97
12/12/2019,PHI,28,28,25,34,0,115,BOS,34,25,21,29,0,109
12/13/2019,NOP,25,32,25,27,0,109,PHI,39,23,30,24,0,116
12/15/2019,PHI,23,20,23,23,0,89,BRK,28,29,26,26,0,109
12/18/2019,MIA,19,37,26,26,0,108,PHI,29,19,26,30,0,104
12/20/2019,DAL,35,28,25,29,0,117,PHI,28,29,20,21,0,98
12/21/2019,WAS,25,28,27,28,0,108,PHI,32,33,23,37,0,125
12/23/2019,PHI,30,30,34,31,0,125,DET,23,29,34,23,0,109
12/25/2019,MIL,30,18,25,36,0,109,PHI,38,31,31,21,0,121
12/27/2019,PHI,21,26,21,29,0,97,ORL,19,27,25,27,0,98
12/28/2019,PHI,33,26,20,29,8,116,MIA,28,26,31,23,9,117
12/31/2019,PHI,27,16,23,31,0,97,IND,29,38,29,19,0,115
1/3/2020,PHI,27,26,31,24,0,108,HOU,20,40,36,22,0,118
1/6/2020,OKC,31,21,34,27,0,113,PHI,31,31,28,30,0,120
1/9/2020,BOS,35,20,25,18,0,98,PHI,26,22,29,32,0,109
1/11/2020,PHI,22,28,16,25,0,91,DAL,20,21,32,36,0,109
1/13/2020,PHI,23,26,20,26,0,95,IND,22,18,29,32,0,101
1/15/2020,BRK,28,29,33,16,0,106,PHI,25,29,32,31,0,117
1/17/2020,CHI,24,23,24,18,0,89,PHI,21,25,35,19,0,100
1/18/2020,PHI,28,24,18,20,0,90,NYK,25,21,23,18,0,87
1/20/2020,PHI,29,35,26,27,0,117,BRK,32,36,23,20,0,111
1/22/2020,PHI,35,15,22,23,0,95,TOR,26,24,26,31,0,107
1/25/2020,LAL,25,25,23,18,0,91,PHI,35,24,26,23,0,108
1/28/2020,GSW,27,27,28,22,0,104,PHI,26,33,27,29,0,115
1/30/2020,PHI,31,36,25,25,0,117,ATL,39,35,25,28,0,127
2/1/2020,PHI,19,32,16,28,0,95,BOS,32,27,27,30,0,116
2/3/2020,PHI,26,26,25,29,0,106,MIA,30,26,41,40,0,137
2/6/2020,PHI,26,25,23,27,0,101,MIL,22,32,32,26,0,112
2/7/2020,MEM,25,19,22,41,0,107,PHI,26,32,39,22,0,119
2/9/2020,CHI,25,30,28,28,0,111,PHI,38,22,23,35,0,118
2/11/2020,LAC,22,32,23,26,0,103,PHI,30,24,27,29,0,110
2/20/2020,BRK,20,32,26,25,1,104,PHI,26,16,35,26,9,112
2/22/2020,PHI,21,29,23,25,0,98,MIL,31,25,37,26,0,119
2/24/2020,ATL,24,28,40,20,0,112,PHI,41,28,22,38,0,129
2/26/2020,PHI,17,27,24,26,0,94,CLE,28,27,22,31,0,108
2/27/2020,NYK,21,25,33,27,0,106,PHI,26,35,26,28,0,115
3/1/2020,PHI,39,33,24,34,0,130,LAC,34,36,38,28,0,136
10/23/2019,SAC,29,30,17,19,0,95,PHO,25,29,32,38,0,124
10/25/2019,PHO,21,24,17,33,12,107,DEN,15,24,25,31,13,108
10/26/2019,LAC,22,33,30,37,0,122,PHO,26,29,36,39,0,130
10/28/2019,UTA,28,18,24,26,0,96,PHO,21,18,31,25,0,95
10/30/2019,PHO,43,29,23,26,0,121,GSW,14,32,21,43,0,110
11/2/2019,PHO,31,14,37,32,0,114,MEM,24,23,22,36,0,105
11/4/2019,PHI,31,30,21,27,0,109,PHO,29,26,26,33,0,114
11/7/2019,MIA,31,33,29,31,0,124,PHO,30,27,29,22,0,108
11/10/2019,BRK,30,20,30,32,0,112,PHO,37,31,38,32,0,138
11/12/2019,LAL,26,34,35,28,0,123,PHO,29,29,34,23,0,115
11/14/2019,ATL,33,28,29,22,0,112,PHO,31,36,37,24,0,128
11/18/2019,BOS,26,31,23,19,0,99,PHO,22,20,23,20,0,85
11/19/2019,PHO,19,26,30,41,0,116,SAC,33,29,25,33,0,120
11/21/2019,NOP,38,21,36,29,0,124,PHO,33,33,28,27,0,121
11/23/2019,PHO,30,22,30,18,0,100,MIN,23,22,28,25,0,98
11/24/2019,PHO,28,29,20,27,0,104,DEN,28,24,27,37,0,116
11/27/2019,WAS,36,38,34,32,0,140,PHO,34,35,26,37,0,132
11/29/2019,DAL,31,22,36,31,0,120,PHO,25,25,39,24,0,113
12/2/2019,PHO,28,31,21,29,0,109,CHO,21,18,34,31,0,104
12/4/2019,PHO,37,21,28,28,0,114,ORL,31,34,38,25,0,128
12/5/2019,PHO,38,36,33,18,14,139,NOP,40,30,21,34,7,132
12/7/2019,PHO,31,21,26,31,0,109,HOU,23,37,23,32,0,115
12/9/2019,MIN,31,33,21,24,0,109,PHO,33,28,33,31,0,125
12/11/2019,MEM,27,24,33,31,0,115,PHO,19,32,28,29,0,108
12/14/2019,SAS,28,16,34,31,12,121,PHO,18,30,32,29,10,119
12/16/2019,POR,25,34,31,21,0,111,PHO,33,34,21,22,0,110
12/17/2019,PHO,23,21,25,30,0,99,LAC,31,23,36,30,0,120
12/20/2019,PHO,23,27,41,17,0,108,OKC,26,31,44,25,0,126
12/21/2019,HOU,36,34,36,33,0,139,PHO,35,30,30,30,0,125
12/23/2019,DEN,34,22,26,31,0,113,PHO,22,27,32,30,0,111
12/27/2019,PHO,29,22,27,18,0,96,GSW,25,18,23,39,0,105
12/28/2019,PHO,31,28,22,31,0,112,SAC,30,19,28,33,0,110
12/30/2019,PHO,19,36,28,39,0,122,POR,38,26,25,27,0,116
1/1/2020,PHO,17,24,38,28,0,107,LAL,43,31,27,16,0,117
1/3/2020,NYK,37,24,26,25,0,112,PHO,29,22,32,37,0,120
1/5/2020,MEM,27,35,34,25,0,121,PHO,31,26,20,37,0,114
1/7/2020,SAC,26,27,25,36,0,114,PHO,29,24,34,16,0,103
1/10/2020,ORL,25,23,27,19,0,94,PHO,27,31,19,21,0,98
1/12/2020,CHO,24,21,26,21,0,92,PHO,18,28,25,29,0,100
1/14/2020,PHO,25,26,32,27,0,110,ATL,28,28,28,39,0,123
1/16/2020,PHO,25,33,32,31,0,121,NYK,32,20,27,19,0,98
1/18/2020,PHO,26,34,27,36,0,123,BOS,20,31,25,43,0,119
1/20/2020,SAS,28,38,30,24,0,120,PHO,26,25,32,35,0,118
1/22/2020,IND,30,24,29,29,0,112,PHO,24,24,17,22,0,87
1/24/2020,PHO,22,34,22,25,0,103,SAS,28,16,28,27,0,99
1/26/2020,PHO,18,27,33,31,0,109,MEM,30,26,25,33,0,114
1/28/2020,PHO,32,28,48,25,0,133,DAL,19,36,22,27,0,104
1/31/2020,OKC,25,28,26,32,0,111,PHO,27,25,29,26,0,107
2/2/2020,PHO,26,26,28,28,0,108,MIL,30,37,30,32,0,129
2/3/2020,PHO,31,21,21,24,0,97,BRK,35,20,35,29,0,119
2/5/2020,PHO,31,30,25,22,0,108,DET,38,26,25,27,0,116
2/7/2020,HOU,26,29,18,18,0,91,PHO,46,19,32,30,0,127
2/8/2020,DEN,28,27,28,34,0,117,PHO,37,17,24,30,0,108
2/10/2020,PHO,30,22,23,25,0,100,LAL,31,30,29,35,0,125
2/12/2020,GSW,24,26,26,30,0,106,PHO,34,24,29,25,0,112
2/21/2020,PHO,23,20,35,23,0,101,TOR,31,36,26,25,0,118
2/22/2020,PHO,22,25,36,29,0,112,CHI,24,33,23,24,0,104
2/24/2020,PHO,27,35,37,32,0,131,UTA,35,27,26,23,0,111
2/26/2020,LAC,21,33,22,26,0,102,PHO,29,20,17,26,0,92
2/28/2020,DET,29,23,32,29,0,113,PHO,24,29,26,32,0,111
2/29/2020,GSW,28,33,31,23,0,115,PHO,41,24,16,18,0,99
10/22/2019,LAL,25,29,31,17,0,102,LAC,22,40,23,27,0,112
10/25/2019,UTA,17,20,18,31,0,86,LAL,24,19,31,21,0,95
10/27/2019,CHO,28,34,18,21,0,101,LAL,30,33,24,33,0,120
10/29/2019,MEM,32,15,20,24,0,91,LAL,27,22,39,32,0,120
11/1/2019,LAL,20,28,28,27,16,119,DAL,25,33,27,18,7,110
11/3/2019,LAL,26,30,21,26,0,103,SAS,25,18,29,24,0,96
11/5/2019,LAL,24,24,32,38,0,118,CHI,29,36,28,19,0,112
11/8/2019,MIA,21,25,20,14,0,80,LAL,28,20,30,17,0,95
11/10/2019,TOR,29,23,26,35,0,113,LAL,30,30,18,26,0,104
11/12/2019,LAL,26,34,35,28,0,123,PHO,29,29,34,23,0,115
11/13/2019,GSW,26,29,27,12,0,94,LAL,38,29,31,22,0,120
11/15/2019,SAC,30,20,21,26,0,97,LAL,20,29,25,25,0,99
11/17/2019,ATL,24,17,36,24,0,101,LAL,36,33,27,26,0,122
11/19/2019,OKC,28,25,34,20,0,107,LAL,33,30,30,19,0,112
11/22/2019,LAL,34,32,40,24,0,130,OKC,33,34,36,24,0,127
11/23/2019,LAL,25,30,30,24,0,109,MEM,35,28,21,24,0,108
11/25/2019,LAL,25,29,32,28,0,114,SAS,22,34,26,22,0,104
11/27/2019,LAL,25,29,25,35,0,114,NOP,38,26,25,21,0,110
11/29/2019,WAS,23,26,30,24,0,103,LAL,37,33,35,20,0,125
12/1/2019,DAL,25,34,35,20,0,114,LAL,30,32,17,21,0,100
12/3/2019,LAL,28,32,24,21,0,105,DEN,24,25,27,20,0,96
12/4/2019,LAL,34,31,29,27,0,121,UTA,26,21,28,21,0,96
12/6/2019,LAL,39,38,33,26,0,136,POR,34,28,31,20,0,113
12/8/2019,MIN,31,34,38,22,0,125,LAL,39,34,37,32,0,142
12/11/2019,LAL,26,25,18,27,0,96,ORL,9,29,27,22,0,87
12/13/2019,LAL,30,21,37,25,0,113,MIA,29,30,26,25,0,110
12/15/2019,LAL,24,31,27,19,0,101,ATL,25,23,30,18,0,96
12/17/2019,LAL,28,24,24,26,0,102,IND,24,26,28,27,0,105
12/19/2019,LAL,17,29,35,23,0,104,MIL,23,42,24,22,0,111
12/22/2019,DEN,23,32,36,37,0,128,LAL,28,25,25,26,0,104
12/25/2019,LAC,31,20,35,25,0,111,LAL,33,30,23,20,0,106
12/28/2019,LAL,34,37,32,25,0,128,POR,32,32,31,25,0,120
12/29/2019,DAL,19,24,26,26,0,95,LAL,25,29,30,24,0,108
1/1/2020,PHO,17,24,38,28,0,107,LAL,43,31,27,16,0,117
1/3/2020,NOP,30,32,21,30,0,113,LAL,42,32,31,18,0,123
1/5/2020,DET,22,25,32,20,0,99,LAL,23,33,19,31,0,106
1/7/2020,NYK,21,24,25,17,0,87,LAL,26,36,23,32,0,117
1/10/2020,LAL,45,34,20,30,0,129,DAL,27,31,28,28,0,114
1/11/2020,LAL,41,32,29,23,0,125,OKC,19,30,33,28,0,110
1/13/2020,CLE,27,21,22,29,0,99,LAL,21,26,37,44,0,128
1/15/2020,ORL,35,30,24,30,0,119,LAL,29,29,30,30,0,118
1/18/2020,LAL,27,32,32,33,0,124,HOU,34,31,17,33,0,115
1/20/2020,LAL,30,25,25,27,0,107,BOS,33,36,35,35,0,139
1/22/2020,LAL,28,20,28,24,0,100,NYK,25,23,22,22,0,92
1/23/2020,LAL,38,37,29,24,0,128,BRK,35,35,24,19,0,113
1/25/2020,LAL,25,25,23,18,0,91,PHI,35,24,26,23,0,108
1/31/2020,POR,38,22,43,24,0,127,LAL,36,26,34,23,0,119
2/1/2020,LAL,44,37,23,25,0,129,SAC,22,42,25,24,0,113
2/4/2020,SAS,19,22,33,28,0,102,LAL,21,30,36,42,0,129
2/6/2020,HOU,28,35,34,24,0,121,LAL,29,34,30,18,0,111
2/8/2020,LAL,33,33,30,29,0,125,GSW,25,34,25,36,0,120
2/10/2020,PHO,30,22,23,25,0,100,LAL,31,30,29,35,0,125
2/12/2020,LAL,23,38,23,27,9,120,DEN,31,24,32,24,5,116
2/21/2020,MEM,22,19,36,28,0,105,LAL,28,32,24,33,0,117
2/23/2020,BOS,19,35,33,25,0,112,LAL,28,28,31,27,0,114
2/25/2020,NOP,26,32,28,23,0,109,LAL,30,34,24,30,0,118
2/27/2020,LAL,24,30,40,22,0,116,GSW,24,28,17,17,0,86
2/29/2020,LAL,25,21,20,22,0,88,MEM,29,29,28,19,0,105
3/1/2020,LAL,29,34,30,29,0,122,NOP,33,28,34,19,0,114
10/23/2019,OKC,12,34,28,21,0,95,UTA,23,26,19,32,0,100
10/25/2019,UTA,17,20,18,31,0,86,LAL,24,19,31,21,0,95
10/26/2019,SAC,25,16,17,23,0,81,UTA,35,31,27,20,0,113
10/28/2019,UTA,28,18,24,26,0,96,PHO,21,18,31,25,0,95
10/30/2019,LAC,23,28,20,25,0,96,UTA,33,19,38,20,0,110
11/1/2019,UTA,18,30,32,21,0,101,SAC,28,23,30,21,0,102
11/3/2019,UTA,20,21,28,25,0,94,LAC,16,23,26,40,0,105
11/6/2019,PHI,29,27,17,31,0,104,UTA,26,32,26,22,0,106
11/8/2019,MIL,16,19,39,26,0,100,UTA,30,25,26,22,0,103
11/11/2019,UTA,34,35,28,25,0,122,GSW,30,24,31,23,0,108
11/12/2019,BRK,35,33,24,22,0,114,UTA,29,24,31,35,0,119
11/15/2019,UTA,26,22,31,27,0,106,MEM,23,30,24,30,0,107
11/18/2019,MIN,36,23,17,36,0,112,UTA,32,24,22,24,0,102
11/20/2019,UTA,26,22,25,30,0,103,MIN,19,27,22,27,0,95
11/22/2019,GSW,28,23,21,37,0,109,UTA,30,35,25,23,0,113
11/23/2019,NOP,31,23,34,32,0,120,UTA,44,30,24,30,0,128
11/25/2019,UTA,25,32,26,35,0,118,MIL,23,25,42,32,0,122
11/27/2019,UTA,20,23,37,22,0,102,IND,21,32,36,32,0,121
11/29/2019,UTA,22,18,35,28,0,103,MEM,24,31,18,21,0,94
12/1/2019,UTA,20,17,49,24,0,110,TOR,37,40,30,23,0,130
12/2/2019,UTA,23,19,24,28,0,94,PHI,31,29,25,18,0,103
12/4/2019,LAL,34,31,29,27,0,121,UTA,26,21,28,21,0,96
12/7/2019,MEM,36,18,30,28,0,112,UTA,32,37,28,29,0,126
12/9/2019,OKC,25,26,34,19,0,104,UTA,24,23,21,22,0,90
12/11/2019,UTA,25,34,38,30,0,127,MIN,23,36,24,33,0,116
12/13/2019,GSW,29,27,28,22,0,106,UTA,22,27,37,28,0,114
12/17/2019,ORL,20,27,24,31,0,102,UTA,26,32,24,27,0,109
12/19/2019,UTA,28,24,31,28,0,111,ATL,30,26,28,22,0,106
12/21/2019,UTA,31,25,28,30,0,114,CHO,33,31,22,21,0,107
12/23/2019,UTA,28,24,29,23,0,104,MIA,32,21,23,31,0,107
12/26/2019,POR,22,30,24,39,0,115,UTA,37,25,34,25,0,121
12/28/2019,UTA,22,39,32,27,0,120,LAC,32,31,29,15,0,107
12/30/2019,DET,21,19,18,23,0,81,UTA,19,20,29,36,0,104
1/2/2020,UTA,25,22,29,26,0,102,CHI,22,29,19,28,0,98
1/4/2020,UTA,33,19,24,33,0,109,ORL,25,22,28,21,0,96
1/6/2020,UTA,35,33,27,33,0,128,NOP,36,28,33,29,0,126
1/8/2020,NYK,29,24,16,35,0,104,UTA,39,33,23,33,0,128
1/10/2020,CHO,13,25,24,30,0,92,UTA,29,32,26,22,0,109
1/12/2020,UTA,23,32,38,34,0,127,WAS,34,32,25,25,0,116
1/14/2020,UTA,30,29,29,30,0,118,BRK,26,19,29,33,0,107
1/16/2020,UTA,28,21,42,31,10,132,NOP,25,31,31,35,16,138
1/18/2020,SAC,22,27,28,24,0,101,UTA,38,25,32,28,0,123
1/20/2020,IND,23,21,19,25,0,88,UTA,29,27,24,38,0,118
1/22/2020,UTA,31,34,35,29,0,129,GSW,17,26,26,27,0,96
1/25/2020,DAL,36,22,26,23,0,107,UTA,25,30,25,32,0,112
1/27/2020,HOU,28,31,28,39,0,126,UTA,20,26,29,42,0,117
1/29/2020,UTA,29,33,32,26,0,120,SAS,37,33,28,29,0,127
1/30/2020,UTA,23,25,22,30,0,100,DEN,21,22,33,30,0,106
2/1/2020,UTA,34,19,30,24,0,107,POR,33,30,31,30,0,124
2/5/2020,DEN,25,24,23,26,0,98,UTA,32,25,18,20,0,95
2/7/2020,POR,38,34,17,25,0,114,UTA,32,26,30,29,0,117
2/9/2020,UTA,25,29,27,33,0,114,HOU,33,25,25,30,0,113
2/10/2020,UTA,32,39,29,23,0,123,DAL,24,26,34,35,0,119
2/12/2020,MIA,28,24,22,27,0,101,UTA,25,22,32,37,0,116
2/21/2020,SAS,27,38,28,20,0,113,UTA,21,25,29,29,0,104
2/22/2020,HOU,38,24,38,20,0,120,UTA,36,30,19,25,0,110
2/24/2020,PHO,27,35,37,32,0,131,UTA,35,27,26,23,0,111
2/26/2020,BOS,23,30,32,29,0,114,UTA,15,36,31,21,0,103
2/28/2020,WAS,28,32,21,38,0,119,UTA,31,27,32,39,0,129
10/23/2019,SAC,29,30,17,19,0,95,PHO,25,29,32,38,0,124
10/25/2019,POR,25,32,37,28,0,122,SAC,27,30,27,28,0,112
10/26/2019,SAC,25,16,17,23,0,81,UTA,35,31,27,20,0,113
10/28/2019,DEN,21,26,30,24,0,101,SAC,28,25,17,24,0,94
10/30/2019,CHO,30,31,32,25,0,118,SAC,33,33,18,27,0,111
11/1/2019,UTA,18,30,32,21,0,101,SAC,28,23,30,21,0,102
11/3/2019,SAC,32,29,29,23,0,113,NYK,23,18,23,28,0,92
11/6/2019,SAC,23,35,30,32,0,120,TOR,36,30,29,29,0,124
11/8/2019,SAC,31,32,28,30,0,121,ATL,24,23,36,26,0,109
11/12/2019,POR,24,25,21,29,0,99,SAC,21,25,35,26,0,107
11/15/2019,SAC,30,20,21,26,0,97,LAL,20,29,25,25,0,99
11/17/2019,BOS,18,28,29,24,0,99,SAC,30,20,21,29,0,100
11/19/2019,PHO,19,26,30,41,0,116,SAC,33,29,25,33,0,120
11/22/2019,SAC,23,26,21,27,0,97,BRK,26,30,30,30,0,116
11/24/2019,SAC,24,33,33,23,0,113,WAS,27,30,28,21,0,106
11/25/2019,SAC,22,24,29,27,0,102,BOS,19,34,22,28,0,103
11/27/2019,SAC,18,28,19,26,0,91,PHI,25,22,29,21,0,97
11/30/2019,DEN,27,30,18,15,7,97,SAC,17,23,27,23,10,100
12/2/2019,CHI,22,33,29,29,0,113,SAC,23,21,30,32,0,106
12/4/2019,SAC,35,29,31,21,0,116,POR,30,36,34,27,0,127
12/6/2019,SAC,17,25,30,28,4,104,SAS,21,31,17,31,5,105
12/8/2019,SAC,36,30,26,18,0,110,DAL,27,19,32,28,0,106
12/9/2019,SAC,32,27,35,25,0,119,HOU,28,36,29,25,0,118
12/11/2019,OKC,18,29,24,22,0,93,SAC,23,15,31,25,0,94
12/13/2019,NYK,20,25,27,31,0,103,SAC,32,22,26,21,0,101
12/15/2019,SAC,26,25,28,21,0,100,GSW,18,24,17,20,0,79
12/17/2019,SAC,21,26,32,23,0,102,CHO,26,27,27,30,0,110
12/20/2019,SAC,32,25,22,26,0,105,IND,30,38,24,27,0,119
12/21/2019,SAC,21,29,28,37,0,115,MEM,23,37,31,28,0,119
12/23/2019,HOU,37,28,32,16,0,113,SAC,21,36,22,25,0,104
12/26/2019,MIN,21,29,21,19,7,105,SAC,26,22,31,11,7,104
12/28/2019,PHO,31,28,22,31,0,112,SAC,30,19,28,33,0,110
12/29/2019,SAC,32,25,24,34,0,115,DEN,31,31,26,32,0,120
12/31/2019,LAC,28,29,31,17,0,105,SAC,23,17,33,14,0,87
1/2/2020,MEM,42,18,37,26,0,123,SAC,26,37,27,38,0,128
1/4/2020,NOP,25,27,24,41,0,117,SAC,26,22,32,35,0,115
1/6/2020,GSW,19,21,24,34,0,98,SAC,26,26,38,21,0,111
1/7/2020,SAC,26,27,25,36,0,114,PHO,29,24,34,16,0,103
1/10/2020,MIL,34,19,37,37,0,127,SAC,18,26,31,31,0,106
1/13/2020,ORL,33,32,21,28,0,114,SAC,25,27,33,27,0,112
1/15/2020,DAL,35,36,37,19,0,127,SAC,31,36,26,30,0,123
1/18/2020,SAC,22,27,28,24,0,101,UTA,38,25,32,28,0,123
1/20/2020,SAC,24,34,20,27,8,113,MIA,21,35,20,29,13,118
1/22/2020,SAC,27,23,25,31,0,106,DET,26,31,36,34,0,127
1/24/2020,SAC,29,25,21,23,0,98,CHI,21,23,25,12,0,81
1/27/2020,SAC,24,26,28,41,14,133,MIN,37,31,29,22,10,129
1/29/2020,OKC,23,36,37,24,0,120,SAC,16,31,29,24,0,100
1/30/2020,SAC,28,36,21,39,0,124,LAC,33,14,24,32,0,103
2/1/2020,LAL,44,37,23,25,0,129,SAC,22,42,25,24,0,113
2/3/2020,MIN,20,30,34,25,0,109,SAC,29,36,28,20,0,113
2/7/2020,MIA,28,22,26,21,0,97,SAC,30,22,31,22,0,105
2/8/2020,SAS,23,26,29,24,0,102,SAC,24,28,37,33,0,122
2/10/2020,SAC,24,34,32,21,0,111,MIL,38,19,31,35,0,123
2/12/2020,SAC,28,24,25,34,0,111,DAL,32,31,33,34,0,130
2/20/2020,MEM,35,26,29,35,0,125,SAC,37,33,27,32,0,129
2/22/2020,SAC,25,29,34,24,0,112,LAC,13,35,35,20,0,103
2/25/2020,SAC,33,22,26,31,0,112,GSW,22,21,30,21,0,94
2/27/2020,SAC,27,34,21,26,0,108,OKC,25,25,31,31,0,112
2/28/2020,SAC,21,29,31,23,0,104,MEM,30,17,28,26,0,101
3/1/2020,DET,31,20,19,30,0,100,SAC,16,34,26,30,0,106
10/23/2019,NYK,15,36,33,27,0,111,SAS,22,37,24,37,0,120
10/25/2019,NYK,23,28,32,26,0,109,BRK,32,32,30,19,0,113
10/26/2019,BOS,22,24,36,36,0,118,NYK,24,27,25,19,0,95
10/28/2019,CHI,33,19,28,18,0,98,NYK,15,27,30,33,0,105
10/30/2019,NYK,25,19,23,16,0,83,ORL,22,20,30,23,0,95
11/1/2019,NYK,23,27,24,28,0,102,BOS,22,27,26,29,0,104
11/3/2019,SAC,32,29,29,23,0,113,NYK,23,18,23,28,0,92
11/6/2019,NYK,25,34,26,17,0,102,DET,33,31,32,26,0,122
11/8/2019,NYK,36,25,23,22,0,106,DAL,28,29,23,22,0,102
11/10/2019,CLE,31,23,24,30,0,108,NYK,19,17,27,24,0,87
11/12/2019,NYK,22,32,31,17,0,102,CHI,30,30,25,35,0,120
11/14/2019,DAL,23,30,34,16,0,103,NYK,27,31,29,19,0,106
11/16/2019,CHO,20,27,28,28,0,103,NYK,23,32,21,26,0,102
11/18/2019,CLE,20,31,20,34,0,105,NYK,32,32,30,29,0,123
11/20/2019,NYK,25,26,28,25,0,104,PHI,27,26,21,35,0,109
11/23/2019,SAS,32,36,21,22,0,111,NYK,16,27,28,33,0,104
11/24/2019,BRK,29,23,30,21,0,103,NYK,22,24,26,29,0,101
11/27/2019,NYK,29,17,23,29,0,98,TOR,21,37,31,37,0,126
11/29/2019,PHI,18,21,31,31,0,101,NYK,31,20,17,27,0,95
12/1/2019,BOS,31,27,23,32,0,113,NYK,30,28,27,19,0,104
12/2/2019,NYK,15,30,17,26,0,88,MIL,33,39,28,32,0,132
12/5/2019,DEN,33,34,31,31,0,129,NYK,27,18,30,17,0,92
12/7/2019,IND,32,34,23,15,0,104,NYK,27,33,21,22,0,103
12/10/2019,NYK,22,19,18,28,0,87,POR,32,28,26,29,0,115
12/11/2019,NYK,30,38,19,25,12,124,GSW,20,30,30,32,10,122
12/13/2019,NYK,20,25,27,31,0,103,SAC,32,22,26,21,0,101
12/15/2019,NYK,22,29,33,21,0,105,DEN,33,34,20,24,0,111
12/17/2019,ATL,27,26,31,36,0,120,NYK,41,36,32,34,0,143
12/20/2019,NYK,20,27,27,40,0,114,MIA,39,31,28,31,0,129
12/21/2019,MIL,37,31,27,28,0,123,NYK,23,31,16,32,0,102
12/23/2019,WAS,32,31,31,27,0,121,NYK,37,27,27,24,0,115
12/26/2019,NYK,24,22,33,15,0,94,BRK,15,26,20,21,0,82
12/28/2019,NYK,33,26,27,21,0,107,WAS,23,35,20,22,0,100
1/1/2020,POR,27,21,29,16,0,93,NYK,25,26,32,34,0,117
1/3/2020,NYK,37,24,26,25,0,112,PHO,29,22,32,37,0,120
1/5/2020,NYK,45,24,31,32,0,132,LAC,29,47,38,21,0,135
1/7/2020,NYK,21,24,25,17,0,87,LAL,26,36,23,32,0,117
1/8/2020,NYK,29,24,16,35,0,104,UTA,39,33,23,33,0,128
1/10/2020,NOP,33,34,28,28,0,123,NYK,31,30,25,25,0,111
1/12/2020,MIA,31,29,34,27,0,121,NYK,27,28,29,40,0,124
1/14/2020,NYK,23,17,36,26,0,102,MIL,29,36,43,20,0,128
1/16/2020,PHO,25,33,32,31,0,121,NYK,32,20,27,19,0,98
1/18/2020,PHI,28,24,18,20,0,90,NYK,25,21,23,18,0,87
1/20/2020,NYK,26,23,30,27,0,106,CLE,26,24,14,22,0,86
1/22/2020,LAL,28,20,28,24,0,100,NYK,25,23,22,22,0,92
1/24/2020,TOR,20,36,29,33,0,118,NYK,28,25,26,33,0,112
1/26/2020,BRK,28,24,24,21,0,97,NYK,30,25,30,25,0,110
1/28/2020,NYK,26,24,16,26,0,92,CHO,15,32,21,29,0,97
1/29/2020,MEM,32,27,37,31,0,127,NYK,32,20,32,22,0,106
2/1/2020,NYK,24,26,22,20,0,92,IND,11,28,32,14,0,85
2/3/2020,NYK,33,30,32,32,12,139,CLE,37,25,38,27,7,134
2/6/2020,ORL,19,28,36,20,0,103,NYK,30,24,22,29,0,105
2/8/2020,NYK,17,31,19,28,0,95,DET,28,22,17,25,0,92
2/9/2020,NYK,31,32,20,33,10,135,ATL,20,41,33,22,10,140
2/12/2020,WAS,25,21,31,37,0,114,NYK,24,26,23,23,0,96
2/21/2020,IND,15,36,29,26,0,106,NYK,20,24,21,33,0,98
2/24/2020,NYK,33,24,29,26,0,112,HOU,36,36,29,22,0,123
2/26/2020,NYK,27,19,29,26,0,101,CHO,30,26,29,22,0,107
2/27/2020,NYK,21,25,33,27,0,106,PHI,26,35,26,28,0,115
2/29/2020,CHI,25,28,33,29,0,115,NYK,31,35,23,36,0,125
10/22/2019,NOP,30,31,25,31,5,122,TOR,27,29,32,29,13,130
10/25/2019,DAL,27,45,23,28,0,123,NOP,41,23,29,23,0,116
10/26/2019,NOP,24,37,39,23,0,123,HOU,29,32,36,29,0,126
10/28/2019,GSW,27,45,31,31,0,134,NOP,23,32,24,44,0,123
10/31/2019,DEN,30,22,23,32,0,107,NOP,32,24,30,36,0,122
11/2/2019,NOP,26,34,26,18,0,104,OKC,33,32,29,21,0,115
11/4/2019,NOP,27,23,48,27,0,125,BRK,33,34,37,31,0,135
11/8/2019,TOR,30,45,22,25,0,122,NOP,30,23,22,29,0,104
11/9/2019,NOP,33,22,26,34,0,115,CHO,28,33,25,24,0,110
11/11/2019,HOU,30,28,32,32,0,122,NOP,23,29,30,34,0,116
11/14/2019,LAC,35,24,38,30,0,127,NOP,34,38,24,36,0,132
11/16/2019,NOP,22,27,16,29,0,94,MIA,29,25,24,31,0,109
11/17/2019,GSW,23,26,20,31,0,100,NOP,26,29,21,32,0,108
11/19/2019,POR,28,26,25,25,0,104,NOP,27,26,35,27,0,115
11/21/2019,NOP,38,21,36,29,0,124,PHO,33,33,28,27,0,121
11/23/2019,NOP,31,23,34,32,0,120,UTA,44,30,24,30,0,128
11/24/2019,NOP,27,29,31,22,0,109,LAC,40,32,28,34,0,134
11/27/2019,LAL,25,29,25,35,0,114,NOP,38,26,25,21,0,110
11/29/2019,NOP,26,27,31,20,0,104,OKC,34,28,17,30,0,109
12/1/2019,OKC,33,23,26,25,0,107,NOP,29,26,22,27,0,104
12/3/2019,DAL,24,35,25,34,0,118,NOP,24,29,22,22,0,97
12/5/2019,PHO,38,36,33,18,14,139,NOP,40,30,21,34,7,132
12/7/2019,NOP,28,24,14,18,0,84,DAL,31,33,40,26,0,130
12/9/2019,DET,25,22,34,24,0,105,NOP,29,24,21,29,0,103
12/11/2019,NOP,20,26,40,26,0,112,MIL,35,34,36,22,0,127
12/13/2019,NOP,25,32,25,27,0,109,PHI,39,23,30,24,0,116
12/15/2019,ORL,24,34,41,31,0,130,NOP,30,27,27,35,0,119
12/17/2019,BRK,21,21,19,32,15,108,NOP,21,14,29,29,8,101
12/18/2019,NOP,32,31,24,20,0,107,MIN,25,25,22,27,0,99
12/20/2019,NOP,16,28,37,21,0,102,GSW,31,25,22,28,0,106
12/23/2019,NOP,31,23,28,20,0,102,POR,31,25,21,17,0,94
12/25/2019,NOP,29,29,26,28,0,112,DEN,26,29,25,20,0,100
12/28/2019,IND,32,13,23,30,0,98,NOP,19,29,38,34,0,120
12/29/2019,HOU,37,27,29,19,0,112,NOP,36,28,22,41,0,127
1/3/2020,NOP,30,32,21,30,0,113,LAL,42,32,31,18,0,123
1/4/2020,NOP,25,27,24,41,0,117,SAC,26,22,32,35,0,115
1/6/2020,UTA,35,33,27,33,0,128,NOP,36,28,33,29,0,126
1/8/2020,CHI,21,27,27,33,0,108,NOP,23,25,44,31,0,123
1/10/2020,NOP,33,34,28,28,0,123,NYK,31,30,25,25,0,111
1/11/2020,NOP,24,33,25,23,0,105,BOS,41,31,42,26,0,140
1/13/2020,NOP,32,31,26,13,15,117,DET,23,29,25,25,8,110
1/16/2020,UTA,28,21,42,31,10,132,NOP,25,31,31,35,16,138
1/18/2020,LAC,33,39,30,31,0,133,NOP,35,45,30,20,0,130
1/20/2020,NOP,31,38,29,28,0,126,MEM,30,20,27,39,0,116
1/22/2020,SAS,31,29,34,27,0,121,NOP,24,27,31,35,0,117
1/24/2020,DEN,37,26,31,19,0,113,NOP,28,28,26,24,0,106
1/26/2020,BOS,20,22,39,27,0,108,NOP,32,30,29,32,0,123
1/28/2020,NOP,40,34,30,21,0,125,CLE,34,31,25,21,0,111
1/31/2020,MEM,22,37,27,25,0,111,NOP,31,35,44,29,0,139
2/2/2020,NOP,28,32,33,16,0,109,HOU,30,35,27,25,0,117
2/4/2020,MIL,26,32,42,20,0,120,NOP,33,28,24,23,0,108
2/6/2020,NOP,32,40,31,22,0,125,CHI,25,37,19,38,0,119
2/8/2020,NOP,31,29,28,36,0,124,IND,26,29,30,32,0,117
2/11/2020,POR,36,29,21,31,0,117,NOP,27,36,41,34,0,138
2/13/2020,OKC,29,37,32,25,0,123,NOP,30,28,35,25,0,118
2/21/2020,NOP,40,33,29,26,0,128,POR,35,28,20,32,0,115
2/23/2020,NOP,29,17,31,38,0,115,GSW,33,23,21,24,0,101
2/25/2020,NOP,26,32,28,23,0,109,LAL,30,34,24,30,0,118
2/28/2020,CLE,25,30,28,21,0,104,NOP,43,27,25,21,0,116
3/1/2020,LAL,29,34,30,29,0,122,NOP,33,28,34,19,0,114
10/23/2019,DET,27,27,29,36,0,119,IND,24,31,31,24,0,110
10/24/2019,ATL,38,22,31,26,0,117,DET,32,31,18,19,0,100
10/26/2019,PHI,28,26,29,34,0,117,DET,29,28,26,28,0,111
10/28/2019,IND,25,28,18,23,0,94,DET,33,26,19,18,0,96
10/30/2019,DET,28,30,27,28,0,113,TOR,37,27,37,24,0,125
11/1/2019,DET,23,29,28,26,0,106,CHI,30,27,29,26,0,112
11/2/2019,BRK,26,28,18,37,0,109,DET,33,13,32,35,0,113
11/4/2019,DET,30,31,17,21,0,99,WAS,31,32,30,22,0,115
11/6/2019,NYK,25,34,26,17,0,102,DET,33,31,32,26,0,122
11/8/2019,DET,35,18,19,34,0,106,IND,27,30,28,27,0,112
11/11/2019,MIN,41,25,26,28,0,120,DET,26,25,30,33,0,114
11/12/2019,DET,17,20,35,36,0,108,MIA,28,31,33,25,0,117
11/15/2019,DET,35,30,18,23,0,106,CHO,25,26,32,26,0,109
11/20/2019,DET,30,25,16,18,0,89,CHI,30,29,25,25,0,109
11/22/2019,ATL,23,34,27,19,0,103,DET,33,43,31,21,0,128
11/23/2019,DET,24,23,22,21,0,90,MIL,27,27,23,27,0,104
11/25/2019,ORL,31,24,15,18,0,88,DET,23,30,25,25,0,103
11/27/2019,DET,32,28,20,21,0,101,CHO,31,24,31,16,0,102
11/29/2019,CHO,38,24,23,25,0,110,DET,37,20,28,22,0,107
12/1/2019,SAS,27,24,20,27,0,98,DET,32,27,37,36,0,132
12/3/2019,DET,32,30,35,30,0,127,CLE,28,18,22,26,0,94
12/4/2019,MIL,22,37,33,35,0,127,DET,24,24,24,31,0,103
12/6/2019,IND,19,25,31,26,0,101,DET,32,23,16,37,0,108
12/9/2019,DET,25,22,34,24,0,105,NOP,29,24,21,29,0,103
12/12/2019,DAL,34,31,30,27,0,122,DET,29,29,27,26,0,111
12/14/2019,DET,30,32,26,27,0,115,HOU,32,20,23,32,0,107
12/16/2019,WAS,43,24,29,37,0,133,DET,31,30,30,28,0,119
12/18/2019,TOR,30,40,26,16,0,112,DET,29,35,15,20,0,99
12/20/2019,DET,26,22,21,24,0,93,BOS,28,32,31,23,0,114
12/21/2019,CHI,25,28,40,26,0,119,DET,28,31,30,18,0,107
12/23/2019,PHI,30,30,34,31,0,125,DET,23,29,34,23,0,109
12/26/2019,WAS,23,25,28,26,0,102,DET,31,37,38,26,0,132
12/28/2019,DET,28,27,25,29,0,109,SAS,30,29,42,35,0,136
12/30/2019,DET,21,19,18,23,0,81,UTA,19,20,29,36,0,104
1/2/2020,DET,33,30,16,33,0,112,LAC,30,39,37,20,0,126
1/4/2020,DET,25,31,27,28,0,111,GSW,23,36,21,24,0,104
1/5/2020,DET,22,25,32,20,0,99,LAL,23,33,19,31,0,106
1/7/2020,DET,27,27,30,31,0,115,CLE,29,38,28,18,0,113
1/9/2020,CLE,26,24,31,21,13,115,DET,32,29,22,19,10,112
1/11/2020,CHI,35,26,20,27,0,108,DET,20,29,22,28,0,99
1/13/2020,NOP,32,31,26,13,15,117,DET,23,29,25,25,8,110
1/15/2020,DET,27,30,34,25,0,116,BOS,24,35,23,21,0,103
1/18/2020,DET,36,35,32,33,0,136,ATL,29,26,21,27,0,103
1/20/2020,DET,35,23,23,19,0,100,WAS,30,30,23,23,0,106
1/22/2020,SAC,27,23,25,31,0,106,DET,26,31,36,34,0,127
1/24/2020,MEM,35,31,26,33,0,125,DET,23,38,24,27,0,112
1/25/2020,BRK,26,24,30,26,15,121,DET,25,35,17,29,5,111
1/27/2020,CLE,24,29,36,26,0,115,DET,23,22,27,28,0,100
1/29/2020,DET,30,38,25,22,0,115,BRK,32,38,29,26,0,125
1/31/2020,TOR,30,30,18,27,0,105,DET,20,27,22,23,0,92
2/2/2020,DEN,44,21,24,22,12,123,DET,30,38,22,21,17,128
2/3/2020,DET,32,21,10,19,0,82,MEM,36,17,19,24,0,96
2/5/2020,PHO,31,30,25,22,0,108,DET,38,26,25,27,0,116
2/7/2020,DET,24,23,21,33,0,101,OKC,29,23,26,30,0,108
2/8/2020,NYK,17,31,19,28,0,95,DET,28,22,17,25,0,92
2/10/2020,CHO,21,26,19,21,0,87,DET,11,26,22,17,0,76
2/12/2020,DET,20,35,26,27,4,112,ORL,32,27,28,21,8,116
2/20/2020,MIL,32,38,28,28,0,126,DET,18,23,30,35,0,106
2/23/2020,DET,24,27,34,19,0,104,POR,40,13,27,27,0,107
2/25/2020,DET,23,23,26,26,0,98,DEN,29,30,23,33,0,115
2/28/2020,DET,29,23,32,29,0,113,PHO,24,29,26,32,0,111
3/1/2020,DET,31,20,19,30,0,100,SAC,16,34,26,30,0,106
10/24/2019,ATL,38,22,31,26,0,117,DET,32,31,18,19,0,100
10/26/2019,ORL,26,24,25,24,0,99,ATL,23,29,25,26,0,103
10/28/2019,PHI,31,32,19,23,0,105,ATL,40,25,18,20,0,103
10/29/2019,ATL,26,23,21,27,0,97,MIA,29,30,29,24,0,112
10/31/2019,MIA,30,22,33,21,0,106,ATL,26,20,29,22,0,97
11/5/2019,SAS,21,24,33,22,0,100,ATL,22,22,26,38,0,108
11/6/2019,CHI,33,23,35,22,0,113,ATL,19,22,24,28,0,93
11/8/2019,SAC,31,32,28,30,0,121,ATL,24,23,36,26,0,109
11/10/2019,ATL,21,23,31,32,6,113,POR,20,26,29,32,17,124
11/12/2019,ATL,25,38,35,27,0,125,DEN,34,20,35,32,0,121
11/14/2019,ATL,33,28,29,22,0,112,PHO,31,36,37,24,0,128
11/16/2019,ATL,30,32,20,19,0,101,LAC,43,31,38,38,0,150
11/17/2019,ATL,24,17,36,24,0,101,LAL,36,33,27,26,0,122
11/20/2019,MIL,34,24,38,39,0,135,ATL,26,35,22,44,0,127
11/22/2019,ATL,23,34,27,19,0,103,DET,33,43,31,21,0,128
11/23/2019,TOR,26,26,35,32,0,119,ATL,27,34,29,26,0,116
11/25/2019,MIN,38,16,39,32,0,125,ATL,30,34,26,23,0,113
11/27/2019,ATL,17,42,23,20,0,102,MIL,33,27,21,30,0,111
11/29/2019,ATL,23,31,11,29,10,104,IND,22,21,29,22,11,105
11/30/2019,ATL,21,31,21,38,0,111,HOU,38,43,46,31,0,158
12/2/2019,GSW,23,17,13,26,0,79,ATL,20,29,27,28,0,104
12/4/2019,BRK,22,34,35,39,0,130,ATL,26,21,35,36,0,118
12/8/2019,ATL,24,27,37,34,0,122,CHO,27,26,30,24,0,107
12/10/2019,ATL,30,34,32,21,4,121,MIA,36,30,27,24,18,135
12/11/2019,ATL,33,19,35,15,0,102,CHI,37,29,40,30,0,136
12/13/2019,IND,29,34,23,24,0,110,ATL,22,26,35,17,0,100
12/15/2019,LAL,24,31,27,19,0,101,ATL,25,23,30,18,0,96
12/17/2019,ATL,27,26,31,36,0,120,NYK,41,36,32,34,0,143
12/19/2019,UTA,28,24,31,28,0,111,ATL,30,26,28,22,0,106
12/21/2019,ATL,34,39,25,14,0,112,BRK,34,26,25,37,0,122
12/23/2019,ATL,32,32,30,24,0,118,CLE,42,29,23,27,0,121
12/27/2019,MIL,32,31,21,28,0,112,ATL,19,21,23,23,0,86
12/28/2019,ATL,19,24,22,16,0,81,CHI,35,29,19,33,0,116
12/30/2019,ATL,25,22,27,27,0,101,ORL,21,36,15,21,0,93
1/3/2020,ATL,32,23,25,26,0,106,BOS,19,34,29,27,0,109
1/4/2020,IND,26,34,35,16,0,111,ATL,43,21,32,20,0,116
1/6/2020,DEN,29,35,27,32,0,123,ATL,31,25,30,29,0,115
1/8/2020,HOU,45,32,22,23,0,122,ATL,29,33,23,30,0,115
1/10/2020,ATL,21,30,28,22,0,101,WAS,30,26,25,30,0,111
1/12/2020,ATL,16,30,20,20,0,86,BRK,37,33,22,16,0,108
1/14/2020,PHO,25,26,32,27,0,110,ATL,28,28,28,39,0,123
1/17/2020,ATL,29,38,21,33,0,121,SAS,27,31,41,21,0,120
1/18/2020,DET,36,35,32,33,0,136,ATL,29,26,21,27,0,103
1/20/2020,TOR,36,21,26,39,0,122,ATL,25,35,22,35,0,117
1/22/2020,LAC,32,28,15,20,0,95,ATL,16,25,28,33,0,102
1/24/2020,ATL,30,28,32,21,0,111,OKC,33,33,38,36,0,140
1/26/2020,WAS,33,39,30,31,0,133,ATL,31,47,41,33,0,152
1/28/2020,ATL,23,33,27,31,0,114,TOR,33,35,29,33,0,130
1/30/2020,PHI,31,36,25,25,0,117,ATL,39,35,25,28,0,127
2/1/2020,ATL,26,23,23,28,0,100,DAL,36,26,35,26,0,123
2/3/2020,BOS,28,32,35,28,0,123,ATL,34,28,22,31,0,115
2/5/2020,ATL,36,28,32,31,0,127,MIN,24,32,21,43,0,120
2/7/2020,ATL,26,29,18,34,0,107,BOS,28,26,33,25,0,112
2/9/2020,NYK,31,32,20,33,10,135,ATL,20,41,33,22,10,140
2/10/2020,ATL,28,33,35,30,0,126,ORL,22,34,37,42,0,135
2/12/2020,ATL,19,29,32,25,0,105,CLE,33,32,33,29,0,127
2/20/2020,MIA,36,28,33,27,0,124,ATL,32,31,27,39,0,129
2/22/2020,DAL,35,31,20,21,0,107,ATL,21,37,19,34,0,111
2/24/2020,ATL,24,28,40,20,0,112,PHI,41,28,22,38,0,129
2/26/2020,ORL,23,41,39,27,0,130,ATL,27,37,31,25,0,120
2/28/2020,BRK,36,26,36,20,0,118,ATL,29,39,40,33,0,141
2/29/2020,POR,28,28,34,27,0,117,ATL,23,40,44,22,0,129
10/23/2019,CHI,28,27,40,30,0,125,CHO,37,26,33,30,0,126
10/25/2019,CHI,25,22,32,31,0,110,MEM,29,31,21,21,0,102
10/26/2019,TOR,24,24,36,24,0,108,CHI,23,17,22,22,0,84
10/28/2019,CHI,33,19,28,18,0,98,NYK,15,27,30,33,0,105
10/30/2019,CHI,26,27,29,29,0,111,CLE,25,25,30,37,0,117
11/1/2019,DET,23,29,28,26,0,106,CHI,30,27,29,26,0,112
11/3/2019,CHI,18,24,32,21,0,95,IND,24,31,31,22,0,108
11/5/2019,LAL,24,24,32,38,0,118,CHI,29,36,28,19,0,112
11/6/2019,CHI,33,23,35,22,0,113,ATL,19,22,24,28,0,93
11/9/2019,HOU,20,30,36,31,0,117,CHI,27,22,18,27,0,94
11/12/2019,NYK,22,32,31,17,0,102,CHI,30,30,25,35,0,120
11/14/2019,CHI,32,34,20,29,0,115,MIL,30,35,32,27,0,124
11/16/2019,BRK,30,20,24,43,0,117,CHI,19,37,22,33,0,111
11/18/2019,MIL,29,31,24,31,0,115,CHI,26,30,25,20,0,101
11/20/2019,DET,30,25,16,18,0,89,CHI,30,29,25,25,0,109
11/22/2019,MIA,34,33,18,31,0,116,CHI,16,27,24,41,0,108
11/23/2019,CHI,34,22,13,47,0,116,CHO,23,26,25,41,0,115
11/25/2019,POR,27,35,30,25,0,117,CHI,28,26,18,22,0,94
11/27/2019,CHI,17,31,25,17,0,90,GSW,25,28,25,26,0,104
11/29/2019,CHI,28,19,31,25,0,103,POR,25,28,28,26,0,107
12/2/2019,CHI,22,33,29,29,0,113,SAC,23,21,30,32,0,106
12/4/2019,MEM,20,15,29,35,0,99,CHI,27,23,28,28,0,106
12/6/2019,GSW,23,27,27,23,0,100,CHI,28,23,32,15,0,98
12/8/2019,CHI,25,24,24,24,8,105,MIA,16,31,27,23,13,110
12/9/2019,TOR,30,19,22,22,0,93,CHI,30,21,20,21,0,92
12/11/2019,ATL,33,19,35,15,0,102,CHI,37,29,40,30,0,136
12/13/2019,CHO,24,20,15,24,0,83,CHI,15,25,10,23,0,73
12/14/2019,LAC,29,28,22,27,0,106,CHI,24,31,29,25,0,109
12/16/2019,CHI,37,31,22,16,0,106,OKC,16,33,33,27,0,109
12/18/2019,CHI,23,29,21,25,12,110,WAS,27,31,27,13,11,109
12/21/2019,CHI,25,28,40,26,0,119,DET,28,31,30,18,0,107
12/23/2019,CHI,28,26,27,14,0,95,ORL,28,23,32,20,0,103
12/28/2019,ATL,19,24,22,16,0,81,CHI,35,29,19,33,0,116
12/30/2019,MIL,31,24,40,28,0,123,CHI,20,32,25,25,0,102
1/2/2020,UTA,25,22,29,26,0,102,CHI,22,29,19,28,0,98
1/4/2020,BOS,30,25,30,26,0,111,CHI,28,24,21,31,0,104
1/6/2020,CHI,27,28,27,28,0,110,DAL,33,28,27,30,0,118
1/8/2020,CHI,21,27,27,33,0,108,NOP,23,25,44,31,0,123
1/10/2020,IND,29,25,25,37,0,116,CHI,27,19,26,33,0,105
1/11/2020,CHI,35,26,20,27,0,108,DET,20,29,22,28,0,99
1/13/2020,CHI,14,23,34,30,0,101,BOS,28,27,28,30,0,113
1/15/2020,WAS,26,34,20,26,0,106,CHI,24,31,30,30,0,115
1/17/2020,CHI,24,23,24,18,0,89,PHI,21,25,35,19,0,100
1/18/2020,CLE,33,40,29,14,0,116,CHI,31,25,31,31,0,118
1/20/2020,CHI,23,29,25,21,0,98,MIL,30,23,31,27,0,111
1/22/2020,MIN,26,26,27,31,0,110,CHI,35,24,22,36,0,117
1/24/2020,SAC,29,25,21,23,0,98,CHI,21,23,25,12,0,81
1/25/2020,CHI,25,34,40,19,0,118,CLE,31,26,19,30,0,106
1/27/2020,SAS,28,20,37,24,0,109,CHI,21,29,25,35,0,110
1/29/2020,CHI,24,27,29,20,6,106,IND,25,30,25,20,15,115
1/31/2020,CHI,23,34,39,22,0,118,BRK,35,38,30,30,0,133
2/2/2020,CHI,29,34,22,17,0,102,TOR,32,28,35,34,0,129
2/6/2020,NOP,32,40,31,22,0,125,CHI,25,37,19,38,0,119
2/9/2020,CHI,25,30,28,28,0,111,PHI,38,22,23,35,0,118
2/11/2020,CHI,26,36,20,32,0,114,WAS,36,33,31,26,0,126
2/20/2020,CHO,33,27,19,24,0,103,CHI,20,24,29,20,0,93
2/22/2020,PHO,22,25,36,29,0,112,CHI,24,33,23,24,0,104
2/23/2020,WAS,31,27,27,32,0,117,CHI,35,38,28,25,0,126
2/25/2020,OKC,36,36,19,33,0,124,CHI,28,27,38,29,0,122
2/29/2020,CHI,25,28,33,29,0,115,NYK,31,35,23,36,0,125
10/23/2019,MEM,32,28,24,17,0,101,MIA,24,30,29,37,0,120
10/26/2019,MIA,29,24,29,39,10,131,MIL,33,37,23,28,5,126
10/27/2019,MIA,23,34,27,25,0,109,MIN,36,19,22,39,0,116
10/29/2019,ATL,26,23,21,27,0,97,MIA,29,30,29,24,0,112
10/31/2019,MIA,30,22,33,21,0,106,ATL,26,20,29,22,0,97
11/3/2019,HOU,14,32,25,29,0,100,MIA,46,25,28,30,0,129
11/5/2019,MIA,28,20,21,20,0,89,DEN,29,29,31,20,0,109
11/7/2019,MIA,31,33,29,31,0,124,PHO,30,27,29,22,0,108
11/8/2019,MIA,21,25,20,14,0,80,LAL,28,20,30,17,0,95
11/12/2019,DET,17,20,35,36,0,108,MIA,28,31,33,25,0,117
11/14/2019,MIA,34,34,26,14,0,108,CLE,22,22,30,23,0,97
11/16/2019,NOP,22,27,16,29,0,94,MIA,29,25,24,31,0,109
11/20/2019,CLE,22,26,29,23,0,100,MIA,32,43,24,25,0,124
11/22/2019,MIA,34,33,18,31,0,116,CHI,16,27,24,41,0,108
11/23/2019,MIA,13,22,24,27,0,86,PHI,28,27,37,21,0,113
11/25/2019,CHO,31,27,24,18,0,100,MIA,36,33,29,19,0,117
11/27/2019,MIA,23,19,26,40,0,108,HOU,27,39,25,26,0,117
11/29/2019,GSW,21,37,21,26,0,105,MIA,41,30,24,27,0,122
12/1/2019,MIA,32,26,25,26,0,109,BRK,30,35,16,25,0,106
12/3/2019,MIA,32,26,25,25,13,121,TOR,23,30,28,27,2,110
12/4/2019,MIA,28,16,25,24,0,93,BOS,20,32,30,30,0,112
12/6/2019,WAS,28,37,20,18,0,103,MIA,27,34,25,26,0,112
12/8/2019,CHI,25,24,24,24,8,105,MIA,16,31,27,23,13,110
12/10/2019,ATL,30,34,32,21,4,121,MIA,36,30,27,24,18,135
12/13/2019,LAL,30,21,37,25,0,113,MIA,29,30,26,25,0,110
12/14/2019,MIA,37,36,18,21,10,122,DAL,23,27,31,31,6,118
12/16/2019,MIA,32,26,28,25,0,111,MEM,36,37,22,23,0,118
12/18/2019,MIA,19,37,26,26,0,108,PHI,29,19,26,30,0,104
12/20/2019,NYK,20,27,27,40,0,114,MIA,39,31,28,31,0,129
12/23/2019,UTA,28,24,29,23,0,104,MIA,32,21,23,31,0,107
12/27/2019,IND,27,28,27,30,0,112,MIA,25,33,26,29,0,113
12/28/2019,PHI,33,26,20,29,8,116,MIA,28,26,31,23,9,117
12/30/2019,MIA,39,24,18,24,0,105,WAS,29,42,19,33,0,123
1/2/2020,TOR,20,19,21,16,0,76,MIA,18,24,21,21,0,84
1/3/2020,MIA,22,22,35,6,0,85,ORL,27,29,28,21,0,105
1/5/2020,POR,19,27,35,30,0,111,MIA,31,34,29,28,0,122
1/8/2020,MIA,31,31,38,22,0,122,IND,23,26,23,36,0,108
1/10/2020,MIA,42,27,20,24,0,113,BRK,32,25,32,28,0,117
1/12/2020,MIA,31,29,34,27,0,121,NYK,27,28,29,40,0,124
1/15/2020,SAS,17,34,26,23,0,100,MIA,24,27,24,31,0,106
1/17/2020,MIA,40,21,31,23,0,115,OKC,26,21,31,30,0,108
1/19/2020,MIA,31,23,30,18,0,102,SAS,28,32,26,21,0,107
1/20/2020,SAC,24,34,20,27,8,113,MIA,21,35,20,29,13,118
1/22/2020,WAS,27,23,33,35,11,129,MIA,30,39,21,28,16,134
1/24/2020,LAC,22,41,38,21,0,122,MIA,30,35,20,32,0,117
1/27/2020,ORL,21,27,23,21,0,92,MIA,31,23,31,28,0,113
1/28/2020,BOS,36,17,27,29,0,109,MIA,28,20,28,25,0,101
2/1/2020,MIA,28,29,19,26,0,102,ORL,25,24,18,22,0,89
2/3/2020,PHI,26,26,25,29,0,106,MIA,30,26,41,40,0,137
2/5/2020,MIA,23,35,22,31,0,111,LAC,25,30,37,36,0,128
2/7/2020,MIA,28,22,26,21,0,97,SAC,30,22,31,22,0,105
2/9/2020,MIA,36,24,23,26,0,109,POR,38,25,30,22,0,115
2/10/2020,MIA,24,38,21,30,0,113,GSW,20,23,32,26,0,101
2/12/2020,MIA,28,24,22,27,0,101,UTA,25,22,32,37,0,116
2/20/2020,MIA,36,28,33,27,0,124,ATL,32,31,27,39,0,129
2/22/2020,CLE,32,20,26,27,0,105,MIA,38,44,24,18,0,124
2/24/2020,MIA,29,39,31,12,8,119,CLE,21,35,24,31,14,125
2/26/2020,MIN,29,28,38,34,0,129,MIA,28,32,34,32,0,126
2/28/2020,DAL,31,24,38,25,0,118,MIA,31,32,25,38,0,126
2/29/2020,BRK,27,22,31,33,0,113,MIA,24,33,34,25,0,116
10/23/2019,MEM,32,28,24,17,0,101,MIA,24,30,29,37,0,120
10/25/2019,CHI,25,22,32,31,0,110,MEM,29,31,21,21,0,102
10/27/2019,BRK,29,28,40,23,13,133,MEM,35,24,33,28,14,134
10/29/2019,MEM,32,15,20,24,0,91,LAL,27,22,39,32,0,120
11/2/2019,PHO,31,14,37,32,0,114,MEM,24,23,22,36,0,105
11/4/2019,HOU,33,29,22,23,0,107,MEM,28,32,16,24,0,100
11/6/2019,MIN,26,38,32,25,0,121,MEM,37,35,29,36,0,137
11/8/2019,MEM,15,33,30,8,0,86,ORL,27,24,33,34,0,118
11/9/2019,DAL,31,37,36,34,0,138,MEM,34,28,29,31,0,122
11/11/2019,MEM,35,22,34,22,0,113,SAS,22,32,26,29,0,109
11/13/2019,MEM,26,37,31,25,0,119,CHO,29,35,32,21,0,117
11/15/2019,UTA,26,22,31,27,0,106,MEM,23,30,24,30,0,107
11/17/2019,DEN,28,44,36,23,0,131,MEM,32,17,31,34,0,114
11/19/2019,GSW,28,33,22,31,0,114,MEM,30,16,26,23,0,95
11/23/2019,LAL,25,30,30,24,0,109,MEM,35,28,21,24,0,108
11/25/2019,MEM,27,29,27,31,0,114,IND,36,31,37,22,0,126
11/27/2019,LAC,35,29,28,29,0,121,MEM,31,29,28,31,0,119
11/29/2019,UTA,22,18,35,28,0,103,MEM,24,31,18,21,0,94
12/1/2019,MEM,25,23,38,29,0,115,MIN,21,26,32,28,0,107
12/2/2019,IND,24,33,28,32,0,117,MEM,19,28,26,31,0,104
12/4/2019,MEM,20,15,29,35,0,99,CHI,27,23,28,28,0,106
12/7/2019,MEM,36,18,30,28,0,112,UTA,32,37,28,29,0,126
12/9/2019,MEM,29,25,34,22,0,110,GSW,20,27,32,23,0,102
12/11/2019,MEM,27,24,33,31,0,115,PHO,19,32,28,29,0,108
12/13/2019,MIL,35,29,26,37,0,127,MEM,29,33,33,19,0,114
12/14/2019,WAS,30,24,30,27,0,111,MEM,35,34,35,24,0,128
12/16/2019,MIA,32,26,28,25,0,111,MEM,36,37,22,23,0,118
12/18/2019,MEM,32,36,32,22,0,122,OKC,27,32,34,33,0,126
12/20/2019,MEM,27,24,36,20,0,107,CLE,25,30,26,33,0,114
12/21/2019,SAC,21,29,28,37,0,115,MEM,23,37,31,28,0,119
12/23/2019,SAS,46,26,36,37,0,145,MEM,31,30,28,26,0,115
12/26/2019,MEM,23,26,37,24,0,110,OKC,18,29,27,23,0,97
12/28/2019,MEM,11,28,29,42,0,110,DEN,26,24,32,37,0,119
12/29/2019,CHO,20,26,29,29,0,104,MEM,31,25,30,31,0,117
1/2/2020,MEM,42,18,37,26,0,123,SAC,26,37,27,38,0,128
1/4/2020,MEM,40,25,39,36,0,140,LAC,27,30,23,34,0,114
1/5/2020,MEM,27,35,34,25,0,121,PHO,31,26,20,37,0,114
1/7/2020,MIN,32,24,28,28,0,112,MEM,27,24,31,37,0,119
1/10/2020,SAS,32,25,41,23,0,121,MEM,37,26,37,34,0,134
1/12/2020,GSW,26,33,17,26,0,102,MEM,27,33,35,27,0,122
1/14/2020,HOU,37,24,22,27,0,110,MEM,32,35,18,36,0,121
1/17/2020,CLE,25,31,20,33,0,109,MEM,27,27,38,21,0,113
1/20/2020,NOP,31,38,29,28,0,126,MEM,30,20,27,39,0,116
1/22/2020,MEM,27,17,19,32,0,95,BOS,25,33,41,20,0,119
1/24/2020,MEM,35,31,26,33,0,125,DET,23,38,24,27,0,112
1/26/2020,PHO,18,27,33,31,0,109,MEM,30,26,25,33,0,114
1/28/2020,DEN,18,32,16,30,0,96,MEM,31,32,19,22,0,104
1/29/2020,MEM,32,27,37,31,0,127,NYK,32,20,32,22,0,106
1/31/2020,MEM,22,37,27,25,0,111,NOP,31,35,44,29,0,139
2/3/2020,DET,32,21,10,19,0,82,MEM,36,17,19,24,0,96
2/5/2020,MEM,31,28,41,21,0,121,DAL,32,24,22,29,0,107
2/7/2020,MEM,25,19,22,41,0,107,PHI,26,32,39,22,0,119
2/9/2020,MEM,18,29,33,26,0,106,WAS,30,25,30,14,0,99
2/12/2020,POR,27,36,19,22,0,104,MEM,31,36,25,19,0,111
2/20/2020,MEM,35,26,29,35,0,125,SAC,37,33,27,32,0,129
2/21/2020,MEM,22,19,36,28,0,105,LAL,28,32,24,33,0,117
2/24/2020,MEM,14,23,29,31,0,97,LAC,40,26,24,34,0,124
2/26/2020,MEM,17,30,41,24,0,112,HOU,35,38,38,29,0,140
2/28/2020,SAC,21,29,31,23,0,104,MEM,30,17,28,26,0,101
2/29/2020,LAL,25,21,20,22,0,88,MEM,29,29,28,19,0,105
10/24/2019,LAC,35,30,46,30,0,141,GSW,29,25,33,35,0,122
10/27/2019,GSW,20,17,31,24,0,92,OKC,35,35,35,15,0,120
10/28/2019,GSW,27,45,31,31,0,134,NOP,23,32,24,44,0,123
10/30/2019,PHO,43,29,23,26,0,121,GSW,14,32,21,43,0,110
11/1/2019,SAS,29,28,40,30,0,127,GSW,28,27,31,24,0,110
11/2/2019,CHO,25,25,18,25,0,93,GSW,30,25,16,16,0,87
11/4/2019,POR,32,31,20,35,0,118,GSW,34,26,27,40,0,127
11/6/2019,GSW,29,23,31,29,0,112,HOU,30,33,35,31,0,129
11/8/2019,GSW,31,30,25,24,9,119,MIN,29,31,20,30,15,125
11/9/2019,GSW,27,16,41,24,0,108,OKC,36,24,24,30,0,114
11/11/2019,UTA,34,35,28,25,0,122,GSW,30,24,31,23,0,108
11/13/2019,GSW,26,29,27,12,0,94,LAL,38,29,31,22,0,120
11/15/2019,BOS,23,29,24,29,0,105,GSW,32,19,20,29,0,100
11/17/2019,GSW,23,26,20,31,0,100,NOP,26,29,21,32,0,108
11/19/2019,GSW,28,33,22,31,0,114,MEM,30,16,26,23,0,95
11/20/2019,GSW,16,22,26,30,0,94,DAL,44,30,30,38,0,142
11/22/2019,GSW,28,23,21,37,0,109,UTA,30,35,25,23,0,113
11/25/2019,OKC,25,28,21,26,0,100,GSW,28,31,24,14,0,97
11/27/2019,CHI,17,31,25,17,0,90,GSW,25,28,25,26,0,104
11/29/2019,GSW,21,37,21,26,0,105,MIA,41,30,24,27,0,122
12/1/2019,GSW,22,29,20,25,0,96,ORL,26,25,21,28,0,100
12/2/2019,GSW,23,17,13,26,0,79,ATL,20,29,27,28,0,104
12/4/2019,GSW,20,34,22,15,0,91,CHO,28,30,28,20,0,106
12/6/2019,GSW,23,27,27,23,0,100,CHI,28,23,32,15,0,98
12/9/2019,MEM,29,25,34,22,0,110,GSW,20,27,32,23,0,102
12/11/2019,NYK,30,38,19,25,12,124,GSW,20,30,30,32,10,122
12/13/2019,GSW,29,27,28,22,0,106,UTA,22,27,37,28,0,114
12/15/2019,SAC,26,25,28,21,0,100,GSW,18,24,17,20,0,79
12/18/2019,GSW,29,37,26,20,0,112,POR,40,27,30,25,0,122
12/20/2019,NOP,16,28,37,21,0,102,GSW,31,25,22,28,0,106
12/23/2019,MIN,22,21,24,37,0,104,GSW,22,35,27,29,0,113
12/25/2019,HOU,29,39,19,17,0,104,GSW,28,36,28,24,0,116
12/27/2019,PHO,29,22,27,18,0,96,GSW,25,18,23,39,0,105
12/28/2019,DAL,41,31,45,24,0,141,GSW,41,33,24,23,0,121
12/31/2019,GSW,32,23,20,25,13,113,SAS,25,28,24,23,17,117
1/2/2020,GSW,19,22,26,17,0,84,MIN,34,24,23,18,0,99
1/4/2020,DET,25,31,27,28,0,111,GSW,23,36,21,24,0,104
1/6/2020,GSW,19,21,24,34,0,98,SAC,26,26,38,21,0,111
1/8/2020,MIL,19,28,34,26,0,107,GSW,19,20,33,26,0,98
1/10/2020,GSW,20,33,30,17,0,100,LAC,22,26,25,36,0,109
1/12/2020,GSW,26,33,17,26,0,102,MEM,27,33,35,27,0,122
1/14/2020,DAL,36,29,29,30,0,124,GSW,26,21,24,26,0,97
1/16/2020,DEN,19,26,28,40,21,134,GSW,34,28,23,28,18,131
1/18/2020,ORL,25,27,19,24,0,95,GSW,28,25,29,27,0,109
1/20/2020,GSW,23,34,35,21,11,124,POR,27,26,34,26,16,129
1/22/2020,UTA,31,34,35,29,0,129,GSW,17,26,26,27,0,96
1/24/2020,IND,35,32,31,31,0,129,GSW,30,21,35,32,0,118
1/28/2020,GSW,27,27,28,22,0,104,PHI,26,33,27,29,0,115
1/30/2020,GSW,22,28,29,25,0,104,BOS,29,31,31,28,0,119
2/1/2020,GSW,31,30,44,26,0,131,CLE,32,27,19,34,0,112
2/3/2020,GSW,40,32,27,26,0,125,WAS,36,27,23,31,0,117
2/5/2020,GSW,25,22,17,24,0,88,BRK,40,28,27,34,0,129
2/8/2020,LAL,33,33,30,29,0,125,GSW,25,34,25,36,0,120
2/10/2020,MIA,24,38,21,30,0,113,GSW,20,23,32,26,0,101
2/12/2020,GSW,24,26,26,30,0,106,PHO,34,24,29,25,0,112
2/20/2020,HOU,38,34,37,26,0,135,GSW,17,33,27,28,0,105
2/23/2020,NOP,29,17,31,38,0,115,GSW,33,23,21,24,0,101
2/25/2020,SAC,33,22,26,31,0,112,GSW,22,21,30,21,0,94
2/27/2020,LAL,24,30,40,22,0,116,GSW,24,28,17,17,0,86
2/29/2020,GSW,28,33,31,23,0,115,PHO,41,24,16,18,0,99
3/1/2020,WAS,35,28,31,30,0,124,GSW,28,29,19,34,0,110
10/23/2019,DEN,24,30,19,35,0,108,POR,27,23,24,26,0,100
10/25/2019,PHO,21,24,17,33,12,107,DEN,15,24,25,31,13,108
10/28/2019,DEN,21,26,30,24,0,101,SAC,28,25,17,24,0,94
10/29/2019,DAL,27,33,23,26,0,109,DEN,31,30,27,18,0,106
10/31/2019,DEN,30,22,23,32,0,107,NOP,32,24,30,36,0,122
11/2/2019,DEN,17,23,29,22,0,91,ORL,26,19,18,24,0,87
11/5/2019,MIA,28,20,21,20,0,89,DEN,29,29,31,20,0,109
11/8/2019,PHI,24,33,27,13,0,97,DEN,18,24,23,35,0,100
11/10/2019,DEN,27,22,27,14,10,100,MIN,27,24,13,26,8,98
11/12/2019,ATL,25,38,35,27,0,125,DEN,34,20,35,32,0,121
11/14/2019,BRK,35,26,18,14,0,93,DEN,28,21,30,22,0,101
11/17/2019,DEN,28,44,36,23,0,131,MEM,32,17,31,34,0,114
11/20/2019,HOU,22,29,22,22,0,95,DEN,27,27,28,23,0,105
11/22/2019,BOS,13,21,23,35,0,92,DEN,27,18,25,26,0,96
11/24/2019,PHO,28,29,20,27,0,104,DEN,28,24,27,37,0,116
11/26/2019,WAS,23,24,22,35,0,104,DEN,25,39,22,31,0,117
11/30/2019,DEN,27,30,18,15,7,97,SAC,17,23,27,23,10,100
12/3/2019,LAL,28,32,24,21,0,105,DEN,24,25,27,20,0,96
12/5/2019,DEN,33,34,31,31,0,129,NYK,27,18,30,17,0,92
12/6/2019,DEN,26,19,19,31,0,95,BOS,33,20,32,23,0,108
12/8/2019,DEN,21,33,23,25,0,102,BRK,25,28,29,23,0,105
12/10/2019,DEN,27,23,26,16,0,92,PHI,26,29,28,14,0,97
12/12/2019,POR,26,27,25,21,0,99,DEN,33,29,27,25,0,114
12/14/2019,OKC,20,29,19,34,0,102,DEN,27,25,30,28,0,110
12/15/2019,NYK,22,29,33,21,0,105,DEN,33,34,20,24,0,111
12/18/2019,ORL,32,28,16,28,0,104,DEN,27,18,39,29,0,113
12/20/2019,MIN,20,31,24,25,0,100,DEN,33,28,21,27,0,109
12/22/2019,DEN,23,32,36,37,0,128,LAL,28,25,25,26,0,104
12/23/2019,DEN,34,22,26,31,0,113,PHO,22,27,32,30,0,111
12/25/2019,NOP,29,29,26,28,0,112,DEN,26,29,25,20,0,100
12/28/2019,MEM,11,28,29,42,0,110,DEN,26,24,32,37,0,119
12/29/2019,SAC,32,25,24,34,0,115,DEN,31,31,26,32,0,120
12/31/2019,DEN,26,26,37,15,0,104,HOU,38,31,23,38,0,130
1/2/2020,DEN,27,35,30,32,0,124,IND,37,27,24,28,0,116
1/4/2020,DEN,19,36,35,24,0,114,WAS,31,30,34,33,0,128
1/6/2020,DEN,29,35,27,32,0,123,ATL,31,25,30,29,0,115
1/8/2020,DEN,27,29,30,21,0,107,DAL,32,27,30,17,0,106
1/11/2020,CLE,23,28,34,26,0,111,DEN,18,24,29,32,0,103
1/12/2020,LAC,30,22,22,30,0,104,DEN,29,37,23,25,0,114
1/15/2020,CHO,25,17,27,17,0,86,DEN,28,29,17,26,0,100
1/16/2020,DEN,19,26,28,40,21,134,GSW,34,28,23,28,18,131
1/19/2020,IND,15,29,30,41,0,115,DEN,21,29,31,26,0,107
1/20/2020,DEN,26,29,26,26,0,107,MIN,29,25,25,21,0,100
1/22/2020,DEN,28,15,28,34,0,105,HOU,35,25,32,29,0,121
1/24/2020,DEN,37,26,31,19,0,113,NOP,28,28,26,24,0,106
1/26/2020,HOU,36,23,30,21,0,110,DEN,27,30,33,27,0,117
1/28/2020,DEN,18,32,16,30,0,96,MEM,31,32,19,22,0,104
1/30/2020,UTA,23,25,22,30,0,100,DEN,21,22,33,30,0,106
1/31/2020,DEN,35,25,40,27,0,127,MIL,43,24,24,24,0,115
2/2/2020,DEN,44,21,24,22,12,123,DET,30,38,22,21,17,128
2/4/2020,POR,28,10,36,25,0,99,DEN,37,27,36,27,0,127
2/5/2020,DEN,25,24,23,26,0,98,UTA,32,25,18,20,0,95
2/8/2020,DEN,28,27,28,34,0,117,PHO,37,17,24,30,0,108
2/10/2020,SAS,40,27,26,27,0,120,DEN,30,23,36,38,0,127
2/12/2020,LAL,23,38,23,27,9,120,DEN,31,24,32,24,5,116
2/21/2020,DEN,17,31,29,24,0,101,OKC,27,21,30,35,0,113
2/23/2020,MIN,38,27,22,29,0,116,DEN,43,30,24,31,0,128
2/25/2020,DET,23,23,26,26,0,98,DEN,29,30,23,33,0,115
2/28/2020,DEN,27,29,23,24,0,103,LAC,37,29,32,34,0,132
3/1/2020,TOR,32,37,27,22,0,118,DEN,40,33,27,33,0,133
10/23/2019,MIN,33,35,20,27,12,127,BRK,22,34,37,22,11,126
10/25/2019,NYK,23,28,32,26,0,109,BRK,32,32,30,19,0,113
10/27/2019,BRK,29,28,40,23,13,133,MEM,35,24,33,28,14,134
10/30/2019,IND,31,29,30,28,0,118,BRK,31,32,20,25,0,108
11/1/2019,HOU,33,26,24,33,0,116,BRK,24,37,34,28,0,123
11/2/2019,BRK,26,28,18,37,0,109,DET,33,13,32,35,0,113
11/4/2019,NOP,27,23,48,27,0,125,BRK,33,34,37,31,0,135
11/8/2019,BRK,26,28,35,30,0,119,POR,20,29,37,29,0,115
11/10/2019,BRK,30,20,30,32,0,112,PHO,37,31,38,32,0,138
11/12/2019,BRK,35,33,24,22,0,114,UTA,29,24,31,35,0,119
11/14/2019,BRK,35,26,18,14,0,93,DEN,28,21,30,22,0,101
11/16/2019,BRK,30,20,24,43,0,117,CHI,19,37,22,33,0,111
11/18/2019,IND,18,41,25,31,0,115,BRK,18,17,33,18,0,86
11/20/2019,CHO,26,25,22,18,0,91,BRK,26,30,26,19,0,101
11/22/2019,SAC,23,26,21,27,0,97,BRK,26,30,30,30,0,116
11/24/2019,BRK,29,23,30,21,0,103,NYK,22,24,26,29,0,101
11/25/2019,BRK,25,27,29,27,0,108,CLE,26,25,24,31,0,106
11/27/2019,BRK,23,40,23,24,0,110,BOS,30,27,34,30,0,121
11/29/2019,BOS,24,31,26,26,0,107,BRK,31,27,29,25,0,112
12/1/2019,MIA,32,26,25,26,0,109,BRK,30,35,16,25,0,106
12/4/2019,BRK,22,34,35,39,0,130,ATL,26,21,35,36,0,118
12/6/2019,BRK,29,26,31,25,0,111,CHO,32,25,27,20,0,104
12/8/2019,DEN,21,33,23,25,0,102,BRK,25,28,29,23,0,105
12/11/2019,CHO,26,27,31,29,0,113,BRK,34,30,22,22,0,108
12/14/2019,BRK,31,29,23,19,0,102,TOR,38,27,25,20,0,110
12/15/2019,PHI,23,20,23,23,0,89,BRK,28,29,26,26,0,109
12/17/2019,BRK,21,21,19,32,15,108,NOP,21,14,29,29,8,101
12/19/2019,BRK,33,23,25,24,0,105,SAS,27,23,33,35,0,118
12/21/2019,ATL,34,39,25,14,0,112,BRK,34,26,25,37,0,122
12/26/2019,NYK,24,22,33,15,0,94,BRK,15,26,20,21,0,82
12/28/2019,BRK,20,34,25,19,0,98,HOU,42,21,25,20,0,108
12/30/2019,BRK,29,21,30,23,12,115,MIN,27,22,25,29,19,122
1/2/2020,BRK,30,35,28,18,0,111,DAL,31,29,33,30,0,123
1/4/2020,TOR,24,24,35,38,0,121,BRK,33,19,28,22,0,102
1/6/2020,BRK,22,17,32,18,0,89,ORL,20,32,23,26,0,101
1/7/2020,OKC,27,22,25,27,10,111,BRK,23,25,29,24,2,103
1/10/2020,MIA,42,27,20,24,0,113,BRK,32,25,32,28,0,117
1/12/2020,ATL,16,30,20,20,0,86,BRK,37,33,22,16,0,108
1/14/2020,UTA,30,29,29,30,0,118,BRK,26,19,29,33,0,107
1/15/2020,BRK,28,29,33,16,0,106,PHI,25,29,32,31,0,117
1/18/2020,MIL,30,27,36,24,0,117,BRK,22,20,29,26,0,97
1/20/2020,PHI,29,35,26,27,0,117,BRK,32,36,23,20,0,111
1/23/2020,LAL,38,37,29,24,0,128,BRK,35,35,24,19,0,113
1/25/2020,BRK,26,24,30,26,15,121,DET,25,35,17,29,5,111
1/26/2020,BRK,28,24,24,21,0,97,NYK,30,25,30,25,0,110
1/29/2020,DET,30,38,25,22,0,115,BRK,32,38,29,26,0,125
1/31/2020,CHI,23,34,39,22,0,118,BRK,35,38,30,30,0,133
2/1/2020,BRK,36,25,23,23,0,107,WAS,27,32,22,32,0,113
2/3/2020,PHO,31,21,21,24,0,97,BRK,35,20,35,29,0,119
2/5/2020,GSW,25,22,17,24,0,88,BRK,40,28,27,34,0,129
2/8/2020,BRK,36,18,34,30,0,118,TOR,33,33,34,19,0,119
2/10/2020,BRK,30,21,26,29,0,106,IND,28,20,32,25,0,105
2/12/2020,TOR,19,21,25,26,0,91,BRK,23,29,23,26,0,101
2/20/2020,BRK,20,32,26,25,1,104,PHI,26,16,35,26,9,112
2/22/2020,BRK,30,25,33,27,0,115,CHO,25,20,18,23,0,86
2/24/2020,ORL,22,19,40,34,0,115,BRK,27,27,33,26,0,113
2/26/2020,BRK,17,30,37,22,0,106,WAS,31,29,21,29,0,110
2/28/2020,BRK,36,26,36,20,0,118,ATL,29,39,40,33,0,141
2/29/2020,BRK,27,22,31,33,0,113,MIA,24,33,34,25,0,116
10/22/2019,LAL,25,29,31,17,0,102,LAC,22,40,23,27,0,112
10/24/2019,LAC,35,30,46,30,0,141,GSW,29,25,33,35,0,122
10/26/2019,LAC,22,33,30,37,0,122,PHO,26,29,36,39,0,130
10/28/2019,CHO,28,26,20,22,0,96,LAC,29,28,29,25,0,111
10/30/2019,LAC,23,28,20,25,0,96,UTA,33,19,38,20,0,110
10/31/2019,SAS,24,24,27,22,0,97,LAC,23,27,30,23,0,103
11/3/2019,UTA,20,21,28,25,0,94,LAC,16,23,26,40,0,105
11/6/2019,MIL,28,42,28,31,0,129,LAC,30,29,30,35,0,124
11/7/2019,POR,22,18,36,25,0,101,LAC,26,21,23,37,0,107
11/11/2019,TOR,23,23,32,10,0,88,LAC,15,36,22,25,0,98
11/13/2019,LAC,15,22,31,25,0,93,HOU,31,18,25,28,0,102
11/14/2019,LAC,35,24,38,30,0,127,NOP,34,38,24,36,0,132
11/16/2019,ATL,30,32,20,19,0,101,LAC,43,31,38,38,0,150
11/18/2019,OKC,17,30,17,24,0,88,LAC,23,19,24,24,0,90
11/20/2019,BOS,21,21,33,22,7,104,LAC,22,18,29,28,10,107
11/22/2019,HOU,23,28,33,35,0,119,LAC,31,24,25,42,0,122
11/24/2019,NOP,27,29,31,22,0,109,LAC,40,32,28,34,0,134
11/26/2019,LAC,34,28,31,21,0,114,DAL,27,19,31,22,0,99
11/27/2019,LAC,35,29,28,29,0,121,MEM,31,29,28,31,0,119
11/29/2019,LAC,30,23,18,26,0,97,SAS,27,26,29,25,0,107
12/1/2019,WAS,35,22,41,27,0,125,LAC,39,43,34,34,0,150
12/3/2019,POR,30,29,17,21,0,97,LAC,29,33,27,28,0,117
12/6/2019,LAC,15,28,19,29,0,91,MIL,30,22,35,32,0,119
12/8/2019,LAC,35,30,35,35,0,135,WAS,25,39,29,26,0,119
12/9/2019,LAC,24,36,31,19,0,110,IND,19,29,25,26,0,99
12/11/2019,LAC,27,37,24,24,0,112,TOR,32,14,25,21,0,92
12/13/2019,LAC,33,32,37,22,0,124,MIN,29,29,23,36,0,117
12/14/2019,LAC,29,28,22,27,0,106,CHI,24,31,29,25,0,109
12/17/2019,PHO,23,21,25,30,0,99,LAC,31,23,36,30,0,120
12/19/2019,HOU,27,27,36,32,0,122,LAC,28,41,18,30,0,117
12/21/2019,LAC,33,39,38,24,0,134,SAS,31,30,22,26,0,109
12/22/2019,LAC,33,30,26,23,0,112,OKC,27,30,29,32,0,118
12/25/2019,LAC,31,20,35,25,0,111,LAL,33,30,23,20,0,106
12/28/2019,UTA,22,39,32,27,0,120,LAC,32,31,29,15,0,107
12/31/2019,LAC,28,29,31,17,0,105,SAC,23,17,33,14,0,87
1/2/2020,DET,33,30,16,33,0,112,LAC,30,39,37,20,0,126
1/4/2020,MEM,40,25,39,36,0,140,LAC,27,30,23,34,0,114
1/5/2020,NYK,45,24,31,32,0,132,LAC,29,47,38,21,0,135
1/10/2020,GSW,20,33,30,17,0,100,LAC,22,26,25,36,0,109
1/12/2020,LAC,30,22,22,30,0,104,DEN,29,37,23,25,0,114
1/14/2020,CLE,26,24,21,32,0,103,LAC,31,35,40,22,0,128
1/16/2020,ORL,26,22,28,19,0,95,LAC,34,33,24,31,0,122
1/18/2020,LAC,33,39,30,31,0,133,NOP,35,45,30,20,0,130
1/21/2020,LAC,24,36,22,28,0,110,DAL,24,25,29,29,0,107
1/22/2020,LAC,32,28,15,20,0,95,ATL,16,25,28,33,0,102
1/24/2020,LAC,22,41,38,21,0,122,MIA,30,35,20,32,0,117
1/26/2020,LAC,26,28,31,27,0,112,ORL,28,24,20,25,0,97
1/30/2020,SAC,28,36,21,39,0,124,LAC,33,14,24,32,0,103
2/1/2020,MIN,32,23,31,20,0,106,LAC,40,22,36,20,0,118
2/3/2020,SAS,39,24,19,23,0,105,LAC,29,25,31,23,0,108
2/5/2020,MIA,23,35,22,31,0,111,LAC,25,30,37,36,0,128
2/8/2020,LAC,31,28,29,27,0,115,MIN,40,41,31,30,0,142
2/9/2020,LAC,36,37,34,26,0,133,CLE,21,29,23,19,0,92
2/11/2020,LAC,22,32,23,26,0,103,PHI,30,24,27,29,0,110
2/13/2020,LAC,32,26,29,27,13,133,BOS,30,30,31,23,13,141
2/22/2020,SAC,25,29,34,24,0,112,LAC,13,35,35,20,0,103
2/24/2020,MEM,14,23,29,31,0,97,LAC,40,26,24,34,0,124
2/26/2020,LAC,21,33,22,26,0,102,PHO,29,20,17,26,0,92
2/28/2020,DEN,27,29,23,24,0,103,LAC,37,29,32,34,0,132
3/1/2020,PHI,39,33,24,34,0,130,LAC,34,36,38,28,0,136
10/23/2019,DEN,24,30,19,35,0,108,POR,27,23,24,26,0,100
10/25/2019,POR,25,32,37,28,0,122,SAC,27,30,27,28,0,112
10/27/2019,POR,25,34,36,26,0,121,DAL,40,31,24,24,0,119
10/28/2019,POR,33,18,20,39,0,110,SAS,19,26,37,31,0,113
10/30/2019,POR,24,25,19,34,0,102,OKC,17,27,25,30,0,99
11/2/2019,PHI,27,30,35,37,0,129,POR,32,36,34,26,0,128
11/4/2019,POR,32,31,20,35,0,118,GSW,34,26,27,40,0,127
11/7/2019,POR,22,18,36,25,0,101,LAC,26,21,23,37,0,107
11/8/2019,BRK,26,28,35,30,0,119,POR,20,29,37,29,0,115
11/10/2019,ATL,21,23,31,32,6,113,POR,20,26,29,32,17,124
11/12/2019,POR,24,25,21,29,0,99,SAC,21,25,35,26,0,107
11/13/2019,TOR,23,31,33,27,0,114,POR,30,23,25,28,0,106
11/16/2019,POR,41,25,24,31,0,121,SAS,23,35,38,20,0,116
11/18/2019,POR,30,20,26,32,0,108,HOU,29,35,35,33,0,132
11/19/2019,POR,28,26,25,25,0,104,NOP,27,26,35,27,0,115
11/21/2019,POR,27,31,40,31,0,129,MIL,37,35,35,30,0,137
11/23/2019,POR,19,23,27,35,0,104,CLE,19,30,27,34,0,110
11/25/2019,POR,27,35,30,25,0,117,CHI,28,26,18,22,0,94
11/27/2019,OKC,26,24,27,42,0,119,POR,42,21,41,32,0,136
11/29/2019,CHI,28,19,31,25,0,103,POR,25,28,28,26,0,107
12/3/2019,POR,30,29,17,21,0,97,LAC,29,33,27,28,0,117
12/4/2019,SAC,35,29,31,21,0,116,POR,30,36,34,27,0,127
12/6/2019,LAL,39,38,33,26,0,136,POR,34,28,31,20,0,113
12/8/2019,OKC,21,34,27,26,0,108,POR,20,27,31,18,0,96
12/10/2019,NYK,22,19,18,28,0,87,POR,32,28,26,29,0,115
12/12/2019,POR,26,27,25,21,0,99,DEN,33,29,27,25,0,114
12/16/2019,POR,25,34,31,21,0,111,PHO,33,34,21,22,0,110
12/18/2019,GSW,29,37,26,20,0,112,POR,40,27,30,25,0,122
12/20/2019,ORL,13,31,31,28,0,103,POR,31,26,36,25,0,118
12/21/2019,MIN,23,29,28,26,0,106,POR,27,34,22,30,0,113
12/23/2019,NOP,31,23,28,20,0,102,POR,31,25,21,17,0,94
12/26/2019,POR,22,30,24,39,0,115,UTA,37,25,34,25,0,121
12/28/2019,LAL,34,37,32,25,0,128,POR,32,32,31,25,0,120
12/30/2019,PHO,19,36,28,39,0,122,POR,38,26,25,27,0,116
1/1/2020,POR,27,21,29,16,0,93,NYK,25,26,32,34,0,117
1/3/2020,POR,27,39,25,31,0,122,WAS,31,27,20,25,0,103
1/5/2020,POR,19,27,35,30,0,111,MIA,31,34,29,28,0,122
1/7/2020,POR,15,31,23,32,0,101,TOR,24,32,22,21,0,99
1/9/2020,POR,34,13,27,28,0,102,MIN,28,31,41,16,0,116
1/11/2020,MIL,32,32,33,25,0,122,POR,24,31,25,21,0,101
1/13/2020,CHO,26,20,43,23,0,112,POR,25,37,29,24,0,115
1/15/2020,POR,28,32,30,27,0,117,HOU,26,21,30,30,0,107
1/17/2020,POR,37,26,26,23,0,112,DAL,38,34,26,22,0,120
1/18/2020,POR,24,33,20,29,0,106,OKC,32,32,23,32,0,119
1/20/2020,GSW,23,34,35,21,11,124,POR,27,26,34,26,16,129
1/23/2020,DAL,45,33,25,30,0,133,POR,37,26,27,35,0,125
1/26/2020,IND,27,29,37,36,0,129,POR,36,30,40,33,0,139
1/29/2020,HOU,36,24,22,30,0,112,POR,30,41,26,28,0,125
1/31/2020,POR,38,22,43,24,0,127,LAL,36,26,34,23,0,119
2/1/2020,UTA,34,19,30,24,0,107,POR,33,30,31,30,0,124
2/4/2020,POR,28,10,36,25,0,99,DEN,37,27,36,27,0,127
2/6/2020,SAS,35,25,32,25,0,117,POR,27,32,27,39,0,125
2/7/2020,POR,38,34,17,25,0,114,UTA,32,26,30,29,0,117
2/9/2020,MIA,36,24,23,26,0,109,POR,38,25,30,22,0,115
2/11/2020,POR,36,29,21,31,0,117,NOP,27,36,41,34,0,138
2/12/2020,POR,27,36,19,22,0,104,MEM,31,36,25,19,0,111
2/21/2020,NOP,40,33,29,26,0,128,POR,35,28,20,32,0,115
2/23/2020,DET,24,27,34,19,0,104,POR,40,13,27,27,0,107
2/25/2020,BOS,28,28,29,33,0,118,POR,24,24,22,36,0,106
2/27/2020,POR,24,25,26,25,0,100,IND,30,13,37,26,0,106
2/29/2020,POR,28,28,34,27,0,117,ATL,23,40,44,22,0,129
10/23/2019,DET,27,27,29,36,0,119,IND,24,31,31,24,0,110
10/26/2019,IND,28,20,26,25,0,99,CLE,26,39,25,20,0,110
10/28/2019,IND,25,28,18,23,0,94,DET,33,26,19,18,0,96
10/30/2019,IND,31,29,30,28,0,118,BRK,31,32,20,25,0,108
11/1/2019,CLE,26,11,24,34,0,95,IND,19,23,26,34,0,102
11/3/2019,CHI,18,24,32,21,0,95,IND,24,31,31,22,0,108
11/5/2019,IND,35,29,28,21,7,120,CHO,20,37,21,35,9,122
11/6/2019,WAS,26,36,18,26,0,106,IND,26,44,24,27,0,121
11/8/2019,DET,35,18,19,34,0,106,IND,27,30,28,27,0,112
11/10/2019,IND,29,22,30,28,0,109,ORL,33,27,17,25,0,102
11/12/2019,OKC,25,17,20,23,0,85,IND,31,21,34,25,0,111
11/15/2019,IND,22,27,30,23,0,102,HOU,26,28,26,31,0,111
11/16/2019,MIL,26,23,22,31,0,102,IND,22,14,27,20,0,83
11/18/2019,IND,18,41,25,31,0,115,BRK,18,17,33,18,0,86
11/23/2019,ORL,25,20,40,21,0,106,IND,24,31,28,28,0,111
11/25/2019,MEM,27,29,27,31,0,114,IND,36,31,37,22,0,126
11/27/2019,UTA,20,23,37,22,0,102,IND,21,32,36,32,0,121
11/29/2019,ATL,23,31,11,29,10,104,IND,22,21,29,22,11,105
11/30/2019,IND,29,36,28,23,0,116,PHI,38,27,28,26,0,119
12/2/2019,IND,24,33,28,32,0,117,MEM,19,28,26,31,0,104
12/4/2019,IND,26,23,30,28,0,107,OKC,29,21,28,22,0,100
12/6/2019,IND,19,25,31,26,0,101,DET,32,23,16,37,0,108
12/7/2019,IND,32,34,23,15,0,104,NYK,27,33,21,22,0,103
12/9/2019,LAC,24,36,31,19,0,110,IND,19,29,25,26,0,99
12/11/2019,BOS,32,25,37,23,0,117,IND,30,31,23,38,0,122
12/13/2019,IND,29,34,23,24,0,110,ATL,22,26,35,17,0,100
12/15/2019,CHO,20,24,22,19,0,85,IND,33,26,13,35,0,107
12/17/2019,LAL,28,24,24,26,0,102,IND,24,26,28,27,0,105
12/20/2019,SAC,32,25,22,26,0,105,IND,30,38,24,27,0,119
12/22/2019,IND,22,33,18,16,0,89,MIL,21,38,24,34,0,117
12/23/2019,TOR,19,25,35,28,8,115,IND,30,24,24,29,13,120
12/27/2019,IND,27,28,27,30,0,112,MIA,25,33,26,29,0,113
12/28/2019,IND,32,13,23,30,0,98,NOP,19,29,38,34,0,120
12/31/2019,PHI,27,16,23,31,0,97,IND,29,38,29,19,0,115
1/2/2020,DEN,27,35,30,32,0,124,IND,37,27,24,28,0,116
1/4/2020,IND,26,34,35,16,0,111,ATL,43,21,32,20,0,116
1/6/2020,IND,27,15,37,36,0,115,CHO,29,15,21,39,0,104
1/8/2020,MIA,31,31,38,22,0,122,IND,23,26,23,36,0,108
1/10/2020,IND,29,25,25,37,0,116,CHI,27,19,26,33,0,105
1/13/2020,PHI,23,26,20,26,0,95,IND,22,18,29,32,0,101
1/15/2020,IND,24,30,22,28,0,104,MIN,30,29,18,22,0,99
1/17/2020,MIN,26,35,32,21,0,114,IND,32,35,32,17,0,116
1/19/2020,IND,15,29,30,41,0,115,DEN,21,29,31,26,0,107
1/20/2020,IND,23,21,19,25,0,88,UTA,29,27,24,38,0,118
1/22/2020,IND,30,24,29,29,0,112,PHO,24,24,17,22,0,87
1/24/2020,IND,35,32,31,31,0,129,GSW,30,21,35,32,0,118
1/26/2020,IND,27,29,37,36,0,129,POR,36,30,40,33,0,139
1/29/2020,CHI,24,27,29,20,6,106,IND,25,30,25,20,15,115
2/1/2020,NYK,24,26,22,20,0,92,IND,11,28,32,14,0,85
2/3/2020,DAL,25,28,29,30,0,112,IND,22,33,22,26,0,103
2/5/2020,IND,20,43,23,32,0,118,TOR,30,18,34,37,0,119
2/7/2020,TOR,36,28,23,28,0,115,IND,31,32,20,23,0,106
2/8/2020,NOP,31,29,28,36,0,124,IND,26,29,30,32,0,117
2/10/2020,BRK,30,21,26,29,0,106,IND,28,20,32,25,0,105
2/12/2020,MIL,20,25,26,40,0,111,IND,34,34,14,36,0,118
2/21/2020,IND,15,36,29,26,0,106,NYK,20,24,21,33,0,98
2/23/2020,IND,12,20,23,26,0,81,TOR,34,29,22,42,0,127
2/25/2020,CHO,25,19,11,25,0,80,IND,35,34,25,25,0,119
2/27/2020,POR,24,25,26,25,0,100,IND,30,13,37,26,0,106
2/29/2020,IND,30,26,30,27,0,113,CLE,31,27,28,18,0,104
10/23/2019,NYK,15,36,33,27,0,111,SAS,22,37,24,37,0,120
10/26/2019,WAS,26,34,30,32,0,122,SAS,30,30,32,32,0,124
10/28/2019,POR,33,18,20,39,0,110,SAS,19,26,37,31,0,113
10/31/2019,SAS,24,24,27,22,0,97,LAC,23,27,30,23,0,103
11/1/2019,SAS,29,28,40,30,0,127,GSW,28,27,31,24,0,110
11/3/2019,LAL,26,30,21,26,0,103,SAS,25,18,29,24,0,96
11/5/2019,SAS,21,24,33,22,0,100,ATL,22,22,26,38,0,108
11/7/2019,OKC,30,27,27,28,0,112,SAS,33,23,36,29,0,121
11/9/2019,BOS,39,33,32,31,0,135,SAS,30,24,37,24,0,115
11/11/2019,MEM,35,22,34,22,0,113,SAS,22,32,26,29,0,109
11/13/2019,SAS,24,35,36,19,0,114,MIN,26,40,40,23,0,129
11/15/2019,SAS,31,25,26,27,0,109,ORL,24,23,32,32,0,111
11/16/2019,POR,41,25,24,31,0,121,SAS,23,35,38,20,0,116
11/18/2019,SAS,22,27,30,31,0,110,DAL,36,23,34,24,0,117
11/20/2019,SAS,38,31,29,34,0,132,WAS,35,28,38,37,0,138
11/22/2019,SAS,22,30,28,24,0,104,PHI,29,30,28,28,0,115
11/23/2019,SAS,32,36,21,22,0,111,NYK,16,27,28,33,0,104
11/25/2019,LAL,25,29,32,28,0,114,SAS,22,34,26,22,0,104
11/27/2019,MIN,22,35,24,32,0,113,SAS,24,23,31,23,0,101
11/29/2019,LAC,30,23,18,26,0,97,SAS,27,26,29,25,0,107
12/1/2019,SAS,27,24,20,27,0,98,DET,32,27,37,36,0,132
12/3/2019,HOU,25,38,34,18,11,133,SAS,27,32,22,34,11,135
12/6/2019,SAC,17,25,30,28,4,104,SAS,21,31,17,31,5,105
12/12/2019,CLE,28,25,25,25,14,117,SAS,19,24,25,35,6,109
12/14/2019,SAS,28,16,34,31,12,121,PHO,18,30,32,29,10,119
12/16/2019,SAS,35,37,17,18,0,107,HOU,21,32,30,26,0,109
12/19/2019,BRK,33,23,25,24,0,105,SAS,27,23,33,35,0,118
12/21/2019,LAC,33,39,38,24,0,134,SAS,31,30,22,26,0,109
12/23/2019,SAS,46,26,36,37,0,145,MEM,31,30,28,26,0,115
12/26/2019,SAS,24,23,27,24,0,98,DAL,20,32,27,23,0,102
12/28/2019,DET,28,27,25,29,0,109,SAS,30,29,42,35,0,136
12/31/2019,GSW,32,23,20,25,13,113,SAS,25,28,24,23,17,117
1/2/2020,OKC,27,19,28,35,0,109,SAS,27,28,21,27,0,103
1/4/2020,SAS,31,35,25,27,0,118,MIL,29,42,32,24,0,127
1/6/2020,MIL,22,30,29,23,0,104,SAS,27,38,26,35,0,126
1/8/2020,SAS,34,31,34,30,0,129,BOS,22,25,36,31,0,114
1/10/2020,SAS,32,25,41,23,0,121,MEM,37,26,37,34,0,134
1/12/2020,SAS,21,22,26,36,0,105,TOR,28,23,31,22,0,104
1/15/2020,SAS,17,34,26,23,0,100,MIA,24,27,24,31,0,106
1/17/2020,ATL,29,38,21,33,0,121,SAS,27,31,41,21,0,120
1/19/2020,MIA,31,23,30,18,0,102,SAS,28,32,26,21,0,107
1/20/2020,SAS,28,38,30,24,0,120,PHO,26,25,32,35,0,118
1/22/2020,SAS,31,29,34,27,0,121,NOP,24,27,31,35,0,117
1/24/2020,PHO,22,34,22,25,0,103,SAS,28,16,28,27,0,99
1/26/2020,TOR,37,26,23,24,0,110,SAS,21,30,34,21,0,106
1/27/2020,SAS,28,20,37,24,0,109,CHI,21,29,25,35,0,110
1/29/2020,UTA,29,33,32,26,0,120,SAS,37,33,28,29,0,127
2/1/2020,CHO,28,35,11,16,0,90,SAS,30,20,29,35,0,114
2/3/2020,SAS,39,24,19,23,0,105,LAC,29,25,31,23,0,108
2/4/2020,SAS,19,22,33,28,0,102,LAL,21,30,36,42,0,129
2/6/2020,SAS,35,25,32,25,0,117,POR,27,32,27,39,0,125
2/8/2020,SAS,23,26,29,24,0,102,SAC,24,28,37,33,0,122
2/10/2020,SAS,40,27,26,27,0,120,DEN,30,23,36,38,0,127
2/11/2020,SAS,25,24,30,35,0,114,OKC,14,27,36,29,0,106
2/21/2020,SAS,27,38,28,20,0,113,UTA,21,25,29,29,0,104
2/23/2020,SAS,29,26,18,30,0,103,OKC,29,32,37,33,0,131
2/26/2020,DAL,36,23,29,21,0,109,SAS,20,29,28,26,0,103
2/29/2020,ORL,27,26,28,32,0,113,SAS,38,23,24,29,0,114
10/24/2019,MIL,23,27,28,39,0,117,HOU,30,36,21,24,0,111
10/26/2019,NOP,24,37,39,23,0,123,HOU,29,32,36,29,0,126
10/28/2019,OKC,35,27,18,32,0,112,HOU,22,30,39,25,0,116
10/30/2019,HOU,35,41,35,48,0,159,WAS,34,43,40,41,0,158
11/1/2019,HOU,33,26,24,33,0,116,BRK,24,37,34,28,0,123
11/3/2019,HOU,14,32,25,29,0,100,MIA,46,25,28,30,0,129
11/4/2019,HOU,33,29,22,23,0,107,MEM,28,32,16,24,0,100
11/6/2019,GSW,29,23,31,29,0,112,HOU,30,33,35,31,0,129
11/9/2019,HOU,20,30,36,31,0,117,CHI,27,22,18,27,0,94
11/11/2019,HOU,30,28,32,32,0,122,NOP,23,29,30,34,0,116
11/13/2019,LAC,15,22,31,25,0,93,HOU,31,18,25,28,0,102
11/15/2019,IND,22,27,30,23,0,102,HOU,26,28,26,31,0,111
11/16/2019,HOU,31,33,29,32,0,125,MIN,30,32,23,20,0,105
11/18/2019,POR,30,20,26,32,0,108,HOU,29,35,35,33,0,132
11/20/2019,HOU,22,29,22,22,0,95,DEN,27,27,28,23,0,105
11/22/2019,HOU,23,28,33,35,0,119,LAC,31,24,25,42,0,122
11/24/2019,DAL,45,33,27,32,0,137,HOU,29,31,35,28,0,123
11/27/2019,MIA,23,19,26,40,0,108,HOU,27,39,25,26,0,117
11/30/2019,ATL,21,31,21,38,0,111,HOU,38,43,46,31,0,158
12/3/2019,HOU,25,38,34,18,11,133,SAS,27,32,22,34,11,135
12/5/2019,HOU,34,29,31,25,0,119,TOR,28,27,33,21,0,109
12/7/2019,PHO,31,21,26,31,0,109,HOU,23,37,23,32,0,115
12/9/2019,SAC,32,27,35,25,0,119,HOU,28,36,29,25,0,118
12/11/2019,HOU,35,29,24,28,0,116,CLE,29,28,25,28,0,110
12/13/2019,HOU,28,34,34,34,0,130,ORL,22,33,23,29,0,107
12/14/2019,DET,30,32,26,27,0,115,HOU,32,20,23,32,0,107
12/16/2019,SAS,35,37,17,18,0,107,HOU,21,32,30,26,0,109
12/19/2019,HOU,27,27,36,32,0,122,LAC,28,41,18,30,0,117
12/21/2019,HOU,36,34,36,33,0,139,PHO,35,30,30,30,0,125
12/23/2019,HOU,37,28,32,16,0,113,SAC,21,36,22,25,0,104
12/25/2019,HOU,29,39,19,17,0,104,GSW,28,36,28,24,0,116
12/28/2019,BRK,20,34,25,19,0,98,HOU,42,21,25,20,0,108
12/29/2019,HOU,37,27,29,19,0,112,NOP,36,28,22,41,0,127
12/31/2019,DEN,26,26,37,15,0,104,HOU,38,31,23,38,0,130
1/3/2020,PHI,27,26,31,24,0,108,HOU,20,40,36,22,0,118
1/8/2020,HOU,45,32,22,23,0,122,ATL,29,33,23,30,0,115
1/9/2020,HOU,21,27,19,25,0,92,OKC,37,23,29,24,0,113
1/11/2020,MIN,20,21,35,33,0,109,HOU,22,35,45,37,0,139
1/14/2020,HOU,37,24,22,27,0,110,MEM,32,35,18,36,0,121
1/15/2020,POR,28,32,30,27,0,117,HOU,26,21,30,30,0,107
1/18/2020,LAL,27,32,32,33,0,124,HOU,34,31,17,33,0,115
1/20/2020,OKC,22,35,14,41,0,112,HOU,25,39,23,20,0,107
1/22/2020,DEN,28,15,28,34,0,105,HOU,35,25,32,29,0,121
1/24/2020,HOU,36,27,31,37,0,131,MIN,26,34,24,40,0,124
1/26/2020,HOU,36,23,30,21,0,110,DEN,27,30,33,27,0,117
1/27/2020,HOU,28,31,28,39,0,126,UTA,20,26,29,42,0,117
1/29/2020,HOU,36,24,22,30,0,112,POR,30,41,26,28,0,125
1/31/2020,DAL,28,32,25,36,0,121,HOU,35,30,36,27,0,128
2/2/2020,NOP,28,32,33,16,0,109,HOU,30,35,27,25,0,117
2/4/2020,CHO,34,29,25,22,0,110,HOU,22,40,30,33,0,125
2/6/2020,HOU,28,35,34,24,0,121,LAL,29,34,30,18,0,111
2/7/2020,HOU,26,29,18,18,0,91,PHO,46,19,32,30,0,127
2/9/2020,UTA,25,29,27,33,0,114,HOU,33,25,25,30,0,113
2/11/2020,BOS,19,30,22,34,0,105,HOU,23,24,31,38,0,116
2/20/2020,HOU,38,34,37,26,0,135,GSW,17,33,27,28,0,105
2/22/2020,HOU,38,24,38,20,0,120,UTA,36,30,19,25,0,110
2/24/2020,NYK,33,24,29,26,0,112,HOU,36,36,29,22,0,123
2/26/2020,MEM,17,30,41,24,0,112,HOU,35,38,38,29,0,140
2/29/2020,HOU,19,26,36,23,7,111,BOS,28,28,22,26,6,110
10/23/2019,OKC,12,34,28,21,0,95,UTA,23,26,19,32,0,100
10/25/2019,WAS,28,24,26,19,0,97,OKC,24,22,24,15,0,85
10/27/2019,GSW,20,17,31,24,0,92,OKC,35,35,35,15,0,120
10/28/2019,OKC,35,27,18,32,0,112,HOU,22,30,39,25,0,116
10/30/2019,POR,24,25,19,34,0,102,OKC,17,27,25,30,0,99
11/2/2019,NOP,26,34,26,18,0,104,OKC,33,32,29,21,0,115
11/5/2019,ORL,26,27,26,15,0,94,OKC,31,27,23,21,0,102
11/7/2019,OKC,30,27,27,28,0,112,SAS,33,23,36,29,0,121
11/9/2019,GSW,27,16,41,24,0,108,OKC,36,24,24,30,0,114
11/10/2019,MIL,21,29,37,34,0,121,OKC,24,32,24,39,0,119
11/12/2019,OKC,25,17,20,23,0,85,IND,31,21,34,25,0,111
11/15/2019,PHI,29,20,34,24,12,119,OKC,24,30,26,27,20,127
11/18/2019,OKC,17,30,17,24,0,88,LAC,23,19,24,24,0,90
11/19/2019,OKC,28,25,34,20,0,107,LAL,33,30,30,19,0,112
11/22/2019,LAL,34,32,40,24,0,130,OKC,33,34,36,24,0,127
11/25/2019,OKC,25,28,21,26,0,100,GSW,28,31,24,14,0,97
11/27/2019,OKC,26,24,27,42,0,119,POR,42,21,41,32,0,136
11/29/2019,NOP,26,27,31,20,0,104,OKC,34,28,17,30,0,109
12/1/2019,OKC,33,23,26,25,0,107,NOP,29,26,22,27,0,104
12/4/2019,IND,26,23,30,28,0,107,OKC,29,21,28,22,0,100
12/6/2019,MIN,27,31,39,25,5,127,OKC,30,23,41,28,17,139
12/8/2019,OKC,21,34,27,26,0,108,POR,20,27,31,18,0,96
12/9/2019,OKC,25,26,34,19,0,104,UTA,24,23,21,22,0,90
12/11/2019,OKC,18,29,24,22,0,93,SAC,23,15,31,25,0,94
12/14/2019,OKC,20,29,19,34,0,102,DEN,27,25,30,28,0,110
12/16/2019,CHI,37,31,22,16,0,106,OKC,16,33,33,27,0,109
12/18/2019,MEM,32,36,32,22,0,122,OKC,27,32,34,33,0,126
12/20/2019,PHO,23,27,41,17,0,108,OKC,26,31,44,25,0,126
12/22/2019,LAC,33,30,26,23,0,112,OKC,27,30,29,32,0,118
12/26/2019,MEM,23,26,37,24,0,110,OKC,18,29,27,23,0,97
12/27/2019,OKC,26,27,19,22,10,104,CHO,18,25,22,29,8,102
12/29/2019,OKC,22,25,29,22,0,98,TOR,20,27,33,17,0,97
12/31/2019,DAL,32,19,27,23,0,101,OKC,20,30,27,29,0,106
1/2/2020,OKC,27,19,28,35,0,109,SAS,27,28,21,27,0,103
1/4/2020,OKC,34,32,25,30,0,121,CLE,27,26,26,27,0,106
1/6/2020,OKC,31,21,34,27,0,113,PHI,31,31,28,30,0,120
1/7/2020,OKC,27,22,25,27,10,111,BRK,23,25,29,24,2,103
1/9/2020,HOU,21,27,19,25,0,92,OKC,37,23,29,24,0,113
1/11/2020,LAL,41,32,29,23,0,125,OKC,19,30,33,28,0,110
1/13/2020,OKC,30,33,29,25,0,117,MIN,33,27,19,25,0,104
1/15/2020,TOR,38,35,24,33,0,130,OKC,25,30,28,38,0,121
1/17/2020,MIA,40,21,31,23,0,115,OKC,26,21,31,30,0,108
1/18/2020,POR,24,33,20,29,0,106,OKC,32,32,23,32,0,119
1/20/2020,OKC,22,35,14,41,0,112,HOU,25,39,23,20,0,107
1/22/2020,OKC,24,36,32,28,0,120,ORL,21,30,38,25,0,114
1/24/2020,ATL,30,28,32,21,0,111,OKC,33,33,38,36,0,140
1/25/2020,OKC,28,24,39,22,0,113,MIN,22,26,24,32,0,104
1/27/2020,DAL,25,34,29,19,0,107,OKC,22,25,30,20,0,97
1/29/2020,OKC,23,36,37,24,0,120,SAC,16,31,29,24,0,100
1/31/2020,OKC,25,28,26,32,0,111,PHO,27,25,29,26,0,107
2/5/2020,CLE,28,25,28,22,0,103,OKC,29,32,23,25,0,109
2/7/2020,DET,24,23,21,33,0,101,OKC,29,23,26,30,0,108
2/9/2020,BOS,28,24,32,28,0,112,OKC,32,29,23,27,0,111
2/11/2020,SAS,25,24,30,35,0,114,OKC,14,27,36,29,0,106
2/13/2020,OKC,29,37,32,25,0,123,NOP,30,28,35,25,0,118
2/21/2020,DEN,17,31,29,24,0,101,OKC,27,21,30,35,0,113
2/23/2020,SAS,29,26,18,30,0,103,OKC,29,32,37,33,0,131
2/25/2020,OKC,36,36,19,33,0,124,CHI,28,27,38,29,0,122
2/27/2020,SAC,27,34,21,26,0,108,OKC,25,25,31,31,0,112
2/28/2020,OKC,24,23,22,17,0,86,MIL,31,39,37,26,0,133
10/22/2019,NOP,30,31,25,31,5,122,TOR,27,29,32,29,13,130
10/25/2019,TOR,21,28,33,24,0,106,BOS,22,28,26,36,0,112
10/26/2019,TOR,24,24,36,24,0,108,CHI,23,17,22,22,0,84
10/28/2019,ORL,22,24,21,28,0,95,TOR,31,20,27,26,0,104
10/30/2019,DET,28,30,27,28,0,113,TOR,37,27,37,24,0,125
11/2/2019,TOR,17,33,40,15,0,105,MIL,36,30,29,20,0,115
11/6/2019,SAC,23,35,30,32,0,120,TOR,36,30,29,29,0,124
11/8/2019,TOR,30,45,22,25,0,122,NOP,30,23,22,29,0,104
11/10/2019,TOR,29,23,26,35,0,113,LAL,30,30,18,26,0,104
11/11/2019,TOR,23,23,32,10,0,88,LAC,15,36,22,25,0,98
11/13/2019,TOR,23,31,33,27,0,114,POR,30,23,25,28,0,106
11/16/2019,TOR,22,38,17,25,0,102,DAL,32,21,25,32,0,110
11/18/2019,CHO,25,31,18,22,0,96,TOR,26,34,32,40,0,132
11/20/2019,ORL,32,19,17,29,0,97,TOR,32,29,18,34,0,113
11/23/2019,TOR,26,26,35,32,0,119,ATL,27,34,29,26,0,116
11/25/2019,PHI,34,15,31,16,0,96,TOR,28,23,30,20,0,101
11/27/2019,NYK,29,17,23,29,0,98,TOR,21,37,31,37,0,126
11/29/2019,TOR,20,20,26,24,0,90,ORL,23,24,12,24,0,83
12/1/2019,UTA,20,17,49,24,0,110,TOR,37,40,30,23,0,130
12/3/2019,MIA,32,26,25,25,13,121,TOR,23,30,28,27,2,110
12/5/2019,HOU,34,29,31,25,0,119,TOR,28,27,33,21,0,109
12/8/2019,TOR,22,20,26,36,0,104,PHI,27,30,29,24,0,110
12/9/2019,TOR,30,19,22,22,0,93,CHI,30,21,20,21,0,92
12/11/2019,LAC,27,37,24,24,0,112,TOR,32,14,25,21,0,92
12/14/2019,BRK,31,29,23,19,0,102,TOR,38,27,25,20,0,110
12/16/2019,CLE,29,25,30,29,0,113,TOR,37,29,38,29,0,133
12/18/2019,TOR,30,40,26,16,0,112,DET,29,35,15,20,0,99
12/20/2019,WAS,23,29,33,33,0,118,TOR,40,28,28,26,0,122
12/22/2019,DAL,17,34,35,21,0,107,TOR,20,22,21,47,0,110
12/23/2019,TOR,19,25,35,28,8,115,IND,30,24,24,29,13,120
12/25/2019,BOS,28,27,33,30,0,118,TOR,19,28,22,33,0,102
12/28/2019,TOR,36,23,30,24,0,113,BOS,25,29,25,18,0,97
12/29/2019,OKC,22,25,29,22,0,98,TOR,20,27,33,17,0,97
12/31/2019,CLE,25,18,26,28,0,97,TOR,27,32,27,31,0,117
1/2/2020,TOR,20,19,21,16,0,76,MIA,18,24,21,21,0,84
1/4/2020,TOR,24,24,35,38,0,121,BRK,33,19,28,22,0,102
1/7/2020,POR,15,31,23,32,0,101,TOR,24,32,22,21,0,99
1/8/2020,TOR,29,31,22,18,12,112,CHO,31,24,26,19,10,110
1/12/2020,SAS,21,22,26,36,0,105,TOR,28,23,31,22,0,104
1/15/2020,TOR,38,35,24,33,0,130,OKC,25,30,28,38,0,121
1/17/2020,WAS,26,25,25,35,0,111,TOR,38,27,35,40,0,140
1/18/2020,TOR,32,26,31,33,0,122,MIN,39,23,22,28,0,112
1/20/2020,TOR,36,21,26,39,0,122,ATL,25,35,22,35,0,117
1/22/2020,PHI,35,15,22,23,0,95,TOR,26,24,26,31,0,107
1/24/2020,TOR,20,36,29,33,0,118,NYK,28,25,26,33,0,112
1/26/2020,TOR,37,26,23,24,0,110,SAS,21,30,34,21,0,106
1/28/2020,ATL,23,33,27,31,0,114,TOR,33,35,29,33,0,130
1/30/2020,TOR,31,25,32,27,0,115,CLE,26,26,24,33,0,109
1/31/2020,TOR,30,30,18,27,0,105,DET,20,27,22,23,0,92
2/2/2020,CHI,29,34,22,17,0,102,TOR,32,28,35,34,0,129
2/5/2020,IND,20,43,23,32,0,118,TOR,30,18,34,37,0,119
2/7/2020,TOR,36,28,23,28,0,115,IND,31,32,20,23,0,106
2/8/2020,BRK,36,18,34,30,0,118,TOR,33,33,34,19,0,119
2/10/2020,MIN,36,39,19,32,0,126,TOR,40,34,32,31,0,137
2/12/2020,TOR,19,21,25,26,0,91,BRK,23,29,23,26,0,101
2/21/2020,PHO,23,20,35,23,0,101,TOR,31,36,26,25,0,118
2/23/2020,IND,12,20,23,26,0,81,TOR,34,29,22,42,0,127
2/25/2020,MIL,25,25,34,24,0,108,TOR,27,25,19,26,0,97
2/28/2020,CHO,25,27,21,26,0,99,TOR,23,18,25,30,0,96
3/1/2020,TOR,32,37,27,22,0,118,DEN,40,33,27,33,0,133
10/23/2019,CLE,24,17,24,20,0,85,ORL,28,27,16,23,0,94
10/26/2019,ORL,26,24,25,24,0,99,ATL,23,29,25,26,0,103
10/28/2019,ORL,22,24,21,28,0,95,TOR,31,20,27,26,0,104
10/30/2019,NYK,25,19,23,16,0,83,ORL,22,20,30,23,0,95
11/1/2019,MIL,31,31,26,35,0,123,ORL,27,14,30,20,0,91
11/2/2019,DEN,17,23,29,22,0,91,ORL,26,19,18,24,0,87
11/5/2019,ORL,26,27,26,15,0,94,OKC,31,27,23,21,0,102
11/6/2019,ORL,28,28,23,27,0,106,DAL,25,29,32,21,0,107
11/8/2019,MEM,15,33,30,8,0,86,ORL,27,24,33,34,0,118
11/10/2019,IND,29,22,30,28,0,109,ORL,33,27,17,25,0,102
11/13/2019,PHI,30,23,29,15,0,97,ORL,31,22,27,32,0,112
11/15/2019,SAS,31,25,26,27,0,109,ORL,24,23,32,32,0,111
11/17/2019,WAS,22,30,25,44,0,121,ORL,29,32,27,37,0,125
11/20/2019,ORL,32,19,17,29,0,97,TOR,32,29,18,34,0,113
11/23/2019,ORL,25,20,40,21,0,106,IND,24,31,28,28,0,111
11/25/2019,ORL,31,24,15,18,0,88,DET,23,30,25,25,0,103
11/27/2019,ORL,27,32,28,29,0,116,CLE,27,25,21,31,0,104
11/29/2019,TOR,20,20,26,24,0,90,ORL,23,24,12,24,0,83
12/1/2019,GSW,22,29,20,25,0,96,ORL,26,25,21,28,0,100
12/3/2019,ORL,32,36,29,30,0,127,WAS,26,28,34,32,0,120
12/4/2019,PHO,37,21,28,28,0,114,ORL,31,34,38,25,0,128
12/6/2019,ORL,24,28,16,25,0,93,CLE,25,22,23,17,0,87
12/9/2019,ORL,20,20,33,28,0,101,MIL,31,21,28,30,0,110
12/11/2019,LAL,26,25,18,27,0,96,ORL,9,29,27,22,0,87
12/13/2019,HOU,28,34,34,34,0,130,ORL,22,33,23,29,0,107
12/15/2019,ORL,24,34,41,31,0,130,NOP,30,27,27,35,0,119
12/17/2019,ORL,20,27,24,31,0,102,UTA,26,32,24,27,0,109
12/18/2019,ORL,32,28,16,28,0,104,DEN,27,18,39,29,0,113
12/20/2019,ORL,13,31,31,28,0,103,POR,31,26,36,25,0,118
12/23/2019,CHI,28,26,27,14,0,95,ORL,28,23,32,20,0,103
12/27/2019,PHI,21,26,21,29,0,97,ORL,19,27,25,27,0,98
12/28/2019,ORL,25,21,28,26,0,100,MIL,37,19,22,33,0,111
12/30/2019,ATL,25,22,27,27,0,101,ORL,21,36,15,21,0,93
1/1/2020,ORL,31,31,32,28,0,122,WAS,29,29,25,18,0,101
1/3/2020,MIA,22,22,35,6,0,85,ORL,27,29,28,21,0,105
1/4/2020,UTA,33,19,24,33,0,109,ORL,25,22,28,21,0,96
1/6/2020,BRK,22,17,32,18,0,89,ORL,20,32,23,26,0,101
1/8/2020,WAS,23,29,20,17,0,89,ORL,32,37,28,26,0,123
1/10/2020,ORL,25,23,27,19,0,94,PHO,27,31,19,21,0,98
1/13/2020,ORL,33,32,21,28,0,114,SAC,25,27,33,27,0,112
1/15/2020,ORL,35,30,24,30,0,119,LAL,29,29,30,30,0,118
1/16/2020,ORL,26,22,28,19,0,95,LAC,34,33,24,31,0,122
1/18/2020,ORL,25,27,19,24,0,95,GSW,28,25,29,27,0,109
1/20/2020,ORL,19,32,21,34,0,106,CHO,27,18,20,18,0,83
1/22/2020,OKC,24,36,32,28,0,120,ORL,21,30,38,25,0,114
1/24/2020,BOS,24,29,29,27,0,109,ORL,30,27,20,21,0,98
1/26/2020,LAC,26,28,31,27,0,112,ORL,28,24,20,25,0,97
1/27/2020,ORL,21,27,23,21,0,92,MIA,31,23,31,28,0,113
2/1/2020,MIA,28,29,19,26,0,102,ORL,25,24,18,22,0,89
2/3/2020,ORL,25,31,29,27,0,112,CHO,24,30,23,23,0,100
2/5/2020,ORL,24,32,24,20,0,100,BOS,32,25,30,29,0,116
2/6/2020,ORL,19,28,36,20,0,103,NYK,30,24,22,29,0,105
2/8/2020,MIL,29,33,21,28,0,111,ORL,24,22,25,24,0,95
2/10/2020,ATL,28,33,35,30,0,126,ORL,22,34,37,42,0,135
2/12/2020,DET,20,35,26,27,4,112,ORL,32,27,28,21,8,116
2/21/2020,DAL,34,30,27,31,0,122,ORL,18,34,32,22,0,106
2/24/2020,ORL,22,19,40,34,0,115,BRK,27,27,33,26,0,113
2/26/2020,ORL,23,41,39,27,0,130,ATL,27,37,31,25,0,120
2/28/2020,MIN,35,30,31,29,0,125,ORL,35,34,34,33,0,136
2/29/2020,ORL,27,26,28,32,0,113,SAS,38,23,24,29,0,114
