,date,away_team,away_q1,away_q2,away_q3,away_q4,away_OT,away_final,home_team,home_q1,home_q2,home_q3,home_q4,home_OT,home_final
0,10/25/2016,NYK,18,27,19,24,0,88,CLE,28,20,34,35,0,117
1,10/28/2016,CLE,28,22,21,23,0,94,TOR,23,17,27,24,0,91
2,10/29/2016,ORL,20,25,17,37,0,99,CLE,33,29,18,25,0,105
3,11/1/2016,HOU,35,24,25,36,0,120,CLE,29,34,22,43,0,128
4,11/3/2016,BOS,25,26,32,39,0,122,CLE,36,32,32,28,0,128
5,11/5/2016,CLE,34,23,25,20,0,102,PHI,19,27,34,21,0,101
6,11/8/2016,ATL,20,33,31,26,0,110,CLE,20,22,37,27,0,106
7,11/11/2016,CLE,26,32,26,21,0,105,WAS,31,25,19,19,0,94
8,11/13/2016,CHO,22,32,18,21,0,93,CLE,32,20,19,29,0,100
9,11/15/2016,TOR,25,32,27,33,0,117,CLE,30,31,30,30,0,121
10,11/16/2016,CLE,19,26,23,25,0,93,IND,30,20,30,23,0,103
11,11/18/2016,DET,19,20,17,25,0,81,CLE,30,26,26,22,0,104
12,11/23/2016,POR,31,29,32,33,0,125,CLE,46,35,31,25,0,137
13,11/25/2016,DAL,16,22,17,35,0,90,CLE,36,36,24,32,0,128
14,11/27/2016,CLE,24,28,25,35,0,112,PHI,30,28,23,27,0,108
15,11/29/2016,CLE,32,22,20,27,0,101,MIL,30,28,34,26,0,118
16,12/1/2016,LAC,24,34,27,28,0,113,CLE,28,22,15,29,0,94
17,12/2/2016,CLE,33,27,20,25,0,105,CHI,30,29,29,23,0,111
18,12/5/2016,CLE,30,32,28,26,0,116,TOR,27,34,20,31,0,112
19,12/7/2016,CLE,36,27,29,34,0,126,NYK,26,22,17,29,0,94
20,12/9/2016,MIA,27,19,23,15,0,84,CLE,31,26,30,27,0,114
21,12/10/2016,CHO,26,26,29,24,0,105,CLE,36,31,25,24,0,116
22,12/13/2016,MEM,20,23,15,28,0,86,CLE,32,26,15,30,0,103
23,12/14/2016,CLE,16,20,17,32,0,85,MEM,28,19,27,19,0,93
24,12/17/2016,LAL,31,28,24,25,0,108,CLE,26,36,27,30,0,119
25,12/20/2016,CLE,35,22,27,16,14,114,MIL,27,26,25,22,8,108
26,12/21/2016,MIL,22,32,23,25,0,102,CLE,31,28,33,21,0,113
27,12/23/2016,BRK,15,25,17,42,0,99,CLE,29,37,32,21,0,119
28,12/25/2016,GSW,27,28,32,21,0,108,CLE,25,27,28,29,0,109
29,12/26/2016,CLE,19,25,20,26,0,90,DET,22,28,26,30,0,106
30,12/29/2016,BOS,25,34,24,35,0,118,CLE,32,34,35,23,0,124
31,12/31/2016,CLE,35,36,28,22,0,121,CHO,28,31,23,27,0,109
32,1/2/2017,NOP,22,21,26,13,0,82,CLE,15,29,23,23,0,90
33,1/4/2017,CHI,16,36,31,23,0,106,CLE,23,23,28,20,0,94
34,1/6/2017,CLE,24,26,36,30,0,116,BRK,20,19,29,40,0,108
35,1/8/2017,CLE,41,28,24,27,0,120,PHO,28,25,37,26,0,116
36,1/10/2017,CLE,29,12,25,26,0,92,UTA,29,27,19,25,0,100
37,1/11/2017,CLE,20,21,20,25,0,86,POR,27,22,24,29,0,102
38,1/13/2017,CLE,32,29,23,36,0,120,SAC,15,28,31,34,0,108
39,1/16/2017,CLE,22,27,22,20,0,91,GSW,37,41,17,31,0,126
40,1/19/2017,PHO,21,20,35,27,0,103,CLE,29,30,30,29,0,118
41,1/21/2017,SAS,22,35,27,23,11,118,CLE,33,25,31,18,8,115
42,1/23/2017,CLE,26,24,36,36,0,122,NOP,35,35,24,30,0,124
43,1/25/2017,SAC,22,31,26,25,12,116,CLE,26,21,35,22,8,112
44,1/27/2017,BRK,25,22,26,43,0,116,CLE,27,28,39,30,0,124
45,1/29/2017,OKC,24,21,20,26,0,91,CLE,21,37,22,27,0,107
46,1/30/2017,CLE,29,21,20,27,0,97,DAL,26,29,26,23,0,104
47,2/1/2017,MIN,32,28,19,18,0,97,CLE,36,27,30,32,0,125
48,2/4/2017,CLE,34,30,20,27,0,111,NYK,25,20,23,36,0,104
49,2/6/2017,CLE,26,28,32,34,20,140,WAS,32,25,25,38,15,135
50,2/8/2017,CLE,25,32,40,35,0,132,IND,36,27,18,36,0,117
51,2/9/2017,CLE,21,36,25,27,0,109,OKC,29,26,31,32,0,118
52,2/11/2017,DEN,33,22,23,31,0,109,CLE,28,31,33,33,0,125
53,2/14/2017,CLE,26,43,24,23,0,116,MIN,30,31,32,15,0,108
54,2/15/2017,IND,32,22,26,24,0,104,CLE,28,29,26,30,0,113
55,2/23/2017,NYK,33,18,28,25,0,104,CLE,34,35,18,32,0,119
56,2/25/2017,CHI,23,32,34,28,0,117,CLE,22,34,20,23,0,99
57,2/27/2017,MIL,25,25,23,22,0,95,CLE,27,25,25,25,0,102
58,3/1/2017,CLE,26,24,21,28,0,99,BOS,20,29,25,29,0,103
59,3/3/2017,CLE,39,38,29,29,0,135,ATL,33,27,28,42,0,130
60,3/4/2017,CLE,35,16,24,17,0,92,MIA,35,32,34,19,0,120
61,3/6/2017,MIA,29,33,27,17,0,106,CLE,22,30,19,27,0,98
62,3/9/2017,CLE,29,23,28,21,0,101,DET,22,33,18,33,0,106
63,3/11/2017,CLE,24,35,28,29,0,116,ORL,25,26,28,25,0,104
64,3/12/2017,CLE,26,41,19,26,0,112,HOU,33,25,32,27,0,117
65,3/14/2017,DET,26,22,22,26,0,96,CLE,44,30,30,24,0,128
66,3/16/2017,UTA,20,22,25,16,0,83,CLE,29,15,23,24,0,91
67,3/18/2017,CLE,16,15,27,20,0,78,LAC,14,33,29,32,0,108
68,3/19/2017,CLE,31,24,27,43,0,125,LAL,28,31,33,28,0,120
69,3/22/2017,CLE,31,28,31,23,0,113,DEN,34,39,28,25,0,126
70,3/24/2017,CLE,33,26,31,22,0,112,CHO,31,22,32,20,0,105
71,3/25/2017,WAS,40,31,25,31,0,127,CLE,26,35,30,24,0,115
72,3/27/2017,CLE,18,22,18,16,0,74,SAS,28,36,17,22,0,103
73,3/30/2017,CLE,28,22,21,22,0,93,CHI,22,19,37,21,0,99
74,3/31/2017,PHI,29,23,25,28,0,105,CLE,32,38,34,18,0,122
75,4/2/2017,IND,27,26,24,27,10,130,CLE,26,34,23,21,10,135
76,4/4/2017,ORL,31,24,20,27,0,102,CLE,28,25,43,26,0,122
77,4/5/2017,CLE,19,38,33,24,0,114,BOS,20,22,24,25,0,91
78,4/7/2017,ATL,21,31,31,31,0,114,CLE,19,31,28,22,0,100
79,4/9/2017,CLE,38,27,28,18,14,125,ATL,21,25,21,44,15,126
80,4/10/2017,CLE,37,23,31,17,13,121,MIA,24,32,24,28,16,124
81,4/12/2017,TOR,26,27,22,23,0,98,CLE,21,13,24,25,0,83
82,10/26/2016,BRK,31,27,23,36,0,117,BOS,33,31,33,25,0,122
83,10/27/2016,BOS,20,29,24,26,0,99,CHI,30,27,22,26,0,105
84,10/29/2016,BOS,28,16,27,33,0,104,CHO,19,22,31,26,0,98
85,11/2/2016,CHI,25,27,18,30,0,100,BOS,36,19,26,26,0,107
86,11/6/2016,DEN,42,35,26,20,0,123,BOS,23,29,31,24,0,107
87,11/9/2016,BOS,8,35,26,24,0,93,WAS,34,24,31,29,0,118
88,11/11/2016,NYK,27,24,22,14,0,87,BOS,31,30,25,29,0,115
89,11/12/2016,BOS,24,24,31,26,0,105,IND,31,14,31,23,0,99
90,11/14/2016,BOS,26,25,23,31,0,105,NOP,27,29,28,22,0,106
91,11/16/2016,DAL,17,14,23,29,0,83,BOS,29,10,18,33,0,90
92,11/18/2016,GSW,29,26,31,18,0,104,BOS,27,21,9,31,0,88
93,11/19/2016,BOS,30,20,21,23,0,94,DET,23,24,26,19,0,92
94,11/21/2016,BOS,23,19,26,31,0,99,MIN,21,31,29,12,0,93
95,11/23/2016,BOS,30,21,28,32,0,111,BRK,16,33,17,26,0,92
96,11/25/2016,SAS,22,24,29,34,0,109,BOS,32,16,26,29,0,103
97,11/28/2016,BOS,21,27,35,29,0,112,MIA,19,12,42,31,0,104
98,11/30/2016,DET,31,28,33,29,0,121,BOS,28,25,31,30,0,114
99,12/2/2016,SAC,29,17,26,20,0,92,BOS,29,18,22,28,0,97
100,12/3/2016,BOS,22,23,29,33,0,107,PHI,30,23,21,32,0,106
101,12/5/2016,BOS,17,31,35,23,0,106,HOU,26,32,19,30,0,107
102,12/7/2016,BOS,26,23,36,32,0,117,ORL,27,23,23,14,0,87
103,12/9/2016,TOR,25,17,33,26,0,101,BOS,28,22,18,26,0,94
104,12/11/2016,BOS,24,19,28,25,0,96,OKC,21,18,28,32,0,99
105,12/14/2016,BOS,23,24,26,28,0,101,SAS,32,24,21,31,0,108
106,12/16/2016,CHO,22,28,19,19,0,88,BOS,23,18,28,27,0,96
107,12/18/2016,BOS,37,21,19,28,0,105,MIA,19,22,30,24,0,95
108,12/20/2016,BOS,15,16,31,35,15,112,MEM,22,23,26,26,12,109
109,12/22/2016,BOS,22,29,26,32,0,109,IND,31,9,27,35,0,102
110,12/23/2016,OKC,25,33,30,29,0,117,BOS,28,26,25,33,0,112
111,12/25/2016,BOS,22,34,32,31,0,119,NYK,28,20,34,32,0,114
112,12/27/2016,MEM,24,24,29,26,0,103,BOS,28,28,28,29,0,113
113,12/30/2016,MIA,25,23,30,36,0,114,BOS,25,27,30,35,0,117
114,1/3/2017,UTA,29,16,29,30,0,104,BOS,28,26,31,30,0,115
115,1/6/2017,PHI,23,39,18,26,0,106,BOS,25,26,27,32,0,110
116,1/7/2017,NOP,31,22,20,35,0,108,BOS,28,29,36,24,0,117
117,1/10/2017,BOS,18,37,29,22,0,106,TOR,23,23,34,34,0,114
118,1/11/2017,WAS,35,24,26,23,0,108,BOS,36,19,28,34,0,117
119,1/13/2017,BOS,28,20,30,25,0,103,ATL,18,26,21,36,0,101
120,1/16/2017,CHO,30,23,18,27,0,98,BOS,34,25,21,28,0,108
121,1/18/2017,NYK,31,32,25,29,0,117,BOS,34,20,29,23,0,106
122,1/21/2017,POR,26,30,32,25,14,127,BOS,28,37,21,27,10,123
123,1/24/2017,BOS,24,35,21,28,0,108,WAS,33,33,25,32,0,123
124,1/25/2017,HOU,27,31,28,23,0,109,BOS,24,28,36,32,0,120
125,1/27/2017,ORL,24,24,17,33,0,98,BOS,39,29,36,24,0,128
126,1/28/2017,BOS,42,22,17,21,10,112,MIL,27,26,20,29,6,108
127,1/30/2017,DET,25,21,24,39,0,109,BOS,26,28,25,34,0,113
128,2/1/2017,TOR,30,32,23,19,0,104,BOS,28,23,26,32,0,109
129,2/3/2017,LAL,30,21,23,33,0,107,BOS,29,33,20,31,0,113
130,2/5/2017,LAC,19,28,20,35,0,102,BOS,29,27,25,26,0,107
131,2/8/2017,BOS,28,21,22,21,0,92,SAC,19,30,28,31,0,108
132,2/9/2017,BOS,22,27,28,43,0,120,POR,32,23,21,35,0,111
133,2/11/2017,BOS,33,25,19,35,0,112,UTA,23,21,21,39,0,104
134,2/13/2017,BOS,30,31,22,28,0,111,DAL,28,22,32,16,0,98
135,2/15/2017,PHI,29,32,18,29,0,108,BOS,29,32,26,29,0,116
136,2/16/2017,BOS,25,33,20,25,0,103,CHI,22,30,29,23,0,104
137,2/24/2017,BOS,29,26,22,20,0,97,TOR,18,27,29,33,0,107
138,2/26/2017,BOS,27,27,25,25,0,104,DET,23,27,24,24,0,98
139,2/27/2017,ATL,24,27,33,30,0,114,BOS,24,23,24,27,0,98
140,3/3/2017,BOS,35,35,23,22,0,115,LAL,26,19,33,17,0,95
141,3/5/2017,BOS,22,20,35,29,0,106,PHO,19,30,32,28,0,109
142,3/6/2017,BOS,25,21,25,31,0,102,LAC,22,21,32,41,0,116
143,3/8/2017,BOS,25,21,26,27,0,99,GSW,28,22,24,12,0,86
144,3/10/2017,BOS,25,29,26,19,0,99,DEN,35,30,29,25,0,119
145,3/12/2017,CHI,9,17,31,23,0,80,BOS,22,24,30,24,0,100
146,3/15/2017,MIN,32,28,17,27,0,104,BOS,30,28,27,32,0,117
147,3/17/2017,BOS,21,24,26,27,0,98,BRK,16,21,28,30,0,95
148,3/19/2017,BOS,23,28,28,20,0,99,PHI,25,21,30,29,0,105
149,3/20/2017,WAS,28,19,28,27,0,102,BOS,30,28,34,18,0,110
150,3/22/2017,IND,19,23,32,26,0,100,BOS,21,28,39,21,0,109
151,3/24/2017,PHO,16,27,37,40,0,120,BOS,29,37,31,33,0,130
152,3/26/2017,MIA,27,31,17,33,0,108,BOS,22,31,32,27,0,112
153,3/29/2017,MIL,24,31,25,23,0,103,BOS,24,25,28,23,0,100
154,3/31/2017,ORL,29,35,26,26,0,116,BOS,31,26,35,25,0,117
155,4/2/2017,BOS,34,26,28,22,0,110,NYK,23,24,24,23,0,94
156,4/6/2017,BOS,24,31,34,27,0,116,ATL,32,39,28,24,0,123
157,4/8/2017,BOS,32,39,21,29,0,121,CHO,28,26,32,28,0,114
158,4/10/2017,BRK,13,27,37,28,0,105,BOS,28,30,32,24,0,114
159,4/12/2017,MIL,36,20,22,16,0,94,BOS,25,32,23,32,0,112
160,10/27/2016,WAS,27,29,24,19,0,99,ATL,29,28,24,33,0,114
161,10/30/2016,WAS,22,32,23,23,3,103,MEM,27,31,20,22,12,112
162,11/2/2016,TOR,27,27,30,29,0,113,WAS,29,27,19,28,0,103
163,11/4/2016,ATL,19,16,28,29,0,92,WAS,19,29,23,24,0,95
164,11/5/2016,WAS,24,26,20,16,0,86,ORL,20,20,21,27,0,88
165,11/7/2016,HOU,23,33,28,30,0,114,WAS,30,17,36,23,0,106
166,11/12/2016,WAS,27,29,14,25,0,95,CHI,28,25,28,25,0,106
167,11/16/2016,WAS,15,33,28,26,0,102,PHI,29,30,29,21,0,109
168,11/17/2016,NYK,18,24,23,47,0,112,WAS,24,28,35,32,0,119
169,11/19/2016,MIA,33,27,31,23,0,114,WAS,35,24,23,29,0,111
170,11/21/2016,PHO,20,26,34,21,0,101,WAS,26,24,25,31,0,106
171,11/25/2016,WAS,26,22,24,22,0,94,ORL,14,24,30,23,0,91
172,11/26/2016,SAS,23,31,36,22,0,112,WAS,22,22,32,24,0,100
173,11/28/2016,SAC,19,34,19,20,3,95,WAS,25,25,24,18,9,101
174,11/30/2016,WAS,19,34,31,21,10,115,OKC,32,28,24,21,21,126
175,12/2/2016,WAS,28,32,14,31,0,105,SAS,24,33,23,27,0,107
176,12/5/2016,WAS,29,22,32,35,0,118,BRK,32,34,15,32,0,113
177,12/6/2016,ORL,25,40,31,28,0,124,WAS,24,28,29,35,0,116
178,12/8/2016,DEN,29,23,21,12,0,85,WAS,18,29,28,17,0,92
179,12/10/2016,MIL,32,20,25,28,0,105,WAS,23,29,25,33,0,110
180,12/12/2016,WAS,29,24,29,19,0,101,MIA,28,31,22,31,0,112
181,12/14/2016,CHO,30,24,23,29,0,106,WAS,26,23,38,22,0,109
182,12/16/2016,DET,27,27,23,31,0,108,WAS,27,38,30,27,0,122
183,12/18/2016,LAC,27,28,32,23,0,110,WAS,28,24,33,32,0,117
184,12/19/2016,WAS,36,21,22,26,0,105,IND,29,28,31,19,0,107
185,12/21/2016,WAS,22,33,22,30,0,107,CHI,33,23,21,20,0,97
186,12/23/2016,WAS,29,29,20,18,0,96,MIL,37,36,27,23,0,123
187,12/26/2016,MIL,27,30,27,18,0,102,WAS,28,25,29,25,0,107
188,12/28/2016,IND,25,23,26,31,0,105,WAS,23,35,27,26,0,111
189,12/30/2016,BRK,23,27,27,18,0,95,WAS,31,35,25,27,0,118
190,1/2/2017,WAS,29,24,17,21,0,91,HOU,14,27,37,23,0,101
191,1/3/2017,WAS,29,38,21,17,0,105,DAL,28,33,26,26,0,113
192,1/6/2017,MIN,29,19,37,20,0,105,WAS,32,24,24,32,0,112
193,1/8/2017,WAS,24,25,33,25,0,107,MIL,31,26,21,23,0,101
194,1/10/2017,CHI,36,25,16,22,0,99,WAS,26,23,32,20,0,101
195,1/14/2017,PHI,30,26,15,22,0,93,WAS,21,35,30,23,0,109
196,1/16/2017,POR,21,29,27,24,0,101,WAS,37,38,26,19,0,120
197,1/18/2017,MEM,24,27,26,24,0,101,WAS,30,36,17,21,0,104
198,1/19/2017,WAS,38,28,34,13,0,113,NYK,27,40,19,24,0,110
199,1/21/2017,WAS,26,29,27,30,0,112,DET,30,31,37,15,0,113
200,1/23/2017,WAS,30,30,20,29,0,109,CHO,22,26,26,25,0,99
201,1/27/2017,WAS,37,30,26,19,0,112,ATL,25,20,23,18,0,86
202,1/29/2017,WAS,29,28,17,33,0,107,NOP,23,17,33,21,0,94
203,1/31/2017,NYK,28,26,22,25,0,101,WAS,28,31,32,26,0,117
204,2/2/2017,LAL,29,15,35,29,0,108,WAS,31,27,32,26,0,116
205,2/4/2017,NOP,18,31,34,8,0,91,WAS,24,29,27,25,0,105
206,2/8/2017,WAS,31,28,20,21,14,114,BRK,22,27,23,28,10,110
207,2/10/2017,IND,27,32,22,26,0,107,WAS,33,26,27,26,0,112
208,2/13/2017,OKC,32,22,19,25,0,98,WAS,38,29,34,19,0,120
209,2/16/2017,WAS,34,28,28,21,0,111,IND,27,25,25,21,0,98
210,2/24/2017,WAS,28,21,32,31,0,112,PHI,26,35,34,25,0,120
211,2/26/2017,UTA,24,25,24,29,0,102,WAS,24,15,21,32,0,92
212,2/28/2017,GSW,26,23,36,23,0,108,WAS,40,21,24,27,0,112
213,3/1/2017,WAS,24,38,20,23,0,105,TOR,26,20,14,36,0,96
214,3/3/2017,TOR,35,27,17,35,0,114,WAS,27,26,25,28,0,106
215,3/5/2017,ORL,28,33,29,24,0,114,WAS,25,20,34,36,0,115
216,3/7/2017,WAS,38,30,26,37,0,131,PHO,25,36,31,35,0,127
217,3/8/2017,WAS,35,32,30,26,0,123,DEN,28,22,35,28,0,113
218,3/10/2017,WAS,28,28,26,34,14,130,SAC,32,36,29,19,6,122
219,3/11/2017,WAS,30,19,33,30,13,125,POR,36,34,21,21,12,124
220,3/13/2017,WAS,23,33,24,24,0,104,MIN,41,23,25,30,0,119
221,3/15/2017,DAL,32,21,20,39,0,112,WAS,39,18,23,27,0,107
222,3/17/2017,CHI,23,17,32,35,0,107,WAS,29,30,25,28,0,112
223,3/18/2017,WAS,20,20,21,32,0,93,CHO,19,20,25,34,0,98
224,3/22/2017,ATL,20,26,21,33,0,100,WAS,16,24,27,37,0,104
225,3/24/2017,BRK,22,20,39,27,0,108,WAS,31,32,34,32,0,129
226,3/28/2017,WAS,27,28,27,37,0,119,LAL,27,31,37,13,0,108
227,3/29/2017,WAS,31,32,35,26,0,124,LAC,39,35,36,23,0,133
228,3/31/2017,WAS,19,20,22,27,0,88,UTA,24,18,22,31,0,95
229,4/2/2017,WAS,30,27,31,27,0,115,GSW,35,32,39,33,0,139
230,4/4/2017,CHO,24,39,18,30,0,111,WAS,22,29,36,31,0,118
231,4/6/2017,WAS,33,26,23,24,0,106,NYK,27,24,24,28,0,103
232,4/8/2017,MIA,28,24,26,28,0,106,WAS,29,23,22,29,0,103
233,4/10/2017,WAS,34,21,24,26,0,105,DET,21,21,31,28,0,101
234,4/12/2017,WAS,27,23,27,25,0,102,MIA,23,33,35,19,0,110
235,10/26/2016,CHO,32,24,27,24,0,107,MIL,24,17,25,30,0,96
236,10/28/2016,CHO,21,25,27,24,0,97,MIA,23,34,20,14,0,91
237,11/2/2016,PHI,26,27,20,20,0,93,CHO,26,20,39,24,0,109
238,11/4/2016,CHO,23,20,30,26,0,99,BRK,23,27,20,25,0,95
239,11/7/2016,IND,34,21,23,22,0,100,CHO,43,32,24,23,0,122
240,11/9/2016,UTA,32,26,20,20,0,98,CHO,24,27,25,28,0,104
241,11/11/2016,TOR,28,30,21,34,0,113,CHO,27,17,38,29,0,111
242,11/15/2016,CHO,31,15,36,33,0,115,MIN,30,28,17,33,0,108
243,11/18/2016,ATL,28,17,35,16,0,96,CHO,29,19,27,25,0,100
244,11/19/2016,CHO,23,23,39,23,8,116,NOP,21,26,27,34,13,121
245,11/21/2016,MEM,32,37,15,21,0,105,CHO,22,23,26,19,0,90
246,11/23/2016,SAS,30,29,25,35,0,119,CHO,28,32,24,30,0,114
247,11/25/2016,CHO,28,28,18,30,7,111,NYK,30,22,27,25,9,113
248,11/26/2016,NYK,22,25,24,31,0,102,CHO,38,20,17,32,0,107
249,11/28/2016,CHO,25,31,25,23,0,104,MEM,25,14,21,25,0,85
250,11/29/2016,DET,33,24,27,28,0,112,CHO,25,29,20,15,0,89
251,12/1/2016,DAL,14,27,19,27,0,87,CHO,23,21,24,29,0,97
252,12/3/2016,MIN,19,30,25,32,19,125,CHO,29,23,32,22,14,120
253,12/5/2016,CHO,23,25,27,34,0,109,DAL,23,27,28,23,0,101
254,12/7/2016,DET,24,15,19,19,0,77,CHO,23,15,23,26,0,87
255,12/9/2016,ORL,21,25,24,18,0,88,CHO,20,32,39,18,0,109
256,12/12/2016,CHO,20,23,30,21,0,94,IND,25,20,31,34,0,110
257,12/17/2016,CHO,22,31,27,27,0,107,ATL,22,20,32,25,0,99
258,12/20/2016,LAL,41,32,23,17,0,113,CHO,35,24,35,23,0,117
259,12/23/2016,CHI,26,14,27,24,0,91,CHO,22,26,27,28,0,103
260,12/26/2016,CHO,40,23,25,30,0,118,BRK,31,23,29,37,0,120
261,12/28/2016,CHO,32,30,35,23,0,120,ORL,28,27,13,33,0,101
262,12/29/2016,MIA,19,30,17,16,0,82,CHO,21,21,31,18,0,91
263,1/2/2017,CHO,23,34,28,26,0,111,CHI,25,33,24,36,0,118
264,1/4/2017,OKC,22,33,33,24,0,112,CHO,27,33,27,36,0,123
265,1/5/2017,CHO,26,22,22,44,0,114,DET,37,21,27,30,0,115
266,1/7/2017,CHO,24,26,14,21,0,85,SAS,24,23,26,29,0,102
267,1/10/2017,CHO,26,21,32,35,0,114,HOU,32,35,29,25,0,121
268,1/13/2017,CHO,21,24,26,22,0,93,PHI,26,26,24,26,0,102
269,1/18/2017,POR,26,20,26,13,0,85,CHO,23,31,25,28,0,107
270,1/20/2017,TOR,18,30,15,15,0,78,CHO,26,29,33,25,0,113
271,1/21/2017,BRK,14,32,35,24,0,105,CHO,28,32,21,31,0,112
272,1/25/2017,GSW,29,24,22,38,0,113,CHO,28,19,33,23,0,103
273,1/27/2017,CHO,23,28,36,20,0,107,NYK,29,25,28,28,0,110
274,1/28/2017,SAC,24,28,33,24,0,109,CHO,22,22,33,29,0,106
275,1/31/2017,CHO,23,27,18,30,0,98,POR,28,28,30,29,0,115
276,2/1/2017,CHO,21,35,27,28,0,111,GSW,41,36,31,18,0,126
277,2/4/2017,CHO,28,16,38,16,0,98,UTA,23,29,21,32,0,105
278,2/7/2017,BRK,16,21,35,35,0,107,CHO,24,30,27,30,0,111
279,2/9/2017,HOU,23,27,36,21,0,107,CHO,29,25,22,19,0,95
280,2/11/2017,LAC,29,24,24,30,0,107,CHO,27,24,19,32,0,102
281,2/13/2017,PHI,31,17,32,25,0,105,CHO,22,25,25,27,0,99
282,2/15/2017,CHO,20,21,34,10,0,85,TOR,31,13,14,32,0,90
283,2/23/2017,CHO,28,34,23,15,8,108,DET,23,27,20,30,14,114
284,2/25/2017,CHO,24,27,28,20,0,99,SAC,19,21,18,27,0,85
285,2/26/2017,CHO,24,27,29,33,8,121,LAC,32,27,25,29,11,124
286,2/28/2017,CHO,27,31,22,29,0,109,LAL,31,24,27,22,0,104
287,3/2/2017,CHO,32,26,33,12,0,103,PHO,28,33,33,26,0,120
288,3/4/2017,CHO,31,30,29,22,0,112,DEN,23,29,27,23,0,102
289,3/6/2017,IND,16,21,29,22,0,88,CHO,27,31,16,26,0,100
290,3/8/2017,CHO,22,32,32,15,0,101,MIA,18,36,27,27,0,108
291,3/10/2017,ORL,24,16,22,19,0,81,CHO,37,21,30,33,0,121
292,3/11/2017,NOP,32,27,24,29,13,125,CHO,27,31,20,34,10,122
293,3/13/2017,CHI,36,22,29,28,0,115,CHO,24,24,29,32,0,109
294,3/15/2017,CHO,22,20,16,19,0,77,IND,24,18,33,23,0,98
295,3/20/2017,ATL,19,23,26,22,0,90,CHO,19,32,32,22,0,105
296,3/22/2017,CHO,21,27,29,32,0,109,ORL,27,27,28,20,0,102
297,3/26/2017,PHO,18,29,33,26,0,106,CHO,38,31,29,22,0,120
298,3/28/2017,MIL,35,37,22,24,0,118,CHO,24,26,26,32,0,108
299,3/29/2017,CHO,22,28,16,44,0,110,TOR,19,28,27,32,0,106
300,3/31/2017,DEN,32,24,38,20,0,114,CHO,24,32,30,36,0,122
301,4/2/2017,CHO,31,28,25,29,0,113,OKC,22,32,16,31,0,101
302,4/5/2017,MIA,27,25,34,26,0,112,CHO,23,28,22,26,0,99
303,4/10/2017,CHO,24,22,20,13,0,79,MIL,18,25,18,28,0,89
304,4/11/2017,CHO,26,18,17,15,0,76,ATL,38,25,21,19,0,103
305,10/26/2016,MIN,32,27,16,23,0,98,MEM,29,21,26,26,0,102
306,10/29/2016,MIN,34,31,12,26,0,103,SAC,25,29,31,21,0,106
307,11/1/2016,MEM,16,20,23,21,0,80,MIN,29,33,35,19,0,116
308,11/3/2016,DEN,25,30,33,14,0,102,MIN,37,24,14,24,0,99
309,11/5/2016,MIN,25,28,19,20,0,92,OKC,32,27,31,22,0,112
310,11/8/2016,MIN,33,32,19,26,0,110,BRK,33,33,22,31,0,119
311,11/9/2016,MIN,39,35,23,26,0,123,ORL,17,30,30,30,0,107
312,11/12/2016,LAC,34,26,28,31,0,119,MIN,21,30,22,32,0,105
313,11/13/2016,LAL,27,19,26,27,0,99,MIN,36,33,18,38,0,125
314,11/17/2016,PHI,18,15,25,28,0,86,MIN,27,34,24,25,0,110
315,11/19/2016,MIN,16,23,13,19,0,71,MEM,18,25,22,28,0,93
316,11/23/2016,MIN,26,24,18,28,0,96,NOP,31,22,36,28,0,117
317,11/25/2016,MIN,29,18,20,31,0,98,PHO,27,25,23,10,0,85
318,11/26/2016,MIN,33,15,25,29,0,102,GSW,30,26,34,25,0,115
319,11/28/2016,UTA,22,28,24,38,0,112,MIN,27,18,24,34,0,103
320,11/30/2016,NYK,28,30,23,25,0,106,MIN,31,18,25,30,0,104
321,12/2/2016,MIN,21,31,36,26,0,114,NYK,30,32,36,20,0,118
322,12/6/2016,SAS,19,24,29,33,0,105,MIN,22,24,18,27,0,91
323,12/8/2016,MIN,32,27,30,21,0,110,TOR,22,37,29,36,0,124
324,12/9/2016,DET,25,24,33,35,0,117,MIN,20,23,25,22,0,90
325,12/11/2016,GSW,30,30,18,38,0,116,MIN,27,31,30,20,0,108
326,12/13/2016,MIN,22,30,26,21,0,99,CHI,38,18,19,19,0,94
327,12/17/2016,HOU,28,16,23,28,16,111,MIN,24,33,23,15,14,109
328,12/19/2016,PHO,23,31,33,21,0,108,MIN,29,33,29,24,0,115
329,12/21/2016,MIN,28,21,18,25,0,92,ATL,26,18,25,15,0,84
330,12/23/2016,SAC,25,26,27,31,0,109,MIN,26,29,30,20,0,105
331,12/25/2016,MIN,27,26,22,25,0,100,OKC,23,34,29,26,0,112
332,12/26/2016,ATL,25,20,20,25,0,90,MIN,23,31,35,15,0,104
333,12/28/2016,MIN,31,18,24,30,0,103,DEN,22,27,32,24,0,105
334,12/30/2016,MIL,21,27,23,28,0,99,MIN,34,21,30,31,0,116
335,1/1/2017,POR,24,13,32,26,0,95,MIN,23,26,15,25,0,89
336,1/3/2017,MIN,16,26,26,23,0,91,PHI,29,28,22,14,0,93
337,1/7/2017,UTA,25,22,22,25,0,94,MIN,24,24,32,12,0,92
338,1/9/2017,DAL,19,27,24,22,0,92,MIN,33,21,23,24,0,101
339,1/11/2017,HOU,23,31,23,28,0,105,MIN,30,25,34,30,0,119
340,1/13/2017,OKC,28,22,18,18,0,86,MIN,30,15,29,22,0,96
341,1/15/2017,MIN,25,22,23,17,0,87,DAL,27,29,23,19,0,98
342,1/17/2017,MIN,30,41,19,24,0,114,SAS,30,37,25,30,0,122
343,1/19/2017,MIN,25,19,33,27,0,104,LAC,22,29,28,22,0,101
344,1/22/2017,DEN,29,29,26,24,0,108,MIN,28,34,22,27,0,111
345,1/24/2017,MIN,23,36,28,25,0,112,PHO,27,29,23,32,0,111
346,1/26/2017,IND,25,27,24,33,0,109,MIN,20,26,24,33,0,103
347,1/28/2017,BRK,26,29,23,31,0,109,MIN,33,30,29,37,0,129
348,1/30/2017,ORL,23,28,28,19,7,105,MIN,26,26,28,18,13,111
349,2/3/2017,MIN,18,34,24,32,0,108,DET,24,29,30,33,0,116
350,2/4/2017,MEM,15,33,21,38,0,107,MIN,31,17,19,32,0,99
351,2/6/2017,MIA,40,31,22,22,0,115,MIN,33,24,31,25,0,113
352,2/8/2017,TOR,33,30,25,21,0,109,MIN,25,28,30,29,0,112
353,2/10/2017,NOP,28,33,37,24,0,122,MIN,40,25,24,17,0,106
354,2/12/2017,CHI,17,23,25,24,0,89,MIN,34,23,27,33,0,117
355,2/15/2017,MIN,32,30,23,27,0,112,DEN,31,29,19,20,0,99
356,2/24/2017,DAL,22,18,23,21,0,84,MIN,26,23,22,26,0,97
357,2/25/2017,MIN,28,30,30,42,0,130,HOU,35,31,40,36,0,142
358,2/27/2017,MIN,20,40,17,25,0,102,SAC,25,19,21,23,0,88
359,3/1/2017,MIN,21,30,30,26,0,107,UTA,16,19,18,27,0,80
360,3/4/2017,MIN,26,29,15,13,7,90,SAS,14,29,19,21,14,97
361,3/8/2017,LAC,19,36,13,23,0,91,MIN,31,27,24,25,0,107
362,3/10/2017,GSW,24,29,23,26,0,102,MIN,34,28,26,15,0,103
363,3/11/2017,MIN,19,29,27,20,0,95,MIL,23,25,28,26,0,102
364,3/17/2017,MIN,23,26,32,24,0,105,MIA,27,37,26,33,0,123
365,3/19/2017,MIN,34,20,30,25,0,109,NOP,28,20,40,35,0,123
366,3/21/2017,SAS,25,17,31,27,0,100,MIN,23,28,16,26,0,93
367,3/24/2017,MIN,27,40,21,21,10,119,LAL,26,28,26,29,21,130
368,3/25/2017,MIN,21,25,28,26,0,100,POR,27,33,34,18,0,112
369,3/28/2017,MIN,26,33,28,28,0,115,IND,25,32,33,24,0,114
370,3/30/2017,LAL,37,23,22,22,0,104,MIN,37,30,29,23,0,119
371,4/1/2017,SAC,18,37,36,32,0,123,MIN,31,28,26,32,0,117
372,4/3/2017,POR,23,34,26,26,0,109,MIN,29,20,37,24,0,110
373,4/4/2017,MIN,32,28,26,21,0,107,GSW,32,36,36,17,0,121
374,4/6/2017,MIN,34,27,26,11,0,98,POR,20,33,27,25,0,105
375,4/7/2017,MIN,31,29,28,25,0,113,UTA,29,26,40,25,0,120
376,4/9/2017,MIN,21,30,28,30,0,109,LAL,29,24,25,32,0,110
377,4/11/2017,OKC,33,23,15,29,0,100,MIN,16,27,29,26,0,98
378,4/12/2017,MIN,32,28,21,37,0,118,HOU,33,27,35,28,0,123
379,10/26/2016,DAL,21,31,33,30,6,121,IND,33,26,35,21,15,130
380,10/28/2016,HOU,24,28,25,29,0,106,DAL,24,26,17,31,0,98
381,10/30/2016,DAL,25,28,17,22,0,92,HOU,34,29,17,13,0,93
382,11/2/2016,DAL,14,19,26,22,0,81,UTA,15,26,25,31,0,97
383,11/4/2016,POR,26,29,24,26,0,105,DAL,26,26,24,19,0,95
384,11/6/2016,MIL,27,12,17,18,1,75,DAL,19,28,12,15,12,86
385,11/8/2016,DAL,25,33,25,26,0,109,LAL,27,27,23,20,0,97
386,11/9/2016,DAL,15,21,32,27,0,95,GSW,34,33,17,32,0,116
387,11/14/2016,DAL,23,16,12,26,0,77,NYK,15,21,31,26,0,93
388,11/18/2016,MEM,19,17,20,24,0,80,DAL,19,10,12,23,0,64
389,11/19/2016,DAL,16,29,24,18,0,87,ORL,17,27,22,29,0,95
390,11/21/2016,DAL,28,21,24,18,0,91,SAS,24,24,25,23,0,96
391,11/23/2016,LAC,32,36,25,31,0,124,DAL,26,19,25,34,0,104
392,11/27/2016,NOP,20,22,18,21,0,81,DAL,26,18,16,31,0,91
393,11/30/2016,SAS,21,22,18,33,0,94,DAL,17,23,26,21,0,87
394,12/3/2016,CHI,18,27,21,16,0,82,DAL,29,28,25,25,0,107
395,12/7/2016,SAC,26,30,29,35,0,120,DAL,23,29,12,25,0,89
396,12/9/2016,IND,27,25,25,26,0,103,DAL,25,29,31,26,0,111
397,12/10/2016,DAL,27,22,20,18,0,87,HOU,36,24,26,23,0,109
398,12/12/2016,DEN,19,24,24,25,0,92,DAL,27,38,27,20,0,112
399,12/14/2016,DET,17,26,17,35,0,95,DAL,20,23,21,21,0,85
400,12/16/2016,DAL,29,29,19,23,0,100,UTA,33,31,26,13,0,103
401,12/18/2016,SAC,21,23,14,21,0,79,DAL,28,27,21,23,0,99
402,12/19/2016,DAL,31,27,27,22,0,107,DEN,28,32,33,24,0,117
403,12/21/2016,DAL,30,32,19,15,0,96,POR,20,18,33,24,0,95
404,12/23/2016,DAL,21,29,18,22,0,90,LAC,24,27,21,16,0,88
405,12/26/2016,DAL,20,33,24,27,0,104,NOP,25,30,30,26,0,111
406,12/27/2016,HOU,31,35,32,25,0,123,DAL,31,16,27,33,0,107
407,12/29/2016,DAL,26,24,31,20,0,101,LAL,27,30,13,19,0,89
408,12/30/2016,DAL,29,19,21,30,0,99,GSW,29,30,32,17,0,108
409,1/5/2017,PHO,19,22,29,32,0,102,DAL,22,23,27,23,0,95
410,1/7/2017,ATL,22,23,21,31,0,97,DAL,20,22,17,23,0,82
411,1/12/2017,DAL,32,25,31,25,0,113,PHO,29,30,17,32,0,108
412,1/17/2017,DAL,24,30,22,23,0,99,CHI,28,19,27,24,0,98
413,1/19/2017,DAL,22,31,20,22,0,95,MIA,29,15,26,29,0,99
414,1/20/2017,UTA,19,27,26,26,14,112,DAL,22,19,27,30,9,107
415,1/22/2017,LAL,22,11,22,18,0,73,DAL,29,38,23,32,0,122
416,1/25/2017,NYK,25,26,22,22,0,95,DAL,30,22,26,25,0,103
417,1/26/2017,DAL,26,29,18,25,0,98,OKC,23,30,34,22,0,109
418,1/29/2017,DAL,27,22,28,28,0,105,SAS,28,31,22,20,0,101
419,2/1/2017,PHI,23,24,22,26,0,95,DAL,20,30,31,32,0,113
420,2/3/2017,DAL,35,25,24,24,0,108,POR,22,25,29,28,0,104
421,2/6/2017,DAL,24,13,30,20,0,87,DEN,29,30,23,28,0,110
422,2/7/2017,POR,32,32,22,28,0,114,DAL,27,26,29,31,0,113
423,2/9/2017,UTA,23,31,24,22,5,105,DAL,20,22,26,32,12,112
424,2/11/2017,ORL,23,12,17,28,0,80,DAL,29,32,23,28,0,112
425,2/15/2017,DAL,17,18,28,28,0,91,DET,27,35,16,20,0,98
426,2/25/2017,NOP,30,19,14,20,0,83,DAL,24,23,20,29,0,96
427,2/27/2017,MIA,31,23,15,20,0,89,DAL,22,33,23,18,0,96
428,3/1/2017,DAL,22,30,24,19,0,95,ATL,27,36,18,19,0,100
429,3/3/2017,MEM,22,28,22,28,0,100,DAL,20,31,28,25,0,104
430,3/5/2017,OKC,27,23,21,18,0,89,DAL,28,32,28,16,0,104
431,3/7/2017,LAL,29,23,22,37,0,111,DAL,38,32,33,19,0,122
432,3/10/2017,BRK,26,23,24,23,0,96,DAL,23,23,28,31,0,105
433,3/11/2017,PHO,25,20,27,28,0,100,DAL,24,23,22,29,0,98
434,3/13/2017,DAL,26,20,20,12,0,78,TOR,25,25,29,21,0,100
435,3/17/2017,DAL,23,17,16,18,0,74,PHI,21,30,36,29,0,116
436,3/19/2017,DAL,32,25,25,29,0,111,BRK,26,17,29,32,0,104
437,3/21/2017,GSW,28,34,29,21,0,112,DAL,30,20,21,16,0,87
438,3/23/2017,LAC,24,30,21,20,0,95,DAL,29,19,29,20,0,97
439,3/25/2017,TOR,30,24,20,20,0,94,DAL,22,22,20,22,0,86
440,3/27/2017,OKC,25,10,22,35,0,92,DAL,26,24,19,22,0,91
441,3/29/2017,DAL,23,28,32,35,0,118,NOP,27,36,26,32,0,121
442,3/31/2017,DAL,19,15,28,28,0,90,MEM,21,34,18,26,0,99
443,4/2/2017,DAL,31,22,22,34,0,109,MIL,28,25,25,27,0,105
444,4/4/2017,DAL,17,21,31,18,0,87,SAC,22,14,32,30,0,98
445,4/5/2017,DAL,24,25,24,28,0,101,LAC,35,27,28,22,0,112
446,4/7/2017,SAS,21,29,25,27,0,102,DAL,26,35,8,20,0,89
447,4/9/2017,DAL,29,36,20,26,0,111,PHO,40,28,36,20,0,124
448,4/11/2017,DEN,23,34,26,26,0,109,DAL,26,18,31,16,0,91
449,4/12/2017,DAL,22,24,24,30,0,100,MEM,27,28,19,19,0,93
450,10/29/2016,BRK,18,23,32,35,0,108,MIL,24,22,34,30,0,110
451,10/30/2016,MIL,21,18,26,18,0,83,DET,24,26,25,23,0,98
452,11/1/2016,MIL,29,34,21,33,0,117,NOP,32,22,32,27,0,113
453,11/3/2016,IND,30,27,22,28,0,107,MIL,29,34,27,35,0,125
454,11/5/2016,SAC,24,24,15,28,0,91,MIL,34,27,29,27,0,117
455,11/10/2016,NOP,26,35,27,24,0,112,MIL,27,27,27,25,0,106
456,11/12/2016,MEM,19,20,31,26,0,96,MIL,24,20,31,31,0,106
457,11/16/2016,MIL,26,9,35,30,0,100,ATL,21,31,32,23,0,107
458,11/17/2016,MIL,27,21,14,11,0,73,MIA,21,27,19,29,0,96
459,11/19/2016,GSW,28,41,34,21,0,124,MIL,37,29,26,29,0,121
460,11/21/2016,ORL,27,17,30,15,0,89,MIL,20,29,20,24,0,93
461,11/25/2016,TOR,27,20,26,32,0,105,MIL,24,18,25,32,0,99
462,11/27/2016,MIL,36,22,21,25,0,104,ORL,29,23,20,24,0,96
463,12/1/2016,MIL,27,25,38,21,0,111,BRK,26,25,27,15,0,93
464,12/3/2016,BRK,22,18,32,31,0,103,MIL,25,25,25,37,0,112
465,12/5/2016,SAS,26,9,36,26,0,97,MIL,24,24,25,23,0,96
466,12/7/2016,POR,28,30,18,31,0,107,MIL,28,23,34,30,0,115
467,12/9/2016,ATL,23,21,40,30,0,114,MIL,30,34,28,18,0,110
468,12/12/2016,MIL,23,26,33,18,0,100,TOR,33,36,23,30,0,122
469,12/15/2016,CHI,18,27,21,31,0,97,MIL,30,34,24,20,0,108
470,12/16/2016,MIL,34,22,18,21,0,95,CHI,15,22,15,17,0,69
471,12/28/2016,MIL,31,31,28,29,0,119,DET,28,26,21,19,0,94
472,12/31/2016,MIL,22,27,31,36,0,116,CHI,27,24,25,20,0,96
473,1/2/2017,OKC,30,26,16,22,0,94,MIL,22,28,29,19,0,98
474,1/4/2017,MIL,27,25,21,32,0,105,NYK,25,27,35,17,0,104
475,1/6/2017,NYK,32,21,30,33,0,116,MIL,33,32,31,15,0,111
476,1/10/2017,MIL,23,30,30,26,0,109,SAS,23,36,30,18,0,107
477,1/13/2017,MIA,30,18,26,34,0,108,MIL,42,23,26,25,0,116
478,1/15/2017,MIL,36,17,30,15,0,98,ATL,36,24,28,23,0,111
479,1/16/2017,PHI,24,22,35,32,0,113,MIL,24,30,24,26,0,104
480,1/18/2017,MIL,27,12,26,27,0,92,HOU,22,30,27,32,0,111
481,1/20/2017,MIL,23,32,19,22,0,96,ORL,25,34,29,24,0,112
482,1/21/2017,MIL,22,21,28,26,0,97,MIA,25,28,29,27,0,109
483,1/23/2017,HOU,33,31,27,23,0,114,MIL,33,35,25,34,0,127
484,1/25/2017,PHI,33,39,16,26,0,114,MIL,39,19,24,27,0,109
485,1/27/2017,MIL,19,20,31,16,0,86,TOR,36,17,24,25,0,102
486,2/1/2017,MIL,27,16,18,27,0,88,UTA,30,31,19,24,0,104
487,2/3/2017,MIL,31,22,36,28,0,117,DEN,31,39,28,23,0,121
488,2/4/2017,MIL,45,29,27,36,0,137,PHO,25,41,23,23,0,112
489,2/8/2017,MIA,28,27,26,25,0,106,MIL,15,29,19,25,0,88
490,2/10/2017,LAL,47,29,27,19,0,122,MIL,30,25,29,30,0,114
491,2/11/2017,MIL,29,33,26,28,0,116,IND,22,30,22,26,0,100
492,2/13/2017,DET,19,15,27,28,0,89,MIL,23,28,26,25,0,102
493,2/15/2017,MIL,39,23,33,34,0,129,BRK,33,27,22,43,0,125
494,2/24/2017,UTA,36,23,28,22,0,109,MIL,27,19,29,20,0,95
495,2/26/2017,PHO,23,24,26,23,0,96,MIL,21,21,35,23,0,100
496,3/1/2017,DEN,32,31,23,24,0,110,MIL,15,22,29,32,0,98
497,3/3/2017,LAC,19,28,29,25,0,101,MIL,34,32,19,27,0,112
498,3/4/2017,TOR,19,23,25,27,0,94,MIL,12,41,27,21,0,101
499,3/6/2017,MIL,27,33,31,21,0,112,PHI,19,24,25,30,0,98
500,3/8/2017,NYK,30,26,17,20,0,93,MIL,32,23,21,28,0,104
501,3/10/2017,IND,27,23,18,17,0,85,MIL,23,22,29,25,0,99
502,3/13/2017,MIL,24,27,23,19,0,93,MEM,30,31,24,28,0,113
503,3/15/2017,MIL,28,18,21,30,0,97,LAC,20,26,23,27,0,96
504,3/17/2017,MIL,31,30,23,23,0,107,LAL,24,22,31,26,0,103
505,3/18/2017,MIL,29,15,26,22,0,92,GSW,27,36,31,23,0,117
506,3/21/2017,MIL,18,30,19,26,0,93,POR,21,14,28,27,0,90
507,3/22/2017,MIL,25,44,21,26,0,116,SAC,24,26,25,23,0,98
508,3/24/2017,ATL,21,22,31,23,0,97,MIL,29,16,27,28,0,100
509,3/26/2017,CHI,29,27,35,18,0,109,MIL,31,24,24,15,0,94
510,3/31/2017,DET,22,26,25,22,10,105,MIL,35,21,15,24,13,108
511,4/4/2017,MIL,20,19,20,20,0,79,OKC,28,35,26,21,0,110
512,4/6/2017,MIL,21,29,23,16,0,89,IND,25,31,29,19,0,104
513,4/8/2017,MIL,23,19,25,23,0,90,PHI,21,27,12,22,0,82
514,10/26/2016,OKC,23,28,18,34,0,103,PHI,24,27,24,22,0,97
515,10/29/2016,ATL,29,24,21,30,0,104,PHI,24,15,19,14,0,72
516,11/1/2016,ORL,24,19,41,19,0,103,PHI,29,28,30,14,0,101
517,11/7/2016,UTA,30,22,25,32,0,109,PHI,24,19,18,23,0,84
518,11/9/2016,PHI,26,34,24,25,6,115,IND,31,23,30,25,13,122
519,11/11/2016,IND,27,25,20,28,5,105,PHI,21,30,25,24,9,109
520,11/12/2016,PHI,27,21,30,18,0,96,ATL,23,36,28,30,0,117
521,11/14/2016,PHI,26,26,16,20,0,88,HOU,38,27,28,22,0,115
522,11/19/2016,PHO,19,29,27,30,0,105,PHI,32,26,34,28,0,120
523,11/21/2016,MIA,30,15,31,18,0,94,PHI,24,22,32,23,0,101
524,11/23/2016,MEM,20,23,20,23,5,104,PHI,26,25,20,15,5,99
525,11/25/2016,CHI,23,34,33,15,0,105,PHI,19,28,17,25,0,89
526,11/28/2016,PHI,26,23,22,24,0,95,TOR,33,27,31,31,0,122
527,12/2/2016,ORL,21,29,32,23,0,105,PHI,14,28,19,27,0,88
528,12/5/2016,DEN,18,33,23,32,0,106,PHI,27,26,17,28,0,98
529,12/6/2016,PHI,20,23,34,14,0,91,MEM,28,19,29,20,0,96
530,12/8/2016,PHI,26,26,19,28,0,99,NOP,31,26,12,19,0,88
531,12/11/2016,PHI,32,26,22,17,0,97,DET,12,23,29,15,0,79
532,12/14/2016,TOR,22,38,32,31,0,123,PHI,25,29,20,40,0,114
533,12/16/2016,LAL,30,23,21,26,0,100,PHI,18,22,24,25,0,89
534,12/18/2016,BRK,32,25,29,21,0,107,PHI,30,24,29,25,0,108
535,12/20/2016,NOP,15,42,27,24,0,108,PHI,23,21,25,24,0,93
536,12/23/2016,PHI,31,35,19,31,0,116,PHO,24,29,28,42,0,123
537,12/26/2016,PHI,23,24,30,23,0,100,SAC,24,27,19,32,0,102
538,12/29/2016,PHI,24,27,23,9,0,83,UTA,22,27,21,30,0,100
539,12/30/2016,PHI,30,30,31,33,0,124,DEN,28,32,27,35,0,122
540,1/8/2017,PHI,24,22,32,27,0,105,BRK,27,30,16,22,0,95
541,1/11/2017,NYK,32,20,23,22,0,97,PHI,27,20,24,27,0,98
542,1/18/2017,TOR,21,23,21,24,0,89,PHI,25,21,22,26,0,94
543,1/20/2017,POR,33,23,15,21,0,92,PHI,22,21,27,23,0,93
544,1/21/2017,PHI,25,29,23,16,0,93,ATL,25,37,28,20,0,110
545,1/24/2017,LAC,29,39,21,21,0,110,PHI,27,32,30,32,0,121
546,1/27/2017,HOU,31,30,33,29,0,123,PHI,28,33,21,36,0,118
547,1/29/2017,PHI,23,34,30,21,0,108,CHI,37,30,29,25,0,121
548,1/30/2017,SAC,35,20,30,34,0,119,PHI,21,27,42,32,0,122
549,2/2/2017,PHI,21,32,20,13,0,86,SAS,24,24,31,23,0,102
550,2/4/2017,PHI,17,35,23,27,0,102,MIA,32,32,36,25,0,125
551,2/6/2017,PHI,27,19,21,29,0,96,DET,24,31,34,24,0,113
552,2/8/2017,SAS,29,29,24,29,0,111,PHI,23,28,24,28,0,103
553,2/9/2017,PHI,20,35,30,27,0,112,ORL,25,23,36,27,0,111
554,2/11/2017,MIA,27,21,28,33,0,109,PHI,27,27,30,33,0,117
555,2/25/2017,PHI,25,25,25,34,0,109,NYK,31,29,26,24,0,110
556,2/27/2017,GSW,32,27,34,26,0,119,PHI,31,25,24,28,0,108
557,3/1/2017,PHI,27,17,30,24,0,98,MIA,37,27,24,37,0,125
558,3/3/2017,NYK,35,18,28,21,0,102,PHI,29,34,16,26,0,105
559,3/4/2017,DET,33,34,39,30,0,136,PHI,25,27,30,24,0,106
560,3/9/2017,PHI,17,35,26,19,11,108,POR,27,30,19,21,17,114
561,3/11/2017,PHI,30,27,22,21,0,100,LAC,32,24,19,37,0,112
562,3/12/2017,PHI,32,33,28,25,0,118,LAL,27,38,20,31,0,116
563,3/14/2017,PHI,34,25,31,14,0,104,GSW,35,23,20,28,0,106
564,3/20/2017,PHI,26,30,27,15,11,109,ORL,25,16,33,24,14,112
565,3/22/2017,PHI,22,28,20,27,0,97,OKC,29,34,32,27,0,122
566,3/24/2017,PHI,24,35,34,24,0,117,CHI,28,18,25,36,0,107
567,3/26/2017,PHI,18,27,24,25,0,94,IND,27,24,30,26,0,107
568,3/28/2017,PHI,31,27,21,27,0,106,BRK,24,33,21,23,0,101
569,3/29/2017,ATL,25,27,27,20,0,99,PHI,18,25,27,22,0,92
570,4/2/2017,PHI,29,20,27,29,0,105,TOR,28,31,27,27,0,113
571,4/4/2017,BRK,40,41,30,30,0,141,PHI,27,26,24,41,0,118
572,4/6/2017,CHI,27,26,27,22,0,102,PHI,17,30,20,23,0,90
573,4/10/2017,IND,35,29,26,30,0,120,PHI,20,34,25,32,0,111
574,4/12/2017,PHI,22,37,28,26,0,113,NYK,25,31,22,36,0,114
575,10/26/2016,SAC,30,27,27,29,0,113,PHO,19,19,29,27,0,94
576,10/28/2016,PHO,40,13,30,19,8,110,OKC,25,24,28,25,11,113
577,10/30/2016,GSW,22,33,26,25,0,106,PHO,30,27,21,22,0,100
578,10/31/2016,PHO,24,12,34,28,0,98,LAC,24,24,34,34,0,116
579,11/2/2016,POR,28,25,20,30,12,115,PHO,28,29,19,27,15,118
580,11/4/2016,PHO,30,28,23,21,10,112,NOP,29,32,18,23,9,111
581,11/6/2016,PHO,15,28,33,32,0,108,LAL,23,31,29,36,0,119
582,11/8/2016,PHO,25,30,27,39,0,121,POR,42,21,26,35,0,124
583,11/9/2016,DET,28,23,25,24,0,100,PHO,19,35,27,26,0,107
584,11/12/2016,BRK,23,35,32,32,0,122,PHO,21,24,38,21,0,104
585,11/13/2016,PHO,32,27,33,28,0,120,GSW,28,34,37,34,0,133
586,11/16/2016,PHO,17,26,33,28,0,104,DEN,28,33,28,31,0,120
587,11/18/2016,PHO,27,30,32,27,0,116,IND,18,31,33,14,0,96
588,11/23/2016,PHO,24,22,22,24,0,92,ORL,22,22,22,21,0,87
589,11/27/2016,DEN,29,34,23,34,0,120,PHO,28,15,36,35,0,114
590,11/30/2016,ATL,27,21,27,32,0,107,PHO,36,14,27,32,0,109
591,12/3/2016,PHO,30,27,27,25,0,109,GSW,37,29,42,30,0,138
592,12/6/2016,PHO,19,26,30,30,0,105,UTA,33,32,29,18,0,112
593,12/7/2016,IND,23,26,33,27,0,109,PHO,22,31,27,14,0,94
594,12/9/2016,PHO,32,30,27,30,0,119,LAL,26,26,28,35,0,115
595,12/11/2016,NOP,25,26,25,34,10,120,PHO,31,27,24,28,9,119
596,12/13/2016,NYK,25,21,27,28,10,111,PHO,31,23,31,16,12,113
597,12/15/2016,SAS,23,28,23,33,0,107,PHO,20,23,28,21,0,92
598,12/17/2016,PHO,20,19,30,32,0,101,OKC,30,24,35,25,0,114
599,12/21/2016,HOU,30,31,30,34,0,125,PHO,26,29,29,27,0,111
600,12/26/2016,PHO,23,20,37,35,0,115,HOU,39,30,38,24,0,131
601,12/28/2016,PHO,27,37,18,16,0,98,SAS,30,28,31,30,0,119
602,12/29/2016,TOR,18,22,22,29,0,91,PHO,16,26,34,23,0,99
603,12/31/2016,PHO,29,22,20,15,0,86,UTA,29,26,21,15,0,91
604,1/2/2017,PHO,26,32,18,22,0,98,LAC,27,37,25,20,0,109
605,1/3/2017,MIA,29,23,14,24,0,90,PHO,28,28,27,16,0,99
606,1/14/2017,SAS,25,33,27,20,0,105,PHO,25,26,29,28,0,108
607,1/16/2017,UTA,24,23,32,27,0,106,PHO,28,25,27,21,0,101
608,1/21/2017,PHO,30,31,29,17,0,107,NYK,33,22,35,15,0,105
609,1/22/2017,PHO,28,29,25,33,0,115,TOR,31,29,25,18,0,103
610,1/26/2017,PHO,29,32,31,28,0,120,DEN,35,22,39,31,0,127
611,1/28/2017,DEN,21,38,36,28,0,123,PHO,33,28,22,29,0,112
612,1/30/2017,MEM,31,28,29,27,0,115,PHO,28,20,22,26,0,96
613,2/1/2017,LAC,38,24,30,32,0,124,PHO,31,28,29,26,0,114
614,2/3/2017,PHO,15,34,30,26,0,105,SAC,21,28,30,24,0,103
615,2/6/2017,PHO,21,21,32,32,0,106,NOP,29,18,30,34,0,111
616,2/8/2017,PHO,15,23,27,26,0,91,MEM,24,22,33,31,0,110
617,2/10/2017,CHI,26,17,33,21,0,97,PHO,28,28,30,29,0,115
618,2/11/2017,PHO,24,29,24,25,0,102,HOU,38,39,34,22,0,133
619,2/13/2017,NOP,29,24,24,33,0,110,PHO,28,30,22,28,0,108
620,2/15/2017,LAL,15,33,28,25,0,101,PHO,32,36,34,35,0,137
621,2/24/2017,PHO,25,29,25,29,13,121,CHI,24,28,28,28,20,128
622,2/28/2017,PHO,27,29,29,27,0,112,MEM,25,30,38,37,0,130
623,3/3/2017,OKC,28,27,24,32,0,111,PHO,23,35,29,31,0,118
624,3/9/2017,LAL,32,29,29,32,0,122,PHO,33,30,18,29,0,110
625,3/12/2017,POR,33,33,16,28,0,110,PHO,18,32,29,22,0,101
626,3/15/2017,SAC,22,26,26,33,0,107,PHO,29,18,28,26,0,101
627,3/17/2017,ORL,30,30,24,25,0,109,PHO,22,36,27,18,0,103
628,3/19/2017,PHO,23,26,26,20,0,95,DET,24,23,30,35,0,112
629,3/21/2017,PHO,26,20,17,34,0,97,MIA,23,36,25,28,0,112
630,3/23/2017,PHO,32,18,15,33,0,98,BRK,22,30,32,42,0,126
631,3/28/2017,PHO,12,32,24,23,0,91,ATL,27,20,24,24,0,95
632,3/30/2017,LAC,31,36,26,31,0,124,PHO,35,24,33,26,0,118
633,4/1/2017,PHO,21,32,34,30,0,117,POR,37,26,34,33,0,130
634,4/2/2017,HOU,31,28,31,33,0,123,PHO,21,33,29,33,0,116
635,4/5/2017,GSW,41,17,33,29,0,120,PHO,18,34,26,33,0,111
636,4/7/2017,OKC,19,29,24,27,0,99,PHO,32,39,24,25,0,120
637,4/11/2017,PHO,25,14,38,27,0,104,SAC,28,30,39,32,0,129
638,10/26/2016,HOU,38,33,25,18,0,114,LAL,38,25,27,30,0,120
639,10/28/2016,LAL,27,16,22,24,0,89,UTA,28,20,17,31,0,96
640,10/30/2016,LAL,24,22,25,25,0,96,OKC,30,28,19,36,0,113
641,11/1/2016,LAL,18,33,28,29,0,108,IND,27,35,22,31,0,115
642,11/2/2016,LAL,28,23,39,33,0,123,ATL,37,23,34,22,0,116
643,11/4/2016,GSW,15,34,33,15,0,97,LAL,24,41,28,24,0,117
644,11/10/2016,LAL,16,29,25,31,0,101,SAC,30,25,18,18,0,91
645,11/12/2016,LAL,30,25,29,42,0,126,NOP,26,30,15,28,0,99
646,11/15/2016,BRK,29,22,34,33,0,118,LAL,27,29,37,32,0,125
647,11/18/2016,SAS,26,26,39,25,0,116,LAL,16,36,24,31,0,107
648,11/20/2016,CHI,30,32,28,28,0,118,LAL,30,31,24,25,0,110
649,11/22/2016,OKC,16,32,26,35,0,109,LAL,29,20,31,31,0,111
650,11/23/2016,LAL,26,23,29,28,0,106,GSW,41,39,26,43,0,149
651,11/25/2016,GSW,30,23,27,29,0,109,LAL,20,23,21,21,0,85
652,11/27/2016,ATL,32,16,29,17,0,94,LAL,21,35,28,25,0,109
653,11/29/2016,LAL,22,19,22,25,0,88,NOP,33,32,24,16,0,105
654,11/30/2016,LAL,17,30,23,26,0,96,CHI,28,19,26,17,0,90
655,12/2/2016,LAL,22,26,14,18,0,80,TOR,28,41,15,29,0,113
656,12/3/2016,LAL,25,37,20,18,0,100,MEM,25,29,28,21,0,103
657,12/5/2016,UTA,26,31,32,18,0,107,LAL,26,27,21,27,0,101
658,12/7/2016,LAL,27,28,22,18,0,95,HOU,43,24,39,28,0,134
659,12/11/2016,NYK,32,25,27,34,0,118,LAL,30,26,19,37,0,112
660,12/12/2016,LAL,24,34,13,21,0,92,SAC,31,18,39,28,0,116
661,12/14/2016,LAL,30,13,33,21,0,97,BRK,27,25,23,32,0,107
662,12/22/2016,LAL,25,35,20,27,0,107,MIA,17,36,29,33,0,115
663,12/23/2016,LAL,14,26,29,21,0,90,ORL,30,27,29,23,0,109
664,12/25/2016,LAC,31,27,16,28,0,102,LAL,27,28,34,22,0,111
665,12/27/2016,UTA,28,20,24,30,0,102,LAL,25,27,22,26,0,100
666,1/1/2017,TOR,27,31,27,38,0,123,LAL,33,24,26,31,0,114
667,1/3/2017,MEM,20,28,29,25,0,102,LAL,22,35,34,25,0,116
668,1/5/2017,LAL,24,38,22,25,0,109,POR,29,24,31,34,0,118
669,1/6/2017,MIA,23,33,23,21,0,100,LAL,32,26,32,37,0,127
670,1/8/2017,ORL,34,26,9,26,0,95,LAL,40,22,19,30,0,111
671,1/10/2017,POR,25,30,23,30,0,108,LAL,26,31,12,18,0,87
672,1/12/2017,LAL,24,30,21,19,0,94,SAS,36,36,34,28,0,134
673,1/14/2017,LAL,15,24,29,29,0,97,LAC,26,32,26,29,0,113
674,1/15/2017,DET,23,36,16,27,0,102,LAL,31,26,15,25,0,97
675,1/17/2017,DEN,40,26,35,26,0,127,LAL,26,28,30,37,0,121
676,1/20/2017,IND,24,29,22,20,0,95,LAL,27,24,35,22,0,108
677,1/25/2017,LAL,31,27,17,23,0,98,POR,30,29,24,22,0,105
678,1/26/2017,LAL,16,25,19,28,0,88,UTA,23,21,26,26,0,96
679,1/31/2017,DEN,30,29,17,40,0,116,LAL,30,24,27,39,0,120
680,2/6/2017,LAL,29,32,36,24,0,121,NYK,19,26,28,34,0,107
681,2/8/2017,LAL,25,25,20,32,0,102,DET,25,31,36,29,0,121
682,2/14/2017,SAC,29,14,27,27,0,97,LAL,23,18,23,32,0,96
683,2/24/2017,LAL,23,28,19,23,0,93,OKC,29,29,28,24,0,110
684,2/26/2017,SAS,36,25,35,23,0,119,LAL,20,21,29,28,0,98
685,3/5/2017,NOP,26,29,28,22,0,105,LAL,20,39,14,24,0,97
686,3/13/2017,LAL,23,20,33,25,0,101,DEN,35,32,26,36,0,129
687,3/15/2017,LAL,26,26,23,25,0,100,HOU,37,29,27,46,0,139
688,3/21/2017,LAC,33,37,38,25,0,133,LAL,24,16,34,35,0,109
689,3/26/2017,POR,22,18,37,20,0,97,LAL,17,15,24,25,0,81
690,4/1/2017,LAL,22,28,22,32,0,104,LAC,28,27,38,22,0,115
691,4/2/2017,MEM,27,22,31,23,0,103,LAL,22,28,29,29,0,108
692,4/5/2017,LAL,31,22,23,26,0,102,SAS,14,27,29,25,0,95
693,4/7/2017,SAC,31,14,25,24,0,94,LAL,18,26,25,29,0,98
694,4/11/2017,NOP,25,28,20,23,0,96,LAL,26,31,28,23,0,108
695,4/12/2017,LAL,28,22,20,24,0,94,GSW,43,21,29,16,0,109
696,10/25/2016,UTA,26,20,37,21,0,104,POR,26,28,23,36,0,113
697,10/30/2016,UTA,22,13,21,19,0,75,LAC,19,23,27,19,0,88
698,11/1/2016,UTA,38,16,19,33,0,106,SAS,28,22,21,20,0,91
699,11/4/2016,SAS,27,26,29,18,0,100,UTA,17,24,25,20,0,86
700,11/6/2016,UTA,20,29,29,36,0,114,NYK,30,24,26,29,0,109
701,11/11/2016,UTA,23,19,18,27,0,87,ORL,17,21,26,10,0,74
702,11/12/2016,UTA,23,29,24,26,0,102,MIA,21,26,12,32,0,91
703,11/14/2016,MEM,33,23,17,29,0,102,UTA,25,23,22,26,0,96
704,11/17/2016,CHI,25,16,25,19,0,85,UTA,26,17,15,19,0,77
705,11/19/2016,UTA,22,22,26,32,0,102,HOU,28,27,26,30,0,111
706,11/20/2016,UTA,14,27,22,28,0,91,DEN,24,29,23,29,0,105
707,11/23/2016,DEN,27,20,14,22,0,83,UTA,36,17,31,24,0,108
708,11/25/2016,ATL,23,11,14,20,0,68,UTA,24,24,13,34,0,95
709,11/29/2016,HOU,29,21,23,28,0,101,UTA,38,24,23,35,0,120
710,12/1/2016,MIA,26,26,31,28,0,111,UTA,27,21,29,33,0,110
711,12/3/2016,DEN,21,26,16,35,0,98,UTA,24,25,33,23,0,105
712,12/8/2016,GSW,35,30,17,24,0,106,UTA,17,29,24,29,0,99
713,12/10/2016,SAC,25,25,26,8,0,84,UTA,29,23,26,26,0,104
714,12/14/2016,OKC,21,20,27,21,0,89,UTA,26,29,25,29,0,109
715,12/18/2016,UTA,18,16,27,21,0,82,MEM,18,17,23,15,0,73
716,12/20/2016,UTA,15,18,21,20,0,74,GSW,19,36,27,22,0,104
717,12/21/2016,SAC,17,21,24,32,0,94,UTA,24,24,25,20,0,93
718,12/23/2016,TOR,28,28,16,32,0,104,UTA,29,22,23,24,0,98
719,1/2/2017,UTA,24,26,20,31,0,101,BRK,26,26,18,19,0,89
720,1/5/2017,UTA,27,25,21,20,0,93,TOR,18,30,23,30,0,101
721,1/8/2017,UTA,18,17,16,28,0,79,MEM,19,23,21,25,0,88
722,1/13/2017,DET,19,24,20,14,0,77,UTA,14,31,33,32,0,110
723,1/14/2017,ORL,42,23,18,24,0,107,UTA,29,35,20,30,0,114
724,1/21/2017,IND,21,29,22,28,0,100,UTA,34,26,25,24,0,109
725,1/23/2017,OKC,27,29,11,30,0,97,UTA,26,27,19,23,0,95
726,1/24/2017,UTA,22,17,28,26,0,93,DEN,18,33,29,23,0,103
727,1/28/2017,MEM,26,26,28,22,0,102,UTA,27,16,31,21,0,95
728,2/6/2017,UTA,29,25,37,29,0,120,ATL,21,29,23,22,0,95
729,2/8/2017,UTA,32,30,28,37,0,127,NOP,25,28,16,25,0,94
730,2/13/2017,LAC,18,27,31,12,0,88,UTA,19,15,15,23,0,72
731,2/15/2017,POR,17,20,25,26,0,88,UTA,18,22,34,37,0,111
732,2/28/2017,UTA,25,28,22,31,0,106,OKC,31,30,25,23,0,109
733,3/3/2017,BRK,26,25,19,27,0,97,UTA,38,22,28,24,0,112
734,3/5/2017,UTA,25,20,24,28,13,110,SAC,31,28,22,16,12,109
735,3/6/2017,NOP,14,20,18,31,0,83,UTA,29,14,18,27,0,88
736,3/8/2017,UTA,30,34,20,31,0,115,HOU,22,31,24,31,0,108
737,3/11/2017,UTA,23,25,28,28,0,104,OKC,29,33,29,21,0,112
738,3/13/2017,LAC,28,28,30,22,0,108,UTA,23,26,40,25,0,114
739,3/15/2017,UTA,28,26,23,20,0,97,DET,19,16,27,21,0,83
740,3/18/2017,UTA,23,21,20,22,0,86,CHI,16,24,21,34,0,95
741,3/20/2017,UTA,23,23,24,30,0,100,IND,28,23,29,27,0,107
742,3/22/2017,NYK,34,21,20,26,0,101,UTA,26,25,21,36,0,108
743,3/25/2017,UTA,14,27,29,25,0,95,LAC,28,21,23,36,0,108
744,3/27/2017,NOP,21,30,20,29,0,100,UTA,28,28,25,27,0,108
745,3/29/2017,UTA,34,16,28,34,0,112,SAC,14,29,24,15,0,82
746,4/2/2017,UTA,28,24,26,25,0,103,SAS,33,21,34,21,0,109
747,4/4/2017,POR,17,24,23,23,0,87,UTA,24,23,28,31,0,106
748,4/8/2017,UTA,20,22,18,26,0,86,POR,34,14,29,24,0,101
749,4/10/2017,UTA,32,17,25,31,0,105,GSW,33,18,23,25,0,99
750,4/12/2017,SAS,23,23,26,25,0,97,UTA,32,21,29,19,0,101
751,10/27/2016,SAS,27,26,23,26,0,102,SAC,29,28,14,23,0,94
752,10/31/2016,SAC,15,29,37,14,0,95,ATL,22,31,26,27,0,106
753,11/1/2016,SAC,26,24,17,24,5,96,MIA,28,26,19,18,17,108
754,11/3/2016,SAC,29,21,28,16,0,94,ORL,23,33,28,18,0,102
755,11/6/2016,SAC,20,24,24,28,0,96,TOR,23,27,16,25,0,91
756,11/8/2016,NOP,26,20,24,24,0,94,SAC,33,20,23,26,0,102
757,11/11/2016,SAC,31,26,26,23,14,120,POR,35,27,22,22,16,122
758,11/16/2016,SAS,27,30,27,26,0,110,SAC,22,24,25,34,0,105
759,11/18/2016,LAC,40,33,31,17,0,121,SAC,24,30,31,30,0,115
760,11/20/2016,TOR,28,35,18,18,0,99,SAC,36,22,28,16,0,102
761,11/23/2016,OKC,27,21,27,26,0,101,SAC,27,24,36,29,0,116
762,11/25/2016,HOU,38,30,22,27,0,117,SAC,19,31,24,30,0,104
763,11/27/2016,SAC,31,27,34,30,0,122,BRK,35,24,18,28,0,105
764,12/4/2016,SAC,21,20,36,21,0,98,NYK,26,29,26,25,0,106
765,12/9/2016,NYK,30,24,24,25,0,103,SAC,32,21,24,23,0,100
766,12/14/2016,SAC,25,18,24,31,0,98,HOU,36,28,38,30,0,132
767,12/16/2016,SAC,24,28,24,20,0,96,MEM,19,23,23,27,0,92
768,12/20/2016,POR,35,37,27,22,0,121,SAC,27,33,33,33,0,126
769,12/28/2016,SAC,21,23,19,26,0,89,POR,30,30,15,27,0,102
770,12/31/2016,MEM,21,29,32,30,0,112,SAC,20,25,22,31,0,98
771,1/3/2017,SAC,29,31,34,26,0,120,DEN,28,23,37,25,0,113
772,1/4/2017,MIA,30,34,23,20,0,107,SAC,25,34,22,21,0,102
773,1/6/2017,LAC,19,34,22,31,0,106,SAC,29,12,32,25,0,98
774,1/8/2017,GSW,24,27,39,27,0,117,SAC,33,25,22,26,0,106
775,1/10/2017,DET,29,27,21,17,0,94,SAC,21,22,25,32,0,100
776,1/15/2017,OKC,28,31,29,34,0,122,SAC,23,23,33,39,0,118
777,1/18/2017,IND,21,20,30,35,0,106,SAC,34,26,19,21,0,100
778,1/20/2017,SAC,23,19,22,27,0,91,MEM,15,34,34,24,0,107
779,1/21/2017,SAC,21,31,21,26,0,99,CHI,24,31,20,27,0,102
780,1/23/2017,SAC,28,37,23,21,0,109,DET,38,24,19,23,0,104
781,1/27/2017,SAC,30,34,23,17,7,111,IND,27,28,26,23,11,115
782,1/31/2017,SAC,24,11,22,26,0,83,HOU,29,25,28,23,0,105
783,2/4/2017,GSW,31,25,26,16,8,106,SAC,27,29,26,16,11,109
784,2/6/2017,CHI,27,33,25,27,0,112,SAC,11,34,24,38,0,107
785,2/10/2017,ATL,28,31,25,23,0,107,SAC,17,26,31,34,0,108
786,2/12/2017,NOP,29,27,17,26,0,99,SAC,23,30,23,29,0,105
787,2/15/2017,SAC,25,25,15,21,0,86,GSW,28,19,42,20,0,109
788,2/23/2017,DEN,26,18,26,30,0,100,SAC,29,32,26,29,0,116
789,3/1/2017,BRK,35,22,24,28,0,109,SAC,31,23,18,28,0,100
790,3/6/2017,SAC,24,26,23,23,0,96,DEN,25,32,33,18,0,108
791,3/8/2017,SAC,37,26,23,18,0,104,SAS,15,33,34,32,0,114
792,3/11/2017,DEN,25,29,21,30,0,105,SAC,19,25,25,23,0,92
793,3/13/2017,ORL,23,35,26,31,0,115,SAC,24,34,35,27,0,120
794,3/18/2017,SAC,19,22,24,29,0,94,OKC,29,34,22,25,0,110
795,3/19/2017,SAC,27,22,25,28,0,102,SAS,21,37,41,19,0,118
796,3/24/2017,SAC,20,30,22,28,0,100,GSW,27,30,35,22,0,114
797,3/26/2017,SAC,24,18,23,33,0,98,LAC,24,20,32,21,0,97
798,3/27/2017,MEM,27,22,19,22,0,90,SAC,28,23,23,17,0,91
799,3/31/2017,SAC,19,19,26,25,0,89,NOP,32,26,26,33,0,117
800,4/9/2017,HOU,42,36,29,28,0,135,SAC,27,35,27,39,0,128
801,4/12/2017,SAC,23,24,26,22,0,95,LAC,30,23,34,28,0,115
802,10/29/2016,MEM,19,30,28,27,0,104,NYK,32,25,25,29,0,111
803,11/1/2016,NYK,29,26,24,10,0,89,DET,32,32,22,16,0,102
804,11/2/2016,HOU,33,35,32,18,0,118,NYK,25,26,27,21,0,99
805,11/4/2016,NYK,32,24,28,33,0,117,CHI,23,34,24,23,0,104
806,11/9/2016,BRK,29,26,16,25,0,96,NYK,19,31,22,38,0,110
807,11/12/2016,NYK,28,28,29,22,0,107,TOR,24,29,34,31,0,118
808,11/16/2016,DET,27,22,25,28,0,102,NYK,29,25,27,24,0,105
809,11/20/2016,ATL,20,21,25,28,0,94,NYK,24,22,29,29,0,104
810,11/22/2016,POR,33,25,23,22,0,103,NYK,28,32,21,26,0,107
811,11/28/2016,OKC,24,34,30,24,0,112,NYK,29,26,26,22,0,103
812,12/6/2016,NYK,26,27,31,30,0,114,MIA,25,29,23,26,0,103
813,12/15/2016,NYK,25,20,21,24,0,90,GSW,32,27,29,15,0,103
814,12/17/2016,NYK,22,32,26,34,0,114,DEN,33,29,34,31,0,127
815,12/20/2016,IND,24,35,28,24,0,111,NYK,20,34,30,34,0,118
816,12/22/2016,ORL,19,28,25,23,0,95,NYK,27,30,24,25,0,106
817,12/28/2016,NYK,25,22,19,19,13,98,ATL,22,23,20,20,17,102
818,12/30/2016,NYK,21,30,18,23,0,92,NOP,31,24,24,25,0,104
819,12/31/2016,NYK,32,23,37,30,0,122,HOU,27,42,30,30,0,129
820,1/2/2017,ORL,33,34,25,23,0,115,NYK,32,27,21,23,0,103
821,1/7/2017,NYK,29,14,27,39,0,109,IND,33,29,34,27,0,123
822,1/9/2017,NOP,29,31,31,19,0,110,NYK,26,25,15,30,0,96
823,1/12/2017,CHI,22,29,14,24,0,89,NYK,24,30,22,28,0,104
824,1/15/2017,NYK,26,28,8,39,0,101,TOR,27,42,27,20,0,116
825,1/16/2017,ATL,26,27,35,20,0,108,NYK,27,27,29,24,0,107
826,1/23/2017,NYK,22,40,24,23,0,109,IND,34,24,17,28,0,103
827,1/29/2017,NYK,37,28,16,23,9,139,ATL,30,31,22,21,9,142
828,2/1/2017,NYK,15,23,26,31,0,95,BRK,27,18,24,21,0,90
829,2/8/2017,LAC,36,32,20,31,0,119,NYK,36,31,28,20,0,115
830,2/10/2017,DEN,34,30,36,31,0,131,NYK,32,34,22,35,0,123
831,2/12/2017,SAS,21,27,17,25,0,90,NYK,18,24,27,25,0,94
832,2/15/2017,NYK,39,21,20,25,0,105,OKC,27,35,26,28,0,116
833,2/27/2017,TOR,21,19,23,29,0,92,NYK,25,28,14,24,0,91
834,3/1/2017,NYK,31,29,19,22,0,101,ORL,24,27,16,23,0,90
835,3/5/2017,GSW,29,20,35,28,0,112,NYK,18,32,26,29,0,105
836,3/6/2017,NYK,20,31,34,28,0,113,ORL,28,26,38,13,0,105
837,3/11/2017,NYK,23,30,28,11,0,92,DET,35,31,23,23,0,112
838,3/12/2017,NYK,26,23,31,32,0,112,BRK,39,28,24,29,0,120
839,3/14/2017,IND,24,28,12,17,0,81,NYK,18,24,20,25,0,87
840,3/16/2017,BRK,28,26,38,29,0,121,NYK,33,28,26,23,0,110
841,3/20/2017,NYK,23,30,19,33,0,105,LAC,29,34,34,17,0,114
842,3/23/2017,NYK,23,23,22,27,0,95,POR,37,30,18,25,0,110
843,3/25/2017,NYK,23,20,31,24,0,98,SAS,33,28,17,28,0,106
844,3/27/2017,DET,36,23,15,21,0,95,NYK,34,30,25,20,0,109
845,3/29/2017,MIA,24,25,28,28,0,105,NYK,22,19,27,20,0,88
846,3/31/2017,NYK,33,26,18,21,0,98,MIA,29,26,20,19,0,94
847,4/4/2017,CHI,24,16,24,27,0,91,NYK,29,25,26,20,0,100
848,4/7/2017,NYK,21,26,25,16,0,88,MEM,27,26,17,31,0,101
849,4/9/2017,TOR,23,29,24,34,0,110,NYK,29,26,20,22,0,97
850,10/26/2016,DEN,30,30,25,22,0,107,NOP,24,24,29,25,0,102
851,10/28/2016,GSW,32,27,33,30,0,122,NOP,22,28,31,33,0,114
852,10/29/2016,NOP,23,22,15,19,0,79,SAS,28,27,28,15,0,98
853,11/2/2016,NOP,13,35,11,16,8,83,MEM,21,20,25,9,14,89
854,11/7/2016,NOP,24,25,29,28,0,106,GSW,28,35,21,32,0,116
855,11/16/2016,NOP,19,21,23,19,0,82,ORL,21,31,13,24,0,89
856,11/18/2016,POR,28,23,24,26,0,101,NOP,31,33,24,25,0,113
857,11/22/2016,NOP,34,32,29,17,0,112,ATL,14,30,27,23,0,94
858,11/25/2016,NOP,34,23,26,21,0,104,POR,32,34,34,19,0,119
859,12/2/2016,LAC,25,35,29,25,0,114,NOP,30,27,19,20,0,96
860,12/4/2016,NOP,26,15,25,26,0,92,OKC,29,20,29,23,0,101
861,12/5/2016,MEM,17,27,30,20,6,110,NOP,21,25,23,25,6,108
862,12/10/2016,NOP,31,24,25,25,0,105,LAC,35,26,37,35,0,133
863,12/13/2016,GSW,29,29,37,18,0,113,NOP,35,30,29,15,0,109
864,12/15/2016,IND,20,30,24,21,0,95,NOP,24,22,25,31,0,102
865,12/16/2016,NOP,24,26,29,21,0,100,HOU,35,37,25,25,0,122
866,12/18/2016,NOP,26,23,22,29,0,100,SAS,30,31,31,21,0,113
867,12/21/2016,OKC,34,29,24,34,0,121,NOP,28,30,26,26,0,110
868,12/23/2016,MIA,28,21,19,19,0,87,NOP,25,19,20,27,0,91
869,12/28/2016,LAC,27,29,21,21,0,98,NOP,19,30,27,26,0,102
870,1/5/2017,ATL,23,19,33,24,0,99,NOP,28,19,25,22,0,94
871,1/12/2017,NOP,35,16,22,31,0,104,BRK,31,26,22,16,0,95
872,1/14/2017,NOP,22,23,26,28,0,99,CHI,21,34,22,30,0,107
873,1/16/2017,NOP,18,34,18,25,0,95,IND,32,22,22,22,0,98
874,1/18/2017,ORL,29,23,21,25,0,98,NOP,32,33,27,26,0,118
875,1/20/2017,BRK,29,37,43,34,0,143,NOP,32,22,30,30,0,114
876,1/25/2017,OKC,33,31,28,22,0,114,NOP,20,25,37,23,0,105
877,1/27/2017,SAS,20,37,27,19,0,103,NOP,23,25,37,34,0,119
878,1/31/2017,NOP,25,35,15,21,10,106,TOR,23,23,31,19,12,108
879,2/1/2017,NOP,30,24,27,17,0,98,DET,34,26,23,35,0,118
880,2/15/2017,NOP,28,22,27,18,0,95,MEM,22,21,18,30,0,91
881,2/23/2017,HOU,30,36,34,29,0,129,NOP,28,22,17,32,0,99
882,2/26/2017,NOP,35,24,25,26,0,110,OKC,32,27,28,31,0,118
883,3/1/2017,DET,18,32,20,16,0,86,NOP,31,22,25,31,0,109
884,3/3/2017,SAS,27,22,18,22,12,101,NOP,30,18,18,23,9,98
885,3/8/2017,TOR,22,23,23,26,0,94,NOP,26,20,18,23,0,87
886,3/14/2017,POR,16,20,18,23,0,77,NOP,23,27,27,23,0,100
887,3/15/2017,NOP,21,31,27,33,0,112,MIA,28,26,31,35,0,120
888,3/17/2017,HOU,23,27,31,31,0,112,NOP,36,32,31,29,0,128
889,3/21/2017,MEM,23,18,13,28,0,82,NOP,21,13,32,29,0,95
890,3/24/2017,NOP,33,17,29,28,0,107,HOU,28,21,31,37,0,117
891,3/26/2017,NOP,29,26,32,28,0,115,DEN,26,14,19,31,0,90
892,4/2/2017,CHI,28,35,24,30,0,117,NOP,21,26,32,31,0,110
893,4/4/2017,DEN,27,42,33,32,0,134,NOP,31,44,30,26,0,131
894,4/7/2017,NOP,25,25,24,32,0,106,DEN,30,21,41,30,0,122
895,4/8/2017,NOP,17,29,22,33,0,101,GSW,23,31,39,30,0,123
896,4/12/2017,NOP,22,31,25,25,0,103,POR,30,23,32,15,0,100
897,10/26/2016,DET,23,23,25,20,0,91,TOR,33,25,28,23,0,109
898,10/28/2016,ORL,22,9,20,31,0,82,DET,24,30,32,22,0,108
899,11/2/2016,DET,30,25,26,20,0,101,BRK,38,33,21,17,0,109
900,11/5/2016,DEN,12,32,23,19,0,86,DET,29,22,26,26,0,103
901,11/7/2016,DET,15,17,21,29,0,82,LAC,33,29,29,23,0,114
902,11/11/2016,DET,26,26,15,19,0,86,SAS,28,21,26,21,0,96
903,11/12/2016,DET,36,21,23,26,0,106,DEN,21,28,22,24,0,95
904,11/14/2016,OKC,25,22,21,20,0,88,DET,28,31,19,26,0,104
905,11/21/2016,HOU,18,33,28,20,0,99,DET,25,21,29,21,0,96
906,11/23/2016,MIA,16,26,22,20,0,84,DET,28,28,30,21,0,107
907,11/25/2016,LAC,23,25,32,17,0,97,DET,35,22,25,26,0,108
908,11/26/2016,DET,19,27,22,20,0,88,OKC,29,27,21,29,0,106
909,12/2/2016,DET,27,31,32,31,0,121,ATL,24,15,18,28,0,85
910,12/4/2016,ORL,23,35,20,20,0,98,DET,27,23,23,19,0,92
911,12/6/2016,CHI,21,23,28,19,0,91,DET,32,19,20,31,0,102
912,12/17/2016,IND,27,28,28,22,0,105,DET,26,18,25,21,0,90
913,12/19/2016,DET,19,15,29,19,0,82,CHI,35,34,28,16,0,113
914,12/21/2016,MEM,29,24,26,19,0,98,DET,19,25,19,23,0,86
915,12/23/2016,GSW,33,24,31,31,0,119,DET,32,27,25,29,0,113
916,12/30/2016,DET,19,22,21,36,0,98,ATL,19,32,23,31,0,105
917,1/1/2017,DET,33,25,27,22,0,107,MIA,37,29,15,17,0,98
918,1/3/2017,IND,36,30,26,29,0,121,DET,28,32,32,24,0,116
919,1/8/2017,DET,31,22,27,26,8,125,POR,30,26,31,19,8,124
920,1/12/2017,DET,30,28,19,30,0,107,GSW,37,23,41,26,0,127
921,1/18/2017,ATL,18,27,23,27,0,95,DET,42,27,25,24,0,118
922,1/28/2017,DET,33,27,31,12,0,103,MIA,35,29,26,26,0,116
923,2/4/2017,DET,32,26,14,12,0,84,IND,30,26,26,23,0,105
924,2/10/2017,SAS,27,33,23,20,0,103,DET,19,22,25,26,0,92
925,2/12/2017,DET,25,20,21,36,0,102,TOR,27,24,31,19,0,101
926,2/28/2017,POR,27,22,30,30,4,113,DET,19,25,31,34,11,120
927,3/6/2017,CHI,26,29,24,16,0,95,DET,14,37,28,30,0,109
928,3/8/2017,DET,23,27,23,25,0,98,IND,30,28,32,25,0,115
929,3/17/2017,TOR,16,24,20,27,0,87,DET,13,25,28,9,0,75
930,3/21/2017,DET,31,13,21,31,0,96,BRK,22,28,24,24,0,98
931,3/22/2017,DET,23,30,20,22,0,95,CHI,32,27,32,26,0,117
932,3/24/2017,DET,18,21,23,25,0,87,ORL,22,35,35,23,0,115
933,3/28/2017,MIA,24,31,23,19,0,97,DET,24,26,19,27,0,96
934,3/30/2017,BRK,18,21,24,26,0,89,DET,16,19,24,31,0,90
935,4/5/2017,TOR,15,31,22,37,0,105,DET,33,23,24,22,0,102
936,4/7/2017,DET,24,28,23,39,0,114,HOU,30,24,33,22,0,109
937,4/9/2017,DET,24,24,27,28,0,103,MEM,28,29,10,23,0,90
938,4/12/2017,DET,17,32,32,28,0,109,ORL,38,21,28,26,0,113
939,11/5/2016,HOU,30,29,25,13,0,97,ATL,30,35,28,19,0,112
940,11/9/2016,CHI,27,34,27,19,0,107,ATL,35,33,26,21,0,115
941,11/15/2016,ATL,22,27,23,21,0,93,MIA,25,18,24,23,0,90
942,11/23/2016,ATL,31,18,25,22,0,96,IND,24,20,22,19,0,85
943,11/28/2016,ATL,27,26,28,19,0,100,GSW,29,21,30,25,0,105
944,12/3/2016,ATL,22,25,23,14,0,84,TOR,32,30,24,42,0,128
945,12/5/2016,OKC,23,32,28,19,0,102,ATL,21,33,15,30,0,99
946,12/7/2016,MIA,25,21,17,32,0,95,ATL,29,24,25,25,0,103
947,12/13/2016,ORL,35,37,27,32,0,131,ATL,34,28,34,24,0,120
948,12/16/2016,ATL,35,34,26,30,0,125,TOR,27,25,30,39,0,121
949,12/19/2016,ATL,22,26,33,29,0,110,OKC,16,37,25,30,0,108
950,12/23/2016,ATL,29,22,31,27,0,109,DEN,29,26,27,26,0,108
951,1/1/2017,SAS,27,19,28,26,12,112,ATL,25,19,25,31,14,114
952,1/4/2017,ATL,23,29,26,33,0,111,ORL,26,21,18,27,0,92
953,1/10/2017,ATL,35,26,25,31,0,117,BRK,29,14,27,27,0,97
954,1/20/2017,CHI,13,23,21,36,0,93,ATL,35,30,22,15,0,102
955,1/23/2017,LAC,30,28,27,30,0,115,ATL,21,19,35,30,0,105
956,1/25/2017,ATL,22,29,27,41,0,119,CHI,29,30,24,31,0,114
957,2/1/2017,ATL,22,25,24,22,0,93,MIA,29,33,32,22,0,116
958,2/2/2017,ATL,26,21,26,40,0,113,HOU,32,18,36,22,0,108
959,2/4/2017,ORL,24,15,26,21,0,86,ATL,35,30,26,22,0,113
960,2/8/2017,DEN,30,25,32,19,0,106,ATL,39,33,26,19,0,117
961,2/13/2017,ATL,21,21,33,22,12,109,POR,28,20,26,23,7,104
962,2/15/2017,ATL,22,18,24,20,0,84,LAC,21,33,29,16,0,99
963,2/24/2017,MIA,25,38,24,21,0,108,ATL,24,25,17,24,0,90
964,2/25/2017,ATL,19,27,19,21,0,86,ORL,22,27,31,25,0,105
965,3/5/2017,IND,19,31,31,16,0,97,ATL,30,20,24,22,0,96
966,3/6/2017,GSW,35,26,33,25,0,119,ATL,42,24,24,21,0,111
967,3/8/2017,BRK,27,23,30,25,0,105,ATL,23,23,35,29,0,110
968,3/10/2017,TOR,19,29,27,24,0,99,ATL,18,31,25,31,0,105
969,3/11/2017,ATL,33,14,30,30,0,107,MEM,15,20,22,33,0,90
970,3/13/2017,ATL,18,25,30,26,0,99,SAS,28,26,27,26,0,107
971,3/16/2017,MEM,26,29,23,25,0,103,ATL,28,24,13,26,0,91
972,3/18/2017,POR,40,23,22,28,0,113,ATL,18,28,27,24,0,97
973,3/26/2017,BRK,32,23,23,29,0,107,ATL,20,28,20,24,0,92
974,4/1/2017,ATL,21,25,38,20,0,104,CHI,23,29,27,27,0,106
975,4/2/2017,ATL,24,19,18,21,0,82,BRK,29,17,24,21,0,91
976,4/12/2017,ATL,15,28,25,18,0,86,IND,22,28,34,20,0,104
977,10/29/2016,IND,20,21,26,34,0,101,CHI,24,38,30,26,0,118
978,10/31/2016,CHI,38,27,28,25,0,118,BRK,20,24,22,22,0,88
979,11/5/2016,CHI,15,28,21,30,0,94,IND,31,31,26,23,0,111
980,11/7/2016,ORL,24,28,11,17,0,80,CHI,37,24,27,24,0,112
981,11/10/2016,CHI,23,30,17,28,0,98,MIA,22,31,17,25,0,95
982,11/15/2016,CHI,35,21,27,30,0,113,POR,14,23,26,25,0,88
983,11/19/2016,CHI,33,19,25,18,0,95,LAC,23,24,25,30,0,102
984,11/22/2016,CHI,31,29,28,19,0,107,DEN,19,41,31,19,0,110
985,12/5/2016,POR,29,36,21,26,0,112,CHI,32,25,30,23,0,110
986,12/8/2016,SAS,17,15,31,28,0,91,CHI,21,24,27,23,0,95
987,12/10/2016,MIA,27,28,20,25,0,100,CHI,29,26,28,22,0,105
988,12/25/2016,CHI,25,25,26,24,0,100,SAS,36,19,32,32,0,119
989,12/26/2016,IND,19,22,20,24,0,85,CHI,28,23,12,27,0,90
990,12/28/2016,BRK,20,29,29,21,0,99,CHI,23,23,30,25,0,101
991,12/30/2016,CHI,22,28,23,28,0,101,IND,28,34,22,27,0,111
992,1/7/2017,TOR,28,33,25,21,11,118,CHI,29,19,26,33,16,123
993,1/9/2017,OKC,26,35,28,20,0,109,CHI,20,26,21,27,0,94
994,1/15/2017,CHI,14,38,26,30,0,108,MEM,19,27,31,27,0,104
995,1/24/2017,CHI,20,32,26,22,0,100,ORL,22,27,24,19,0,92
996,1/27/2017,MIA,33,20,24,23,0,100,CHI,24,29,14,21,0,88
997,2/1/2017,CHI,21,34,39,34,0,128,OKC,20,27,26,27,0,100
998,2/3/2017,CHI,26,23,32,27,9,117,HOU,24,36,19,29,13,121
999,2/8/2017,CHI,17,24,29,22,0,92,GSW,30,25,31,37,0,123
1000,2/14/2017,TOR,18,21,25,30,0,94,CHI,24,34,20,27,0,105
1001,2/28/2017,DEN,22,34,35,34,0,125,CHI,25,34,24,24,0,107
1002,3/2/2017,GSW,26,25,22,14,0,87,CHI,19,28,32,15,0,94
1003,3/4/2017,LAC,23,32,27,19,0,101,CHI,29,32,12,18,0,91
1004,3/8/2017,CHI,22,31,24,14,0,91,ORL,19,24,34,21,0,98
1005,3/10/2017,HOU,23,33,36,23,0,115,CHI,33,16,14,31,0,94
1006,3/15/2017,MEM,24,30,20,24,0,98,CHI,24,26,21,20,0,91
1007,3/21/2017,CHI,31,28,35,19,7,120,TOR,27,27,25,34,9,122
1008,4/8/2017,CHI,25,20,37,24,0,106,BRK,32,19,24,32,0,107
1009,4/10/2017,ORL,13,24,22,16,0,75,CHI,34,30,28,30,0,122
1010,4/12/2017,BRK,13,19,24,17,0,73,CHI,27,23,25,37,0,112
1011,10/26/2016,MIA,23,27,30,28,0,108,ORL,27,26,16,27,0,96
1012,10/30/2016,SAS,24,28,25,29,0,106,MIA,19,25,28,27,0,99
1013,11/4/2016,MIA,27,19,26,15,0,87,TOR,25,27,23,21,0,96
1014,11/7/2016,MIA,28,19,14,24,0,85,OKC,39,16,28,14,0,97
1015,11/14/2016,MIA,19,21,20,30,0,90,SAS,25,30,16,23,0,94
1016,11/25/2016,MIA,28,17,26,19,0,90,MEM,19,20,18,24,0,81
1017,11/26/2016,MEM,24,27,31,28,0,110,MIA,31,18,33,25,0,107
1018,11/30/2016,MIA,28,24,23,31,0,106,DEN,30,17,33,18,0,98
1019,12/3/2016,MIA,29,20,22,21,0,92,POR,21,34,18,26,0,99
1020,12/14/2016,IND,21,31,27,10,0,89,MIA,20,33,25,17,0,95
1021,12/16/2016,LAC,31,29,19,23,0,102,MIA,27,19,23,29,0,98
1022,12/20/2016,ORL,27,30,28,24,9,136,MIA,28,36,25,20,9,130
1023,12/27/2016,OKC,33,28,26,19,0,106,MIA,19,29,21,25,0,94
1024,1/8/2017,MIA,19,20,27,20,0,86,LAC,20,32,28,18,0,98
1025,1/10/2017,MIA,29,25,14,27,0,95,GSW,27,26,26,28,0,107
1026,1/17/2017,HOU,32,21,26,24,0,103,MIA,27,26,26,30,0,109
1027,1/23/2017,GSW,30,18,25,29,0,102,MIA,28,18,31,28,0,105
1028,1/25/2017,MIA,34,21,16,38,0,109,BRK,30,36,23,17,0,106
1029,1/30/2017,BRK,32,20,25,19,0,96,MIA,28,28,28,20,0,104
1030,2/10/2017,MIA,20,29,25,34,0,108,BRK,22,31,19,27,0,99
1031,2/13/2017,ORL,36,24,27,29,0,116,MIA,28,29,30,20,0,107
1032,2/15/2017,MIA,34,24,30,29,0,117,HOU,28,17,28,36,0,109
1033,2/25/2017,IND,23,31,25,16,0,95,MIA,18,35,30,30,0,113
1034,3/3/2017,MIA,25,28,20,26,0,99,ORL,33,27,25,25,0,110
1035,3/11/2017,TOR,26,15,22,26,0,89,MIA,32,27,26,19,0,104
1036,3/12/2017,MIA,22,31,22,23,0,98,IND,32,28,23,19,0,102
1037,3/19/2017,POR,28,24,33,30,0,115,MIA,29,22,28,25,0,104
1038,3/23/2017,TOR,23,22,30,26,0,101,MIA,33,14,21,16,0,84
1039,4/2/2017,DEN,37,31,25,23,0,116,MIA,30,28,29,26,0,113
1040,4/7/2017,MIA,19,24,22,29,0,94,TOR,26,27,17,26,0,96
1041,11/4/2016,LAC,23,30,23,23,0,99,MEM,20,15,22,31,0,88
1042,11/6/2016,POR,25,22,29,24,0,100,MEM,22,29,26,17,0,94
1043,11/8/2016,DEN,26,30,20,31,0,107,MEM,26,30,23,29,0,108
1044,11/16/2016,MEM,26,35,22,28,0,111,LAC,28,18,30,31,0,107
1045,11/30/2016,MEM,28,29,25,23,0,105,TOR,25,30,34,31,0,120
1046,12/1/2016,ORL,28,21,19,26,0,94,MEM,30,20,15,30,0,95
1047,12/8/2016,POR,22,28,19,17,0,86,MEM,14,29,18,27,0,88
1048,12/10/2016,GSW,16,22,27,24,0,89,MEM,31,30,26,23,0,110
1049,12/23/2016,HOU,31,18,26,34,0,109,MEM,25,29,23,38,0,115
1050,12/26/2016,MEM,18,25,28,31,0,102,ORL,36,32,28,16,0,112
1051,12/29/2016,OKC,21,18,22,19,0,80,MEM,27,28,23,36,0,114
1052,1/4/2017,MEM,29,34,22,21,0,106,LAC,30,23,36,26,0,115
1053,1/6/2017,MEM,27,28,24,32,17,128,GSW,34,33,31,13,8,119
1054,1/11/2017,MEM,22,22,23,28,0,95,OKC,28,27,20,28,0,103
1055,1/13/2017,MEM,25,26,32,27,0,110,HOU,31,33,21,20,0,105
1056,1/21/2017,HOU,32,26,33,28,0,119,MEM,22,27,23,23,0,95
1057,1/25/2017,TOR,34,23,20,22,0,99,MEM,32,24,31,14,0,101
1058,1/27/2017,MEM,24,32,28,25,0,109,POR,28,34,23,27,0,112
1059,2/1/2017,MEM,27,35,25,32,0,119,DEN,18,31,20,30,0,99
1060,2/3/2017,MEM,23,25,34,20,0,102,OKC,21,37,22,34,0,114
1061,2/6/2017,SAS,14,26,25,9,0,74,MEM,17,23,29,20,0,89
1062,2/10/2017,GSW,29,33,36,24,0,122,MEM,22,27,28,30,0,107
1063,2/13/2017,MEM,27,25,27,33,0,112,BRK,19,23,30,31,0,103
1064,2/24/2017,MEM,26,23,19,24,0,92,IND,25,36,28,13,0,102
1065,2/26/2017,MEM,22,28,18,37,0,105,DEN,19,28,21,30,0,98
1066,3/4/2017,MEM,24,27,27,30,0,108,HOU,27,28,38,30,0,123
1067,3/6/2017,BRK,36,20,32,34,0,122,MEM,34,23,34,18,0,109
1068,3/9/2017,LAC,26,28,31,29,0,114,MEM,21,24,20,33,0,98
1069,3/18/2017,SAS,18,25,30,23,0,96,MEM,29,15,31,29,0,104
1070,3/23/2017,MEM,22,20,27,21,0,90,SAS,27,24,23,23,0,97
1071,3/26/2017,MEM,28,26,27,13,0,94,GSW,25,31,27,23,0,106
1072,3/29/2017,IND,24,29,26,18,0,97,MEM,38,34,24,14,0,110
1073,4/4/2017,MEM,16,19,16,33,5,89,SAS,14,19,27,24,11,95
1074,4/5/2017,OKC,34,23,22,24,0,103,MEM,27,23,24,26,0,100
1075,10/25/2016,SAS,31,33,33,32,0,129,GSW,20,26,31,23,0,100
1076,11/1/2016,GSW,34,25,41,27,0,127,POR,25,28,20,31,0,104
1077,11/3/2016,OKC,32,11,27,26,0,96,GSW,31,37,30,24,0,122
1078,11/10/2016,GSW,38,27,34,26,0,125,DEN,19,32,24,26,0,101
1079,11/16/2016,GSW,34,32,29,32,0,127,TOR,38,15,33,35,0,121
1080,11/21/2016,GSW,34,27,39,20,0,120,IND,21,21,29,12,0,83
1081,12/1/2016,HOU,32,32,22,27,10,132,GSW,30,29,23,31,10,127
1082,12/5/2016,IND,27,23,33,23,0,106,GSW,38,42,36,26,0,142
1083,12/7/2016,GSW,37,25,29,24,0,115,LAC,19,30,26,23,0,98
1084,12/17/2016,POR,21,24,27,18,0,90,GSW,39,31,38,27,0,135
1085,12/22/2016,GSW,33,16,39,29,0,117,BRK,34,31,19,17,0,101
1086,12/28/2016,TOR,17,38,32,24,0,111,GSW,42,30,32,17,0,121
1087,1/2/2017,DEN,33,31,21,34,0,119,GSW,35,33,26,33,0,127
1088,1/4/2017,POR,34,37,21,25,0,117,GSW,40,29,30,26,0,125
1089,1/18/2017,OKC,31,25,22,22,0,100,GSW,30,26,37,28,0,121
1090,1/20/2017,GSW,32,30,37,26,0,125,HOU,29,28,22,29,0,108
1091,1/22/2017,GSW,28,22,42,26,0,118,ORL,22,28,24,24,0,98
1092,1/28/2017,LAC,22,29,23,24,0,98,GSW,31,41,45,27,0,144
1093,1/29/2017,GSW,33,20,31,29,0,113,POR,24,26,24,37,0,111
1094,2/2/2017,GSW,33,32,39,29,0,133,LAC,22,33,32,33,0,120
1095,2/11/2017,GSW,30,43,32,25,0,130,OKC,24,26,37,27,0,114
1096,2/13/2017,GSW,30,24,31,25,0,110,DEN,42,37,28,25,0,132
1097,2/23/2017,LAC,24,37,26,26,0,113,GSW,31,18,50,24,0,123
1098,2/25/2017,BRK,28,23,25,19,0,95,GSW,32,30,29,21,0,112
1099,3/11/2017,GSW,22,22,19,22,0,85,SAS,33,31,22,21,0,107
1100,3/16/2017,ORL,20,30,21,21,0,92,GSW,34,33,36,19,0,122
1101,3/20/2017,GSW,25,34,33,19,0,111,OKC,22,17,27,29,0,95
1102,3/28/2017,GSW,37,23,26,27,0,113,HOU,20,32,23,31,0,106
1103,3/29/2017,GSW,17,37,30,26,0,110,SAS,33,24,20,21,0,98
1104,3/31/2017,HOU,25,36,24,13,0,98,GSW,23,33,27,24,0,107
1105,10/29/2016,POR,33,29,19,23,11,115,DEN,28,26,34,16,9,113
1106,10/31/2016,DEN,24,25,35,18,0,102,TOR,33,29,26,17,0,105
1107,11/13/2016,DEN,28,29,15,33,0,105,POR,20,30,36,26,0,112
1108,11/18/2016,TOR,29,23,25,25,11,113,DEN,19,38,25,20,9,111
1109,11/25/2016,OKC,31,31,22,38,10,132,DEN,30,33,26,33,7,129
1110,12/2/2016,HOU,42,31,26,29,0,128,DEN,33,30,21,26,0,110
1111,12/7/2016,DEN,23,29,27,32,0,111,BRK,36,32,28,20,0,116
1112,12/10/2016,DEN,32,33,27,29,0,121,ORL,29,29,37,18,0,113
1113,12/15/2016,POR,28,28,29,35,0,120,DEN,38,36,26,32,0,132
1114,12/20/2016,DEN,26,27,19,30,0,102,LAC,36,32,27,24,0,119
1115,12/26/2016,DEN,23,40,16,27,0,106,LAC,23,23,31,25,0,102
1116,1/5/2017,SAS,29,29,32,37,0,127,DEN,33,20,24,22,0,99
1117,1/7/2017,DEN,22,38,20,26,0,106,OKC,24,36,28,33,0,121
1118,1/12/2017,IND,29,27,20,36,0,112,DEN,30,37,39,34,0,140
1119,1/16/2017,ORL,36,25,22,29,0,112,DEN,39,30,31,25,0,125
1120,1/19/2017,DEN,23,35,23,23,0,104,SAS,28,31,33,26,0,118
1121,1/21/2017,LAC,18,27,26,27,0,98,DEN,27,32,36,28,0,123
1122,2/4/2017,DEN,27,23,22,25,0,97,SAS,30,26,35,30,0,121
1123,2/24/2017,BRK,25,28,22,34,0,109,DEN,30,34,37,28,0,129
1124,3/16/2017,LAC,19,27,34,34,0,114,DEN,27,32,44,26,0,129
1125,3/18/2017,HOU,26,25,29,29,0,109,DEN,26,30,18,31,0,105
1126,3/20/2017,DEN,28,37,32,27,0,124,HOU,35,27,32,31,0,125
1127,3/24/2017,DEN,34,30,30,31,0,125,IND,26,27,22,42,0,117
1128,3/28/2017,DEN,35,29,21,28,0,113,POR,32,34,29,27,0,122
1129,4/5/2017,DEN,25,25,29,25,0,104,HOU,36,23,26,25,0,110
1130,4/9/2017,OKC,27,25,29,25,0,106,DEN,26,27,38,14,0,105
1131,4/12/2017,DEN,25,31,30,25,0,111,OKC,26,38,21,20,0,105
1132,10/28/2016,IND,27,21,31,15,0,94,BRK,20,32,20,31,0,103
1133,11/14/2016,BRK,14,33,18,30,0,95,LAC,39,32,28,28,0,127
1134,11/18/2016,BRK,40,21,21,23,0,105,OKC,34,30,32,28,0,124
1135,11/20/2016,POR,32,38,29,30,0,129,BRK,29,35,20,25,0,109
1136,11/25/2016,BRK,23,20,22,32,0,97,IND,28,30,34,26,0,118
1137,11/29/2016,LAC,28,37,21,21,11,122,BRK,24,29,20,34,11,127
1138,12/10/2016,BRK,26,26,18,31,0,101,SAS,41,26,36,27,0,130
1139,12/12/2016,BRK,24,19,42,33,0,118,HOU,29,24,37,32,0,122
1140,12/16/2016,BRK,28,24,30,29,0,111,ORL,25,28,30,35,0,118
1141,12/20/2016,BRK,23,23,26,32,0,104,TOR,29,35,27,25,0,116
1142,1/5/2017,BRK,27,25,32,25,0,109,IND,34,25,38,24,0,121
1143,1/13/2017,BRK,27,26,36,24,0,113,TOR,30,24,36,42,0,132
1144,1/15/2017,HOU,37,37,30,33,0,137,BRK,36,30,24,22,0,112
1145,1/17/2017,TOR,26,32,34,27,0,119,BRK,29,32,24,24,0,109
1146,1/23/2017,SAS,27,25,39,21,0,112,BRK,26,16,27,17,0,86
1147,2/3/2017,IND,27,29,24,26,0,106,BRK,16,30,28,23,0,97
1148,2/5/2017,TOR,26,29,20,28,0,103,BRK,24,19,20,32,0,95
1149,3/4/2017,BRK,27,30,25,34,0,116,POR,37,21,32,40,0,130
1150,3/14/2017,OKC,32,30,29,31,0,122,BRK,32,30,21,21,0,104
1151,4/1/2017,ORL,33,20,36,22,0,111,BRK,33,27,29,32,0,121
1152,4/6/2017,BRK,25,25,21,36,0,107,ORL,22,28,36,29,0,115
1153,10/27/2016,LAC,28,30,24,32,0,114,POR,27,22,33,24,0,106
1154,11/2/2016,OKC,23,26,16,20,0,85,LAC,24,17,25,17,0,83
1155,11/5/2016,LAC,39,34,16,27,0,116,SAS,24,31,17,20,0,92
1156,11/9/2016,POR,16,16,18,30,0,80,LAC,36,25,32,18,0,111
1157,11/11/2016,LAC,16,34,32,28,0,110,OKC,24,26,24,34,0,108
1158,11/21/2016,TOR,19,26,34,36,0,115,LAC,23,31,34,35,0,123
1159,11/27/2016,LAC,20,20,18,12,0,70,IND,23,27,26,15,0,91
1160,12/4/2016,IND,17,31,35,28,0,111,LAC,28,24,17,33,0,102
1161,12/12/2016,POR,27,33,26,34,0,120,LAC,38,18,33,32,0,121
1162,12/14/2016,LAC,30,30,27,26,0,113,ORL,25,26,36,21,0,108
1163,12/22/2016,SAS,22,23,28,28,0,101,LAC,27,30,24,25,0,106
1164,12/30/2016,LAC,23,34,41,18,0,116,HOU,37,37,34,32,0,140
1165,12/31/2016,LAC,12,28,28,20,0,88,OKC,33,36,27,18,0,114
1166,1/11/2017,ORL,33,18,24,21,0,96,LAC,28,28,17,32,0,105
1167,1/16/2017,OKC,25,22,28,23,0,98,LAC,34,30,32,24,0,120
1168,2/6/2017,LAC,31,29,22,27,0,109,TOR,35,35,27,21,0,118
1169,2/24/2017,SAS,18,29,30,28,0,105,LAC,13,29,31,24,0,97
1170,3/1/2017,HOU,34,36,38,14,0,122,LAC,37,21,20,25,0,103
1171,4/8/2017,LAC,22,30,30,16,0,98,SAS,23,20,27,17,0,87
1172,4/10/2017,HOU,35,22,12,27,0,96,LAC,35,26,36,28,0,125
1173,11/17/2016,POR,29,33,21,26,0,109,HOU,41,21,38,26,0,126
1174,11/27/2016,HOU,35,30,31,34,0,130,POR,35,27,31,21,0,114
1175,11/30/2016,IND,23,35,25,26,0,109,POR,31,42,36,22,0,131
1176,12/10/2016,POR,44,27,27,13,0,111,IND,31,33,26,28,0,118
1177,12/13/2016,OKC,31,21,19,24,0,95,POR,32,36,24,22,0,114
1178,12/23/2016,SAS,27,30,30,23,0,110,POR,27,18,27,18,0,90
1179,12/26/2016,TOR,21,22,30,22,0,95,POR,24,18,26,23,0,91
1180,12/30/2016,POR,32,20,21,21,0,94,SAS,22,25,33,30,0,110
1181,1/13/2017,ORL,36,18,28,33,0,115,POR,23,26,29,31,0,109
1182,2/5/2017,POR,16,36,21,26,0,99,OKC,24,22,25,34,0,105
1183,2/23/2017,POR,23,23,31,35,0,112,ORL,25,30,30,18,0,103
1184,2/26/2017,POR,28,24,28,26,0,106,TOR,25,28,29,30,0,112
1185,3/2/2017,OKC,24,36,25,24,0,109,POR,26,31,24,33,0,114
1186,3/7/2017,POR,29,32,38,27,0,126,OKC,40,27,25,29,0,121
1187,3/15/2017,POR,28,26,28,28,0,110,SAS,29,26,25,26,0,106
1188,3/30/2017,HOU,31,25,29,22,0,107,POR,32,33,31,21,0,117
1189,4/10/2017,SAS,28,15,33,22,0,98,POR,31,16,24,28,0,99
1190,11/14/2016,ORL,19,18,20,12,0,69,IND,16,25,30,17,0,88
1191,11/20/2016,IND,30,28,21,24,12,115,OKC,21,33,16,33,8,111
1192,1/1/2017,ORL,17,34,22,31,0,104,IND,27,35,27,28,0,117
1193,1/29/2017,HOU,20,23,27,31,0,101,IND,33,24,33,30,0,120
1194,2/1/2017,IND,28,28,24,18,0,98,ORL,23,24,27,14,0,88
1195,2/6/2017,OKC,25,27,18,20,0,90,IND,20,21,32,20,0,93
1196,2/13/2017,SAS,26,23,34,27,0,110,IND,31,18,30,27,0,106
1197,2/27/2017,IND,20,39,29,29,0,117,HOU,31,27,22,28,0,108
1198,3/1/2017,IND,28,21,27,23,0,99,SAS,29,18,26,27,0,100
1199,3/19/2017,IND,24,21,28,18,0,91,TOR,32,30,29,25,0,116
1200,3/31/2017,IND,25,23,20,32,0,100,TOR,28,18,34,31,0,111
1201,4/4/2017,TOR,26,25,24,15,0,90,IND,18,22,37,31,0,108
1202,4/8/2017,IND,39,29,31,28,0,127,ORL,38,21,23,30,0,112
1203,11/9/2016,HOU,33,30,22,16,0,101,SAS,24,36,20,19,0,99
1204,11/12/2016,SAS,26,23,33,24,0,106,HOU,22,18,30,30,0,100
1205,11/29/2016,ORL,16,29,30,20,0,95,SAS,20,23,21,19,0,83
1206,12/20/2016,SAS,26,26,19,31,0,102,HOU,24,21,33,22,0,100
1207,1/3/2017,TOR,18,23,17,24,0,82,SAS,29,31,28,22,0,110
1208,1/24/2017,SAS,29,32,18,29,0,108,TOR,25,29,25,27,0,106
1209,1/31/2017,OKC,17,25,33,19,0,94,SAS,31,21,27,29,0,108
1210,2/15/2017,SAS,30,24,31,22,0,107,ORL,16,21,27,15,0,79
1211,3/6/2017,HOU,39,15,28,28,0,110,SAS,23,24,34,31,0,112
1212,3/9/2017,SAS,28,21,22,21,0,92,OKC,29,27,26,20,0,102
1213,3/31/2017,SAS,16,25,30,29,0,100,OKC,25,29,22,19,0,95
1214,11/16/2016,HOU,32,31,27,13,0,103,OKC,38,27,20,20,0,105
1215,11/23/2016,TOR,24,30,36,25,0,115,HOU,20,19,35,28,0,102
1216,12/9/2016,HOU,25,30,31,16,0,102,OKC,23,26,28,22,0,99
1217,1/5/2017,OKC,38,18,27,33,0,116,HOU,33,34,30,21,0,118
1218,1/6/2017,HOU,19,25,35,21,0,100,ORL,22,30,23,18,0,93
1219,1/8/2017,HOU,27,34,34,34,0,129,TOR,37,26,36,23,0,122
1220,2/7/2017,ORL,28,26,30,20,0,104,HOU,35,35,24,34,0,128
1221,3/26/2017,OKC,31,28,29,37,0,125,HOU,37,42,34,24,0,137
1222,11/9/2016,TOR,20,42,26,24,0,112,OKC,27,28,20,27,0,102
1223,11/13/2016,ORL,27,30,25,37,0,119,OKC,13,34,37,33,0,117
1224,3/16/2017,OKC,29,29,39,26,0,123,TOR,24,24,22,32,0,102
1225,3/29/2017,OKC,20,24,28,30,12,114,ORL,18,31,33,20,4,106
1226,12/18/2016,TOR,23,32,29,25,0,109,ORL,30,21,13,15,0,79
1227,1/29/2017,ORL,27,33,22,32,0,114,TOR,36,15,27,35,0,113
1228,2/3/2017,TOR,24,30,12,28,0,94,ORL,28,24,21,29,0,102
1229,3/27/2017,ORL,34,23,32,23,0,112,TOR,35,38,26,32,0,131
