,date,away_team,away_q1,away_q2,away_q3,away_q4,away_OT,away_final,home_team,home_q1,home_q2,home_q3,home_q4,home_OT,home_final
0,10/17/2017,BOS,19,19,33,28,0,99,CLE,29,25,18,30,0,102
1,10/20/2017,CLE,25,30,31,30,0,116,MIL,25,24,24,24,0,97
2,10/21/2017,ORL,36,20,32,26,0,114,CLE,18,27,20,28,0,93
3,10/24/2017,CHI,38,30,24,20,0,112,CLE,28,37,26,28,0,119
4,10/25/2017,CLE,23,29,21,34,0,107,BRK,26,29,29,28,0,112
5,10/28/2017,CLE,22,30,31,18,0,101,NOP,35,30,24,34,0,123
6,10/29/2017,NYK,29,33,30,22,0,114,CLE,19,35,21,20,0,95
7,11/1/2017,IND,30,32,30,32,0,124,CLE,28,33,24,22,0,107
8,11/3/2017,CLE,42,32,30,26,0,130,WAS,36,30,27,29,0,122
9,11/5/2017,ATL,37,17,37,26,0,117,CLE,28,17,33,37,0,115
10,11/7/2017,MIL,28,39,23,29,0,119,CLE,39,26,29,30,0,124
11,11/9/2017,CLE,25,42,26,20,0,113,HOU,36,29,35,17,0,117
12,11/11/2017,CLE,29,20,34,28,0,111,DAL,23,29,22,30,0,104
13,11/13/2017,CLE,25,13,23,43,0,104,NYK,22,29,25,25,0,101
14,11/15/2017,CLE,36,25,27,27,0,115,CHO,30,37,17,23,0,107
15,11/17/2017,LAC,27,29,25,24,8,113,CLE,24,32,22,27,13,118
16,11/20/2017,CLE,36,37,28,15,0,116,DET,23,23,16,26,0,88
17,11/22/2017,BRK,17,29,31,32,0,109,CLE,20,25,32,42,0,119
18,11/24/2017,CHO,28,29,25,17,0,99,CLE,27,27,29,17,0,100
19,11/27/2017,CLE,29,24,33,27,0,113,PHI,22,23,28,18,0,91
20,11/28/2017,MIA,24,25,25,23,0,97,CLE,35,40,18,15,0,108
21,11/30/2017,CLE,42,21,36,22,0,121,ATL,35,32,23,24,0,114
22,12/2/2017,MEM,32,20,30,29,0,111,CLE,28,38,27,23,0,116
23,12/4/2017,CLE,29,32,25,27,0,113,CHI,22,23,26,20,0,91
24,12/6/2017,SAC,22,35,21,17,0,95,CLE,19,29,25,28,0,101
25,12/8/2017,CLE,33,30,23,16,0,102,IND,32,25,32,17,0,106
26,12/9/2017,PHI,24,22,27,25,0,98,CLE,23,29,26,27,0,105
27,12/12/2017,ATL,31,17,29,37,0,114,CLE,31,31,32,29,0,123
28,12/14/2017,LAL,26,34,26,26,0,112,CLE,24,39,31,27,0,121
29,12/16/2017,UTA,24,24,25,27,0,100,CLE,23,28,29,29,0,109
30,12/17/2017,CLE,27,33,23,23,0,106,WAS,23,37,23,16,0,99
31,12/19/2017,CLE,34,24,25,33,0,116,MIL,30,39,29,21,0,119
32,12/21/2017,CHI,27,29,23,33,0,112,CLE,29,29,24,33,0,115
33,12/25/2017,CLE,28,16,23,25,0,92,GSW,24,22,25,28,0,99
34,12/27/2017,CLE,27,28,25,15,0,95,SAC,28,34,23,24,0,109
35,12/30/2017,CLE,32,21,16,32,0,101,UTA,22,26,28,28,0,104
36,1/2/2018,POR,28,28,31,23,0,110,CLE,28,25,38,36,0,127
37,1/3/2018,CLE,21,26,21,20,0,88,BOS,32,23,26,21,0,102
38,1/6/2018,CLE,31,36,40,24,0,131,ORL,30,34,23,40,0,127
39,1/8/2018,CLE,18,24,25,32,0,99,MIN,32,37,33,25,0,127
40,1/11/2018,CLE,24,16,32,27,0,99,TOR,30,35,35,33,0,133
41,1/12/2018,CLE,34,24,16,21,0,95,IND,12,32,32,21,0,97
42,1/15/2018,GSW,35,22,36,25,0,118,CLE,37,27,27,17,0,108
43,1/18/2018,ORL,20,27,33,23,0,103,CLE,36,31,17,20,0,104
44,1/20/2018,OKC,43,33,38,34,0,148,CLE,24,36,34,30,0,124
45,1/23/2018,CLE,29,26,26,21,0,102,SAS,25,38,26,25,0,114
46,1/26/2018,IND,31,29,20,28,0,108,CLE,38,35,24,18,0,115
47,1/28/2018,DET,28,33,26,17,0,104,CLE,33,25,32,31,0,121
48,1/30/2018,CLE,27,36,21,30,0,114,DET,33,26,30,36,0,125
49,1/31/2018,MIA,21,29,22,17,0,89,CLE,27,21,24,19,0,91
50,2/3/2018,HOU,32,33,32,23,0,120,CLE,20,19,30,19,0,88
51,2/6/2018,CLE,43,24,22,9,0,98,ORL,31,20,41,24,0,116
52,2/7/2018,MIN,29,37,33,30,9,138,CLE,31,33,37,28,11,140
53,2/9/2018,CLE,31,30,36,26,0,123,ATL,27,29,26,25,0,107
54,2/11/2018,CLE,31,33,31,26,0,121,BOS,32,20,22,25,0,99
55,2/13/2018,CLE,29,33,29,29,0,120,OKC,28,29,30,25,0,112
56,2/22/2018,WAS,22,35,25,28,0,110,CLE,31,23,25,24,0,103
57,2/23/2018,CLE,20,34,31,27,0,112,MEM,27,22,22,18,0,89
58,2/25/2018,SAS,25,25,26,34,0,110,CLE,20,33,21,20,0,94
59,2/27/2018,BRK,29,32,30,32,0,123,CLE,25,35,34,35,0,129
60,3/1/2018,PHI,32,27,18,31,0,108,CLE,29,27,15,26,0,97
61,3/3/2018,DEN,37,36,30,23,0,126,CLE,31,31,35,20,0,117
62,3/5/2018,DET,28,21,21,20,0,90,CLE,26,28,36,22,0,112
63,3/7/2018,CLE,38,32,19,24,0,113,DEN,23,35,29,21,0,108
64,3/9/2018,CLE,17,30,30,25,0,102,LAC,35,26,24,31,0,116
65,3/11/2018,CLE,29,31,22,31,0,113,LAL,33,32,33,29,0,127
66,3/13/2018,CLE,38,30,34,27,0,129,PHO,18,34,28,27,0,107
67,3/15/2018,CLE,29,25,23,28,0,105,POR,29,30,29,25,0,113
68,3/17/2018,CLE,32,37,16,29,0,114,CHI,31,21,29,28,0,109
69,3/19/2018,MIL,25,32,28,32,0,117,CLE,26,38,29,31,0,124
70,3/21/2018,TOR,38,41,20,30,0,129,CLE,42,22,34,34,0,132
71,3/23/2018,PHO,27,18,26,24,0,95,CLE,23,39,31,27,0,120
72,3/25/2018,CLE,28,32,27,34,0,121,BRK,30,32,27,25,0,114
73,3/27/2018,CLE,18,16,25,20,0,79,MIA,29,25,21,23,0,98
74,3/28/2018,CLE,22,42,31,23,0,118,CHO,26,28,24,27,0,105
75,3/30/2018,NOP,29,28,22,23,0,102,CLE,29,18,33,27,0,107
76,4/1/2018,DAL,25,22,30,10,0,87,CLE,18,30,25,25,0,98
77,4/3/2018,TOR,24,28,26,28,0,106,CLE,28,32,26,26,0,112
78,4/5/2018,WAS,26,28,36,25,0,115,CLE,39,20,23,37,0,119
79,4/6/2018,CLE,28,27,43,32,0,130,PHI,41,37,27,27,0,132
80,4/9/2018,CLE,26,35,29,33,0,123,NYK,25,24,28,32,0,109
81,4/11/2018,NYK,20,37,27,26,0,110,CLE,20,17,34,27,0,98
82,10/18/2017,MIL,24,34,18,32,0,108,BOS,26,27,27,20,0,100
83,10/20/2017,BOS,24,22,23,33,0,102,PHI,21,29,22,20,0,92
84,10/24/2017,NYK,17,16,27,29,0,89,BOS,30,24,23,33,0,110
85,10/26/2017,BOS,28,15,29,24,0,96,MIL,23,21,25,20,0,89
86,10/28/2017,BOS,21,26,27,22,0,96,MIA,26,19,18,27,0,90
87,10/30/2017,SAS,26,23,18,27,0,94,BOS,30,24,26,28,0,108
88,11/1/2017,SAC,24,21,15,26,0,86,BOS,27,31,31,24,0,113
89,11/3/2017,BOS,18,19,30,34,0,101,OKC,31,24,16,23,0,94
90,11/5/2017,BOS,22,27,28,27,0,104,ORL,20,18,31,19,0,88
91,11/6/2017,BOS,26,28,28,28,0,110,ATL,25,29,21,32,0,107
92,11/8/2017,LAL,16,36,29,15,0,96,BOS,33,28,26,20,0,107
93,11/10/2017,CHO,26,31,19,11,0,87,BOS,11,30,23,26,0,90
94,11/12/2017,TOR,24,25,27,18,0,94,BOS,24,20,33,18,0,95
95,11/14/2017,BOS,30,22,28,29,0,109,BRK,21,31,19,31,0,102
96,11/16/2017,GSW,28,19,21,20,0,88,BOS,18,24,26,24,0,92
97,11/18/2017,BOS,20,24,36,30,0,110,ATL,35,15,27,22,0,99
98,11/20/2017,BOS,34,19,16,27,14,110,DAL,22,27,28,19,6,102
99,11/22/2017,BOS,16,25,22,35,0,98,MIA,27,27,25,25,0,104
100,11/24/2017,ORL,26,21,22,34,0,103,BOS,40,33,26,19,0,118
101,11/25/2017,BOS,27,18,37,26,0,108,IND,32,22,16,28,0,98
102,11/27/2017,DET,31,29,26,32,0,118,BOS,23,34,29,22,0,108
103,11/30/2017,PHI,22,22,27,26,0,97,BOS,28,26,22,32,0,108
104,12/2/2017,PHO,22,32,25,32,0,111,BOS,31,29,29,27,0,116
105,12/4/2017,MIL,26,23,32,19,0,100,BOS,34,28,26,23,0,111
106,12/6/2017,DAL,26,31,16,17,0,90,BOS,24,23,23,27,0,97
107,12/8/2017,BOS,31,24,27,20,0,102,SAS,26,30,21,28,0,105
108,12/10/2017,BOS,29,15,29,18,0,91,DET,21,16,22,22,0,81
109,12/11/2017,BOS,29,13,21,22,0,85,CHI,28,28,22,30,0,108
110,12/13/2017,DEN,31,28,33,26,0,118,BOS,30,38,29,27,0,124
111,12/15/2017,UTA,21,25,33,28,0,107,BOS,26,13,28,28,0,95
112,12/16/2017,BOS,31,17,23,31,0,102,MEM,12,28,33,20,0,93
113,12/18/2017,BOS,38,24,23,27,0,112,IND,21,26,31,33,0,111
114,12/20/2017,MIA,15,21,26,28,0,90,BOS,24,20,15,30,0,89
115,12/21/2017,BOS,15,25,28,25,0,93,NYK,25,19,24,34,0,102
116,12/23/2017,CHI,31,27,18,16,0,92,BOS,33,27,38,19,0,117
117,12/25/2017,WAS,30,22,28,31,0,111,BOS,24,26,26,27,0,103
118,12/27/2017,BOS,28,32,16,26,0,102,CHO,16,28,31,16,0,91
119,12/28/2017,HOU,32,30,16,20,0,98,BOS,12,26,31,30,0,99
120,12/31/2017,BRK,28,31,17,29,0,105,BOS,38,23,21,26,0,108
121,1/5/2018,MIN,19,19,24,22,0,84,BOS,19,22,25,25,0,91
122,1/6/2018,BOS,16,23,25,23,0,87,BRK,22,19,20,24,0,85
123,1/11/2018,BOS,23,25,37,29,0,114,PHI,28,29,22,24,0,103
124,1/16/2018,NOP,32,26,29,17,12,116,BOS,25,23,32,24,9,113
125,1/18/2018,PHI,21,18,32,18,0,89,BOS,19,13,21,27,0,80
126,1/21/2018,ORL,28,30,32,13,0,103,BOS,29,30,12,24,0,95
127,1/23/2018,BOS,21,32,21,33,0,107,LAL,15,30,31,32,0,108
128,1/24/2018,BOS,25,37,29,22,0,113,LAC,22,33,22,25,0,102
129,1/27/2018,BOS,37,17,19,32,0,105,GSW,27,23,30,29,0,109
130,1/29/2018,BOS,32,24,24,31,0,111,DEN,21,24,37,28,0,110
131,1/31/2018,NYK,24,21,20,8,0,73,BOS,27,23,31,22,0,103
132,2/2/2018,ATL,32,23,20,35,0,110,BOS,26,27,41,25,0,119
133,2/4/2018,POR,26,28,19,23,0,96,BOS,19,19,31,28,0,97
134,2/6/2018,BOS,18,19,23,31,0,91,TOR,22,36,25,28,0,111
135,2/8/2018,BOS,26,23,26,23,12,110,WAS,27,24,19,28,6,104
136,2/9/2018,IND,30,29,17,21,0,97,BOS,16,22,34,19,0,91
137,2/14/2018,LAC,34,27,32,36,0,129,BOS,25,32,34,28,0,119
138,2/23/2018,BOS,23,38,25,24,0,110,DET,28,21,28,21,0,98
139,2/24/2018,BOS,23,36,29,33,0,121,NYK,24,32,25,31,0,112
140,2/26/2018,MEM,24,17,28,29,0,98,BOS,33,34,19,23,0,109
141,2/28/2018,CHO,31,28,20,27,0,106,BOS,37,30,36,31,0,134
142,3/3/2018,BOS,32,32,25,31,0,120,HOU,30,28,28,37,0,123
143,3/5/2018,BOS,35,20,31,19,0,105,CHI,16,13,24,36,0,89
144,3/8/2018,BOS,35,25,26,31,0,117,MIN,28,18,28,35,0,109
145,3/11/2018,IND,24,16,34,25,0,99,BOS,25,25,20,27,0,97
146,3/14/2018,WAS,23,29,29,25,9,125,BOS,37,22,21,26,9,124
147,3/16/2018,BOS,25,23,27,17,0,92,ORL,16,15,21,31,0,83
148,3/18/2018,BOS,28,21,27,13,0,89,NOP,20,27,35,26,0,108
149,3/20/2018,OKC,26,22,27,24,0,99,BOS,18,27,28,27,0,100
150,3/23/2018,BOS,23,24,20,38,0,105,POR,26,26,25,23,0,100
151,3/25/2018,BOS,24,28,28,24,0,104,SAC,27,33,18,15,0,93
152,3/26/2018,BOS,31,17,29,25,0,102,PHO,15,30,20,29,0,94
153,3/28/2018,BOS,18,30,19,30,0,97,UTA,24,15,32,23,0,94
154,3/31/2018,TOR,33,22,29,15,0,99,BOS,31,22,29,28,0,110
155,4/3/2018,BOS,31,25,15,31,0,102,MIL,26,32,21,27,0,106
156,4/4/2018,BOS,20,13,20,25,0,78,TOR,14,29,24,29,0,96
157,4/6/2018,CHI,30,28,18,28,0,104,BOS,30,25,24,32,0,111
158,4/8/2018,ATL,24,25,27,36,0,112,BOS,31,27,24,24,0,106
159,4/10/2018,BOS,30,24,18,29,0,101,WAS,22,30,27,34,0,113
160,4/11/2018,BRK,22,21,27,27,0,97,BOS,27,26,30,27,0,110
161,10/18/2017,PHI,23,36,23,33,0,115,WAS,32,24,34,30,0,120
162,10/20/2017,DET,31,34,16,30,0,111,WAS,29,29,33,24,0,115
163,10/23/2017,WAS,29,27,22,31,0,109,DEN,29,26,22,27,0,104
164,10/25/2017,WAS,18,31,30,13,7,99,LAL,23,22,24,23,10,102
165,10/27/2017,WAS,34,33,30,20,0,117,GSW,27,26,34,33,0,120
166,10/29/2017,WAS,35,28,25,22,0,110,SAC,16,16,28,23,0,83
167,11/1/2017,PHO,15,37,35,35,0,122,WAS,32,32,26,26,0,116
168,11/5/2017,WAS,32,30,22,23,0,107,TOR,17,29,30,20,0,96
169,11/7/2017,DAL,36,28,26,23,0,113,WAS,34,19,23,23,0,99
170,11/9/2017,LAL,34,22,21,18,0,95,WAS,37,32,22,20,0,111
171,11/11/2017,ATL,19,23,25,27,0,94,WAS,20,29,27,37,0,113
172,11/13/2017,SAC,32,19,20,21,0,92,WAS,25,32,29,24,0,110
173,11/15/2017,WAS,30,31,10,31,0,102,MIA,19,30,25,19,0,93
174,11/17/2017,MIA,26,24,16,25,0,91,WAS,17,12,28,31,0,88
175,11/19/2017,WAS,28,27,21,15,0,91,TOR,28,32,19,21,0,100
176,11/20/2017,WAS,27,20,26,26,0,99,MIL,19,27,20,22,0,88
177,11/22/2017,WAS,26,33,29,26,10,124,CHO,25,30,29,30,15,129
178,11/25/2017,POR,27,14,32,35,0,108,WAS,30,22,31,22,0,105
179,11/28/2017,WAS,23,20,25,24,0,92,MIN,30,21,20,18,0,89
180,11/29/2017,WAS,18,22,25,48,0,113,PHI,28,30,26,34,0,118
181,12/1/2017,DET,26,26,15,24,0,91,WAS,26,20,35,28,0,109
182,12/4/2017,WAS,15,15,22,17,0,69,UTA,29,35,24,28,0,116
183,12/5/2017,WAS,24,27,28,27,0,106,POR,22,15,29,26,0,92
184,12/7/2017,WAS,26,31,28,24,0,109,PHO,28,24,32,15,0,99
185,12/9/2017,WAS,27,22,32,31,0,112,LAC,30,32,23,28,0,113
186,12/12/2017,WAS,22,29,27,20,0,98,BRK,30,21,28,24,0,103
187,12/13/2017,MEM,12,17,28,30,0,87,WAS,22,19,19,33,0,93
188,12/15/2017,LAC,18,25,21,27,0,91,WAS,25,23,27,25,0,100
189,12/19/2017,NOP,19,36,15,36,0,106,WAS,36,25,32,23,0,116
190,12/22/2017,WAS,23,20,18,23,0,84,BRK,26,27,35,31,0,119
191,12/23/2017,ORL,29,19,35,20,0,103,WAS,37,35,28,30,0,130
192,12/27/2017,WAS,29,28,19,23,0,99,ATL,29,26,23,35,0,113
193,12/29/2017,HOU,23,25,30,25,0,103,WAS,27,32,28,34,0,121
194,12/31/2017,CHI,38,25,26,21,0,110,WAS,30,29,24,31,0,114
195,1/3/2018,NYK,32,31,14,26,0,103,WAS,33,31,26,31,0,121
196,1/5/2018,WAS,33,25,29,15,0,102,MEM,24,26,22,28,0,100
197,1/6/2018,MIL,24,29,29,28,0,110,WAS,32,21,32,18,0,103
198,1/10/2018,UTA,25,21,37,24,0,107,WAS,32,18,27,27,0,104
199,1/12/2018,ORL,33,30,35,21,0,119,WAS,34,31,33,27,0,125
200,1/13/2018,BRK,18,21,35,33,6,113,WAS,33,26,24,24,12,119
201,1/15/2018,MIL,28,25,25,26,0,104,WAS,30,21,21,23,0,95
202,1/17/2018,WAS,36,25,18,30,0,109,CHO,38,39,25,31,0,133
203,1/19/2018,WAS,19,27,45,31,0,122,DET,29,17,28,38,0,112
204,1/22/2018,WAS,22,15,17,21,0,75,DAL,22,31,18,27,0,98
205,1/25/2018,WAS,20,20,34,38,0,112,OKC,25,29,28,39,0,121
206,1/27/2018,WAS,27,34,31,37,0,129,ATL,18,27,26,33,0,104
207,1/30/2018,OKC,25,29,22,20,0,96,WAS,30,23,22,27,0,102
208,2/1/2018,TOR,34,28,25,32,0,119,WAS,27,28,33,34,0,122
209,2/3/2018,WAS,31,25,31,28,0,115,ORL,25,22,22,29,0,98
210,2/5/2018,WAS,28,30,28,25,0,111,IND,23,26,25,28,0,102
211,2/6/2018,WAS,20,35,29,18,0,102,PHI,37,28,29,21,0,115
212,2/10/2018,WAS,30,26,26,19,0,101,CHI,22,24,24,20,0,90
213,2/14/2018,WAS,26,25,39,28,0,118,NYK,39,33,15,26,0,113
214,2/23/2018,CHO,36,31,27,28,0,122,WAS,26,29,27,23,0,105
215,2/25/2018,PHI,28,20,25,21,0,94,WAS,30,37,20,22,0,109
216,2/27/2018,WAS,40,24,20,23,0,107,MIL,22,28,31,23,0,104
217,2/28/2018,GSW,36,22,27,24,0,109,WAS,21,35,14,31,0,101
218,3/2/2018,TOR,19,32,26,25,0,102,WAS,27,20,27,21,0,95
219,3/4/2018,IND,30,25,25,18,0,98,WAS,20,25,20,30,0,95
220,3/6/2018,MIA,26,24,30,25,8,113,WAS,31,28,27,19,12,117
221,3/9/2018,WAS,22,31,30,33,0,116,NOP,19,19,24,35,0,97
222,3/10/2018,WAS,20,28,28,26,0,102,MIA,26,34,43,26,0,129
223,3/13/2018,MIN,25,28,29,34,0,116,WAS,26,33,31,21,0,111
224,3/17/2018,IND,20,25,26,31,0,102,WAS,25,32,29,23,0,109
225,3/21/2018,WAS,18,26,16,30,0,90,SAS,18,32,27,21,0,98
226,3/23/2018,DEN,23,32,23,30,0,108,WAS,16,27,33,24,0,100
227,3/25/2018,NYK,19,42,16,24,0,101,WAS,21,32,18,26,0,97
228,3/27/2018,SAS,24,21,21,40,0,106,WAS,21,38,29,28,0,116
229,3/29/2018,WAS,24,25,17,26,0,92,DET,23,26,32,22,0,103
230,3/31/2018,CHO,27,24,23,19,0,93,WAS,30,20,37,20,0,107
231,4/1/2018,WAS,27,32,16,19,0,94,CHI,36,32,19,26,0,113
232,4/3/2018,WAS,24,25,26,29,0,104,HOU,35,36,24,25,0,120
233,4/6/2018,ATL,21,31,29,22,0,103,WAS,22,26,29,20,0,97
234,4/11/2018,WAS,23,22,30,17,0,92,ORL,26,29,21,25,0,101
235,10/18/2017,CHO,27,18,25,20,0,90,DET,29,27,26,20,0,102
236,10/20/2017,ATL,28,28,17,18,0,91,CHO,18,31,35,25,0,109
237,10/23/2017,CHO,25,29,23,17,0,94,MIL,18,35,30,20,0,103
238,10/25/2017,DEN,23,16,29,25,0,93,CHO,27,35,23,25,0,110
239,10/27/2017,HOU,27,29,22,31,0,109,CHO,30,16,28,19,0,93
240,10/29/2017,ORL,24,25,37,27,0,113,CHO,27,34,32,27,0,120
241,10/30/2017,CHO,31,20,22,31,0,104,MEM,31,26,25,17,0,99
242,11/1/2017,MIL,32,25,31,33,0,121,CHO,25,35,28,38,0,126
243,11/3/2017,CHO,19,26,26,30,0,101,SAS,25,24,31,28,0,108
244,11/5/2017,CHO,28,23,28,15,0,94,MIN,28,40,29,15,0,112
245,11/7/2017,CHO,41,28,25,19,0,113,NYK,32,26,25,35,0,118
246,11/17/2017,CHO,27,33,32,28,0,120,CHI,26,34,23,40,0,123
247,11/18/2017,LAC,24,22,25,16,0,87,CHO,25,30,18,29,0,102
248,11/20/2017,MIN,24,28,28,22,0,102,CHO,26,29,29,34,0,118
249,11/25/2017,SAS,14,26,32,34,0,106,CHO,15,14,29,28,0,86
250,11/29/2017,CHO,25,27,33,28,0,113,TOR,32,39,22,33,0,126
251,12/1/2017,CHO,30,19,26,25,0,100,MIA,22,28,29,26,0,105
252,12/4/2017,ORL,23,22,29,20,0,94,CHO,26,28,21,29,0,104
253,12/6/2017,GSW,26,27,26,22,0,101,CHO,18,20,30,19,0,87
254,12/8/2017,CHI,31,21,23,31,13,119,CHO,25,27,27,27,5,111
255,12/9/2017,LAL,28,24,24,34,0,110,CHO,29,27,19,24,0,99
256,12/11/2017,CHO,34,18,40,24,0,116,OKC,26,26,22,29,0,103
257,12/13/2017,CHO,23,26,20,27,0,96,HOU,38,25,28,17,0,108
258,12/15/2017,MIA,24,29,26,25,0,104,CHO,19,28,24,27,0,98
259,12/16/2017,POR,24,25,25,19,0,93,CHO,20,17,30,24,0,91
260,12/18/2017,NYK,23,19,22,27,0,91,CHO,29,31,28,21,0,109
261,12/20/2017,TOR,22,41,36,30,0,129,CHO,26,21,32,32,0,111
262,12/22/2017,CHO,23,36,26,19,0,104,MIL,26,26,31,26,0,109
263,12/23/2017,MIL,23,31,31,21,0,106,CHO,24,29,28,30,0,111
264,12/29/2017,CHO,32,21,26,32,0,111,GSW,29,24,22,25,0,100
265,12/31/2017,CHO,22,30,14,32,0,98,LAC,29,13,33,31,0,106
266,1/2/2018,CHO,32,40,28,31,0,131,SAC,25,27,29,30,0,111
267,1/5/2018,CHO,28,35,30,15,0,108,LAL,24,24,28,18,0,94
268,1/10/2018,DAL,20,39,24,32,0,115,CHO,28,24,25,34,0,111
269,1/12/2018,UTA,25,21,26,16,0,88,CHO,25,27,22,25,0,99
270,1/13/2018,OKC,31,24,18,28,0,101,CHO,28,31,17,15,0,91
271,1/15/2018,CHO,27,23,34,34,0,118,DET,27,29,24,27,0,107
272,1/20/2018,MIA,31,26,16,33,0,106,CHO,27,21,35,22,0,105
273,1/22/2018,SAC,33,22,20,32,0,107,CHO,35,32,25,20,0,112
274,1/24/2018,NOP,32,24,20,25,0,101,CHO,21,32,20,23,0,96
275,1/26/2018,ATL,26,26,34,24,0,110,CHO,30,31,29,31,0,121
276,1/27/2018,CHO,26,22,30,13,0,91,MIA,22,32,17,24,0,95
277,1/29/2018,CHO,23,28,27,18,0,96,IND,23,29,29,24,0,105
278,1/31/2018,CHO,35,29,33,26,0,123,ATL,28,24,32,26,0,110
279,2/2/2018,IND,37,20,34,35,0,126,CHO,49,22,25,37,0,133
280,2/4/2018,CHO,25,23,38,29,0,115,PHO,31,28,35,16,0,110
281,2/5/2018,CHO,25,37,22,20,0,104,DEN,36,27,34,24,0,121
282,2/8/2018,CHO,18,27,20,32,6,103,POR,29,20,30,18,12,109
283,2/9/2018,CHO,24,22,31,17,0,94,UTA,28,27,29,22,0,106
284,2/11/2018,TOR,30,32,28,33,0,123,CHO,26,29,19,29,0,103
285,2/14/2018,CHO,20,34,31,19,0,104,ORL,26,27,25,24,0,102
286,2/22/2018,BRK,28,25,21,22,0,96,CHO,32,23,25,31,0,111
287,2/25/2018,DET,19,27,25,27,0,98,CHO,32,38,26,18,0,114
288,2/27/2018,CHI,29,22,27,25,0,103,CHO,26,25,36,31,0,118
289,3/2/2018,CHO,30,26,24,19,0,99,PHI,27,21,26,36,0,110
290,3/4/2018,CHO,21,22,26,29,0,98,TOR,26,26,30,21,0,103
291,3/6/2018,PHI,32,39,30,27,0,128,CHO,29,30,32,23,0,114
292,3/8/2018,BRK,35,30,31,29,0,125,CHO,29,30,26,26,0,111
293,3/10/2018,PHO,25,26,21,43,0,115,CHO,32,27,35,28,0,122
294,3/13/2018,CHO,32,33,27,23,0,115,NOP,37,35,20,27,0,119
295,3/15/2018,CHO,33,30,34,32,0,129,ATL,23,32,24,38,0,117
296,3/17/2018,CHO,24,26,17,34,0,101,NYK,22,35,42,25,0,124
297,3/19/2018,CHO,18,38,14,24,0,94,PHI,21,28,32,27,0,108
298,3/21/2018,CHO,22,21,32,36,0,111,BRK,34,28,25,18,0,105
299,3/22/2018,MEM,14,28,15,22,0,79,CHO,37,38,37,28,0,140
300,3/24/2018,CHO,22,32,25,23,0,102,DAL,27,21,22,28,0,98
301,3/26/2018,NYK,22,27,33,35,11,128,CHO,27,35,25,30,20,137
302,4/1/2018,PHI,28,32,31,28,0,119,CHO,29,22,27,24,0,102
303,4/3/2018,CHO,22,25,32,35,0,114,CHI,19,34,33,34,0,120
304,4/6/2018,CHO,43,29,31,34,0,137,ORL,25,24,26,25,0,100
305,4/8/2018,IND,31,39,25,28,0,123,CHO,25,32,24,36,0,117
306,4/10/2018,CHO,37,26,24,32,0,119,IND,25,30,16,22,0,93
307,10/18/2017,MIN,25,24,28,22,0,99,SAS,32,21,34,20,0,107
308,10/20/2017,UTA,16,26,23,32,0,97,MIN,19,27,24,30,0,100
309,10/22/2017,MIN,28,33,27,27,0,115,OKC,23,31,21,38,0,113
310,10/24/2017,IND,33,28,37,32,0,130,MIN,20,41,23,23,0,107
311,10/25/2017,MIN,26,18,29,28,0,101,DET,23,40,28,31,0,122
312,10/27/2017,OKC,33,26,30,27,0,116,MIN,26,33,31,29,0,119
313,10/30/2017,MIN,23,37,19,31,15,125,MIA,32,30,20,28,12,122
314,11/1/2017,MIN,31,34,18,21,0,104,NOP,28,26,23,21,0,98
315,11/4/2017,DAL,18,31,20,30,0,99,MIN,27,32,34,19,0,112
316,11/8/2017,MIN,22,28,26,25,0,101,GSW,22,29,44,30,0,125
317,11/11/2017,MIN,28,32,28,22,0,110,PHO,19,37,29,33,0,118
318,11/13/2017,MIN,33,24,31,21,0,109,UTA,14,28,23,33,0,98
319,11/15/2017,SAS,24,19,22,21,0,86,MIN,18,39,18,23,0,98
320,11/17/2017,MIN,24,19,31,37,0,111,DAL,29,26,17,15,0,87
321,11/19/2017,DET,22,27,22,29,0,100,MIN,24,29,27,17,0,97
322,11/22/2017,ORL,35,27,18,38,0,118,MIN,30,35,41,18,0,124
323,11/24/2017,MIA,28,30,23,28,0,109,MIN,24,24,22,27,0,97
324,11/26/2017,PHO,27,31,22,28,0,108,MIN,33,30,30,26,0,119
325,11/29/2017,MIN,28,34,31,27,0,120,NOP,29,20,27,26,0,102
326,12/1/2017,MIN,33,21,25,28,0,107,OKC,42,22,21,26,0,111
327,12/3/2017,LAC,27,28,21,30,0,106,MIN,31,29,18,34,0,112
328,12/4/2017,MIN,26,27,22,17,0,92,MEM,29,27,20,19,0,95
329,12/6/2017,MIN,29,33,26,25,0,113,LAC,22,27,31,27,0,107
330,12/10/2017,DAL,24,24,21,23,0,92,MIN,23,24,24,26,0,97
331,12/12/2017,PHI,20,28,26,26,18,118,MIN,27,24,25,24,12,112
332,12/14/2017,SAC,22,33,16,25,0,96,MIN,32,32,31,24,0,119
333,12/16/2017,PHO,22,20,35,31,0,108,MIN,25,25,31,25,0,106
334,12/18/2017,POR,24,30,31,22,0,107,MIN,24,27,25,32,0,108
335,12/20/2017,MIN,17,33,30,32,0,112,DEN,24,28,32,20,0,104
336,12/23/2017,MIN,33,31,22,29,0,115,PHO,24,19,37,26,0,106
337,12/25/2017,MIN,29,24,30,38,0,121,LAL,20,32,28,24,0,104
338,12/27/2017,DEN,23,35,24,32,11,125,MIN,35,36,17,26,14,128
339,12/28/2017,MIN,26,30,28,12,0,96,MIL,16,30,29,27,0,102
340,12/31/2017,MIN,23,26,38,20,0,107,IND,13,25,20,32,0,90
341,1/1/2018,LAL,18,30,28,20,0,96,MIN,30,30,31,23,0,114
342,1/3/2018,MIN,22,21,30,24,0,97,BRK,24,24,23,27,0,98
343,1/6/2018,NOP,24,24,23,27,0,98,MIN,36,33,29,18,0,116
344,1/10/2018,OKC,23,24,18,23,0,88,MIN,23,24,29,28,0,104
345,1/12/2018,NYK,27,30,29,22,0,108,MIN,24,31,32,31,0,118
346,1/14/2018,POR,33,10,31,29,0,103,MIN,31,26,34,29,0,120
347,1/16/2018,MIN,25,23,27,27,0,102,ORL,25,22,26,35,0,108
348,1/18/2018,MIN,17,33,20,28,0,98,HOU,26,37,26,27,0,116
349,1/20/2018,TOR,28,34,21,26,0,109,MIN,26,28,33,28,0,115
350,1/22/2018,MIN,30,31,31,34,0,126,LAC,26,31,33,28,0,118
351,1/24/2018,MIN,29,25,30,30,0,114,POR,25,29,43,26,0,123
352,1/25/2018,MIN,29,33,31,20,0,113,GSW,38,36,32,20,0,126
353,1/27/2018,BRK,11,31,23,32,0,97,MIN,30,24,24,33,0,111
354,1/29/2018,MIN,32,26,21,21,0,100,ATL,27,28,21,29,0,105
355,1/30/2018,MIN,27,30,23,24,0,104,TOR,19,32,27,31,0,109
356,2/1/2018,MIL,17,22,22,28,0,89,MIN,23,37,19,29,0,108
357,2/3/2018,NOP,29,24,28,26,0,107,MIN,37,29,29,23,0,118
358,2/9/2018,MIN,27,40,19,27,0,113,CHI,30,26,33,25,0,114
359,2/11/2018,SAC,29,25,26,26,0,106,MIN,23,33,19,36,0,111
360,2/13/2018,HOU,23,31,30,42,0,126,MIN,31,19,30,28,0,108
361,2/15/2018,LAL,39,26,26,20,0,111,MIN,35,27,22,35,0,119
362,2/23/2018,MIN,32,22,21,27,0,102,HOU,26,29,33,32,0,120
363,2/24/2018,CHI,24,38,20,22,0,104,MIN,31,29,26,36,0,122
364,2/26/2018,MIN,29,34,34,21,0,118,SAC,29,31,17,23,0,100
365,3/1/2018,MIN,24,25,29,21,0,99,POR,19,25,31,33,0,108
366,3/2/2018,MIN,24,21,32,31,0,108,UTA,23,33,29,31,0,116
367,3/11/2018,GSW,24,38,22,19,0,103,MIN,34,21,29,25,0,109
368,3/17/2018,MIN,24,26,31,20,0,101,SAS,23,38,29,27,0,117
369,3/18/2018,HOU,38,39,30,22,0,129,MIN,23,33,35,29,0,120
370,3/20/2018,LAC,32,26,25,26,0,109,MIN,28,31,36,28,0,123
371,3/23/2018,MIN,31,26,27,24,0,108,NYK,22,26,34,22,0,104
372,3/24/2018,MIN,24,28,19,37,0,108,PHI,32,27,39,22,0,120
373,3/26/2018,MEM,26,33,19,23,0,101,MIN,25,34,23,11,0,93
374,3/28/2018,ATL,32,25,31,26,0,114,MIN,34,31,33,28,0,126
375,3/30/2018,MIN,16,28,23,26,0,93,DAL,20,26,18,28,0,92
376,4/1/2018,UTA,28,33,26,34,0,121,MIN,26,24,21,26,0,97
377,4/5/2018,MIN,24,30,18,24,0,96,DEN,27,24,28,21,0,100
378,4/6/2018,MIN,30,21,29,33,0,113,LAL,26,32,15,23,0,96
379,4/9/2018,MEM,26,27,22,19,0,94,MIN,20,36,27,30,0,113
380,4/11/2018,DEN,26,28,27,20,5,106,MIN,29,33,24,15,11,112
381,10/18/2017,ATL,27,31,24,35,0,117,DAL,24,23,35,29,0,111
382,10/20/2017,SAC,19,27,25,22,0,93,DAL,23,23,14,28,0,88
383,10/21/2017,DAL,20,19,19,33,0,91,HOU,33,29,30,15,0,107
384,10/23/2017,GSW,40,25,34,34,0,133,DAL,24,38,22,19,0,103
385,10/25/2017,MEM,18,31,23,22,0,94,DAL,32,25,22,24,0,103
386,10/26/2017,DAL,14,21,33,23,0,91,MEM,28,26,22,20,0,96
387,10/28/2017,PHI,32,25,32,23,0,112,DAL,23,33,22,32,0,110
388,10/30/2017,DAL,27,26,15,21,0,89,UTA,21,23,32,28,0,104
389,11/1/2017,DAL,29,19,29,21,0,98,LAC,32,34,29,24,0,119
390,11/3/2017,NOP,28,27,20,24,0,99,DAL,25,21,17,31,0,94
391,11/12/2017,DAL,20,22,25,32,0,99,OKC,18,26,39,29,0,112
392,11/14/2017,SAS,17,27,18,35,0,97,DAL,16,23,21,31,0,91
393,11/18/2017,MIL,24,20,17,18,0,79,DAL,33,23,26,29,0,111
394,11/22/2017,DAL,12,27,35,21,0,95,MEM,27,29,16,22,0,94
395,11/25/2017,OKC,24,13,18,26,0,81,DAL,25,27,26,19,0,97
396,11/27/2017,DAL,23,30,22,33,0,108,SAS,21,25,31,38,0,115
397,11/29/2017,BRK,21,27,32,29,0,109,DAL,27,20,29,28,0,104
398,12/2/2017,LAC,17,21,28,16,0,82,DAL,24,35,27,22,0,108
399,12/4/2017,DEN,23,24,35,23,0,105,DAL,39,25,29,29,0,122
400,12/8/2017,DAL,25,29,24,24,0,102,MIL,22,27,28,32,0,109
401,12/12/2017,SAS,23,21,25,20,0,89,DAL,30,16,21,28,0,95
402,12/14/2017,DAL,28,20,25,24,0,97,GSW,24,24,32,32,0,112
403,12/16/2017,DAL,31,22,27,16,0,96,SAS,18,25,28,27,0,98
404,12/18/2017,PHO,25,24,19,29,0,97,DAL,22,28,25,16,0,91
405,12/20/2017,DET,25,28,13,27,0,93,DAL,22,43,24,21,0,110
406,12/22/2017,DAL,23,30,20,28,0,101,MIA,32,21,29,31,0,113
407,12/23/2017,DAL,25,28,27,27,0,107,ATL,25,23,31,33,0,112
408,12/26/2017,TOR,23,30,24,16,0,93,DAL,31,26,28,13,0,98
409,12/27/2017,DAL,22,31,18,27,0,98,IND,29,25,20,20,0,94
410,12/29/2017,DAL,36,41,32,19,0,128,NOP,21,39,41,19,0,120
411,12/31/2017,DAL,35,22,27,32,0,116,OKC,32,31,22,28,0,113
412,1/3/2018,GSW,35,32,24,34,0,125,DAL,26,35,28,33,0,122
413,1/5/2018,CHI,34,23,23,47,0,127,DAL,28,25,35,36,0,124
414,1/7/2018,NYK,33,23,19,25,0,100,DAL,25,27,19,25,0,96
415,1/9/2018,ORL,19,29,27,24,0,99,DAL,25,18,39,32,0,114
416,1/13/2018,LAL,31,15,24,25,12,107,DAL,20,32,21,22,6,101
417,1/16/2018,DAL,27,21,21,33,0,102,DEN,30,31,25,19,0,105
418,1/20/2018,DAL,20,25,34,29,0,108,POR,33,29,29,26,0,117
419,1/24/2018,HOU,38,13,34,19,0,104,DAL,28,17,22,30,0,97
420,1/26/2018,POR,17,35,23,32,0,107,DAL,25,19,24,25,0,93
421,1/27/2018,DAL,26,16,32,15,0,89,DEN,30,20,16,25,0,91
422,1/29/2018,MIA,22,29,24,20,0,95,DAL,26,20,15,27,0,88
423,1/31/2018,DAL,17,29,15,27,0,88,PHO,36,21,24,21,0,102
424,2/3/2018,DAL,27,29,25,25,0,106,SAC,28,26,31,14,0,99
425,2/5/2018,DAL,28,27,27,19,0,101,LAC,32,26,20,26,0,104
426,2/8/2018,DAL,33,27,25,18,0,103,GSW,23,37,33,28,0,121
427,2/10/2018,LAL,36,30,29,28,0,123,DAL,34,31,35,30,0,130
428,2/11/2018,DAL,19,36,20,22,0,97,HOU,27,30,30,17,0,104
429,2/13/2018,SAC,29,36,23,26,0,114,DAL,16,28,27,38,0,109
430,2/23/2018,DAL,17,24,35,26,0,102,LAL,32,31,32,29,0,124
431,2/24/2018,DAL,23,27,21,19,0,90,UTA,35,18,21,23,0,97
432,2/26/2018,IND,23,20,22,38,0,103,DAL,23,26,19,41,0,109
433,2/28/2018,OKC,32,22,23,23,11,111,DAL,21,22,33,24,10,110
434,3/2/2018,DAL,32,17,36,15,0,100,CHI,24,23,31,30,0,108
435,3/4/2018,NOP,33,32,26,35,0,126,DAL,25,24,29,31,0,109
436,3/6/2018,DEN,25,37,23,22,0,107,DAL,29,29,38,22,0,118
437,3/10/2018,MEM,13,17,33,17,0,80,DAL,31,25,28,30,0,114
438,3/11/2018,HOU,25,23,32,25,0,105,DAL,14,33,16,19,0,82
439,3/13/2018,DAL,29,28,26,27,0,110,NYK,31,29,12,25,0,97
440,3/16/2018,DAL,27,33,24,22,9,115,TOR,29,25,24,28,16,122
441,3/17/2018,DAL,24,32,33,17,0,106,BRK,30,29,29,26,0,114
442,3/20/2018,DAL,30,22,28,25,0,105,NOP,29,25,26,35,0,115
443,3/22/2018,UTA,37,28,31,23,0,119,DAL,34,24,23,31,0,112
444,3/27/2018,DAL,25,28,22,28,0,103,SAC,20,25,25,27,0,97
445,3/28/2018,DAL,34,22,25,12,0,93,LAL,32,23,27,21,0,103
446,4/3/2018,POR,22,27,29,31,0,109,DAL,22,28,32,33,0,115
447,4/4/2018,DAL,22,29,23,26,0,100,ORL,33,23,21,28,0,105
448,4/6/2018,DAL,24,30,21,26,5,106,DET,22,31,25,23,12,113
449,4/8/2018,DAL,20,28,28,21,0,97,PHI,28,33,24,24,0,109
450,4/10/2018,PHO,29,15,39,41,0,124,DAL,26,28,22,21,0,97
451,10/21/2017,POR,26,29,25,30,0,110,MIL,24,36,24,29,0,113
452,10/29/2017,MIL,28,33,31,25,0,117,ATL,16,32,25,33,0,106
453,10/31/2017,OKC,31,29,25,25,0,110,MIL,23,19,22,27,0,91
454,11/3/2017,MIL,26,22,24,24,0,96,DET,28,31,23,23,0,105
455,11/10/2017,MIL,25,21,30,18,0,94,SAS,27,20,23,17,0,87
456,11/11/2017,LAL,17,32,18,23,0,90,MIL,24,27,26,21,0,98
457,11/13/2017,MEM,29,36,12,26,0,103,MIL,34,26,24,26,0,110
458,11/15/2017,DET,23,18,21,33,0,95,MIL,26,15,34,24,0,99
459,11/22/2017,MIL,33,21,30,21,8,113,PHO,23,21,31,30,2,107
460,11/25/2017,MIL,30,27,28,23,0,108,UTA,31,33,31,26,0,121
461,11/28/2017,MIL,32,29,31,20,0,112,SAC,26,11,22,28,0,87
462,11/30/2017,MIL,33,27,27,16,0,103,POR,21,24,21,25,0,91
463,12/2/2017,SAC,25,27,24,28,0,104,MIL,33,30,25,21,0,109
464,12/6/2017,DET,27,24,25,24,0,100,MIL,30,30,16,28,0,104
465,12/9/2017,UTA,19,23,24,34,0,100,MIL,29,22,32,34,0,117
466,12/13/2017,MIL,37,26,22,23,0,108,NOP,32,30,25,28,0,115
467,12/15/2017,CHI,33,26,23,33,0,115,MIL,30,28,24,27,0,109
468,12/16/2017,MIL,25,30,24,32,0,111,HOU,28,27,29,31,0,115
469,12/26/2017,CHI,22,34,27,32,0,115,MIL,31,22,30,23,0,106
470,12/29/2017,MIL,38,20,15,24,0,97,OKC,18,26,23,28,0,95
471,1/1/2018,MIL,30,26,28,30,13,127,TOR,35,25,28,26,17,131
472,1/3/2018,IND,26,26,24,25,0,101,MIL,34,28,31,29,0,122
473,1/5/2018,TOR,33,28,43,25,0,129,MIL,24,35,19,32,0,110
474,1/8/2018,MIL,16,22,27,31,0,96,IND,37,27,24,21,0,109
475,1/10/2018,ORL,29,17,23,34,0,103,MIL,30,23,36,21,0,110
476,1/12/2018,GSW,36,27,17,28,0,108,MIL,27,22,33,12,0,94
477,1/14/2018,MIL,23,20,16,20,0,79,MIA,21,20,30,26,0,97
478,1/17/2018,MIA,30,22,26,28,0,106,MIL,25,32,22,22,0,101
479,1/20/2018,MIL,29,26,25,14,0,94,PHI,37,24,23,32,0,116
480,1/22/2018,PHO,26,27,26,26,0,105,MIL,30,23,23,33,0,109
481,1/26/2018,BRK,15,20,37,19,0,91,MIL,33,25,23,35,0,116
482,1/28/2018,MIL,26,35,25,24,0,110,CHI,20,22,30,24,0,96
483,1/29/2018,PHI,30,23,22,20,0,95,MIL,28,27,28,24,0,107
484,2/2/2018,NYK,29,26,19,16,0,90,MIL,28,27,19,18,0,92
485,2/4/2018,MIL,36,26,21,26,0,109,BRK,22,19,31,22,0,94
486,2/6/2018,MIL,25,25,26,27,0,103,NYK,26,20,17,26,0,89
487,2/9/2018,MIL,23,23,8,31,0,85,MIA,19,23,30,19,0,91
488,2/10/2018,MIL,24,26,28,33,0,111,ORL,29,25,20,30,0,104
489,2/13/2018,ATL,24,19,18,31,0,92,MIL,21,20,33,23,0,97
490,2/15/2018,DEN,35,39,33,27,0,134,MIL,28,34,26,35,0,123
491,2/23/2018,MIL,23,42,31,14,12,122,TOR,29,28,31,22,9,119
492,2/25/2018,NOP,21,28,38,27,9,123,MIL,32,34,19,29,7,121
493,2/28/2018,MIL,32,12,26,17,0,87,DET,32,21,32,25,0,110
494,3/2/2018,IND,18,27,33,25,0,103,MIL,21,25,21,29,0,96
495,3/4/2018,PHI,43,29,14,24,0,110,MIL,31,29,33,25,0,118
496,3/5/2018,MIL,17,29,23,20,0,89,IND,20,24,29,19,0,92
497,3/7/2018,HOU,24,34,29,23,0,110,MIL,22,24,30,23,0,99
498,3/9/2018,NYK,22,33,34,23,0,112,MIL,26,34,31,29,0,120
499,3/12/2018,MIL,32,32,26,31,0,121,MEM,24,26,23,30,0,103
500,3/14/2018,MIL,20,32,28,37,0,117,ORL,36,25,30,35,0,126
501,3/17/2018,ATL,31,19,37,30,0,117,MIL,26,30,39,27,0,122
502,3/21/2018,LAC,38,26,33,30,0,127,MIL,24,33,26,37,0,120
503,3/23/2018,MIL,24,37,29,28,0,118,CHI,34,27,21,23,0,105
504,3/25/2018,SAS,15,32,28,28,0,103,MIL,27,20,41,18,0,106
505,3/27/2018,MIL,29,27,26,16,0,98,LAC,35,27,16,27,0,105
506,3/29/2018,MIL,29,29,34,24,0,116,GSW,27,22,23,35,0,107
507,3/30/2018,MIL,39,29,29,15,12,124,LAL,34,23,26,29,10,122
508,4/1/2018,MIL,34,20,38,19,14,125,DEN,22,41,16,32,17,128
509,4/5/2018,BRK,30,22,31,36,0,119,MIL,24,21,36,30,0,111
510,4/7/2018,MIL,31,22,27,35,0,115,NYK,28,27,22,25,0,102
511,4/9/2018,ORL,21,21,25,19,0,86,MIL,31,14,29,28,0,102
512,4/11/2018,MIL,18,26,31,20,0,95,PHI,46,34,25,25,0,130
513,10/21/2017,PHI,19,30,22,23,0,94,TOR,36,26,40,26,0,128
514,10/23/2017,PHI,31,25,19,22,0,97,DET,22,21,24,19,0,86
515,10/25/2017,HOU,31,25,23,26,0,105,PHI,33,21,26,24,0,104
516,10/30/2017,PHI,37,21,34,23,0,115,HOU,27,29,24,27,0,107
517,11/1/2017,ATL,25,32,36,16,0,109,PHI,34,25,34,26,0,119
518,11/3/2017,IND,28,35,26,21,0,110,PHI,30,26,36,29,0,121
519,11/7/2017,PHI,32,14,34,24,0,104,UTA,21,23,27,26,0,97
520,11/9/2017,PHI,26,31,24,27,0,108,SAC,26,38,20,25,0,109
521,11/11/2017,PHI,28,36,21,29,0,114,GSW,32,33,36,34,0,135
522,11/13/2017,PHI,36,19,22,32,0,109,LAC,28,25,26,26,0,105
523,11/15/2017,PHI,29,29,25,32,0,115,LAL,26,28,30,25,0,109
524,11/18/2017,GSW,28,24,47,25,0,124,PHI,47,27,15,27,0,116
525,11/20/2017,UTA,15,21,27,23,0,86,PHI,25,22,28,32,0,107
526,11/22/2017,POR,14,23,20,24,0,81,PHI,26,24,20,31,0,101
527,11/25/2017,ORL,28,27,30,26,0,111,PHI,31,39,31,29,0,130
528,12/2/2017,DET,25,22,33,23,0,103,PHI,32,31,17,28,0,108
529,12/4/2017,PHO,28,32,29,26,0,115,PHI,28,19,32,22,0,101
530,12/7/2017,LAL,32,25,22,28,0,107,PHI,25,24,21,34,0,104
531,12/10/2017,PHI,26,29,40,29,0,124,NOP,32,34,21,44,0,131
532,12/15/2017,OKC,28,27,26,13,8,119,PHI,23,24,30,17,8,117
533,12/18/2017,PHI,25,34,28,28,0,115,CHI,30,37,22,28,0,117
534,12/19/2017,SAC,30,18,23,30,0,101,PHI,27,30,21,17,0,95
535,12/21/2017,TOR,30,22,34,28,0,114,PHI,31,34,23,21,0,109
536,12/23/2017,PHI,27,19,17,23,0,86,TOR,27,28,26,21,0,102
537,12/25/2017,PHI,21,29,29,26,0,105,NYK,24,24,27,23,0,98
538,12/28/2017,PHI,30,21,34,25,0,110,POR,27,25,20,42,0,114
539,12/30/2017,PHI,31,27,25,24,0,107,DEN,29,32,19,22,0,102
540,12/31/2017,PHI,38,25,29,31,0,123,PHO,32,17,40,21,0,110
541,1/3/2018,SAS,22,27,35,22,0,106,PHI,27,33,28,24,0,112
542,1/5/2018,DET,15,17,29,17,0,78,PHI,32,30,35,17,0,114
543,1/15/2018,TOR,23,26,26,36,0,111,PHI,32,27,34,24,0,117
544,1/22/2018,PHI,30,25,28,18,0,101,MEM,19,30,25,31,0,105
545,1/24/2018,CHI,16,25,26,34,0,101,PHI,25,30,30,30,0,115
546,1/26/2018,PHI,25,25,31,16,0,97,SAS,13,18,30,17,0,78
547,1/28/2018,PHI,29,29,25,29,0,112,OKC,31,26,35,30,0,122
548,1/31/2018,PHI,34,31,23,20,0,108,BRK,30,34,27,25,0,116
549,2/2/2018,MIA,23,18,19,37,0,97,PHI,24,27,35,17,0,103
550,2/3/2018,PHI,27,30,18,17,0,92,IND,33,29,14,24,0,100
551,2/9/2018,NOP,14,27,11,30,0,82,PHI,32,24,28,16,0,100
552,2/10/2018,LAC,28,27,23,20,0,98,PHI,37,32,16,27,0,112
553,2/12/2018,NYK,21,34,24,13,0,92,PHI,31,26,29,22,0,108
554,2/14/2018,MIA,29,33,19,21,0,102,PHI,20,19,34,31,0,104
555,2/22/2018,PHI,33,34,26,23,0,116,CHI,29,40,22,24,0,115
556,2/24/2018,ORL,18,22,31,34,0,105,PHI,27,31,29,29,0,116
557,2/27/2018,PHI,24,24,27,26,0,101,MIA,17,28,28,29,0,102
558,3/8/2018,PHI,28,21,25,25,0,99,MIA,29,24,20,35,0,108
559,3/11/2018,PHI,37,33,26,24,0,120,BRK,25,35,23,14,0,97
560,3/13/2018,IND,33,24,26,18,0,101,PHI,23,30,26,19,0,98
561,3/15/2018,PHI,32,28,23,35,0,118,NYK,32,36,23,19,0,110
562,3/16/2018,BRK,33,25,23,35,0,116,PHI,30,25,31,34,0,120
563,3/21/2018,MEM,19,25,25,36,0,105,PHI,26,32,41,20,0,119
564,3/22/2018,PHI,32,38,25,23,0,118,ORL,23,26,16,33,0,98
565,3/26/2018,DEN,27,32,15,30,0,104,PHI,23,28,34,38,0,123
566,3/28/2018,NYK,28,35,17,21,0,101,PHI,37,30,26,25,0,118
567,3/30/2018,PHI,30,17,39,15,0,101,ATL,27,14,18,32,0,91
568,4/3/2018,BRK,22,27,22,24,0,95,PHI,28,33,32,28,0,121
569,4/4/2018,PHI,36,29,23,27,0,115,DET,28,21,22,37,0,108
570,4/10/2018,PHI,27,34,28,32,0,121,ATL,32,23,24,34,0,113
571,10/18/2017,POR,29,31,38,26,0,124,PHO,21,14,20,21,0,76
572,10/20/2017,LAL,40,30,36,26,0,132,PHO,36,37,26,31,0,130
573,10/21/2017,PHO,18,26,20,24,0,88,LAC,23,35,32,40,0,130
574,10/23/2017,SAC,17,34,25,39,0,115,PHO,36,23,28,30,0,117
575,10/25/2017,UTA,13,28,18,29,0,88,PHO,23,25,23,26,0,97
576,10/28/2017,PHO,24,33,32,18,0,107,POR,29,32,31,22,0,114
577,10/31/2017,PHO,30,29,28,35,0,122,BRK,24,29,35,26,0,114
578,11/3/2017,PHO,19,31,26,31,0,107,NYK,32,33,27,28,0,120
579,11/5/2017,PHO,20,35,13,27,0,95,SAS,28,23,34,27,0,112
580,11/6/2017,BRK,28,19,25,26,0,98,PHO,19,22,27,24,0,92
581,11/8/2017,MIA,36,33,25,32,0,126,PHO,27,27,32,29,0,115
582,11/10/2017,ORL,36,28,33,31,0,128,PHO,32,31,20,29,0,112
583,11/13/2017,LAL,21,22,31,26,0,100,PHO,20,24,29,20,0,93
584,11/16/2017,HOU,45,45,30,22,0,142,PHO,23,42,26,25,0,116
585,11/17/2017,PHO,29,36,24,33,0,122,LAL,28,25,29,31,0,113
586,11/19/2017,CHI,37,19,28,21,0,105,PHO,30,31,24,28,0,113
587,11/24/2017,NOP,33,39,22,21,0,115,PHO,21,21,20,29,0,91
588,11/28/2017,PHO,28,18,27,31,0,104,CHI,29,14,27,29,0,99
589,11/29/2017,PHO,19,22,29,37,0,107,DET,36,33,35,27,0,131
590,12/5/2017,PHO,23,23,33,34,0,113,TOR,36,19,42,29,0,126
591,12/9/2017,SAS,28,24,27,25,0,104,PHO,17,22,32,30,0,101
592,12/12/2017,PHO,23,28,23,18,0,92,SAC,21,28,25,25,0,99
593,12/13/2017,TOR,37,21,34,23,0,115,PHO,31,21,27,30,0,109
594,12/20/2017,PHO,15,20,31,29,0,95,LAC,23,30,28,27,0,108
595,12/21/2017,MEM,25,26,30,14,0,95,PHO,26,34,19,18,0,97
596,12/26/2017,MEM,19,34,23,21,0,97,PHO,29,28,19,23,0,99
597,12/29/2017,PHO,35,20,33,23,0,111,SAC,25,21,37,18,0,101
598,1/2/2018,ATL,27,21,32,23,0,103,PHO,19,30,24,31,0,104
599,1/3/2018,PHO,26,41,18,26,0,111,DEN,34,27,37,36,0,134
600,1/5/2018,PHO,26,16,30,17,0,89,SAS,26,23,31,23,0,103
601,1/7/2018,OKC,23,30,29,18,0,100,PHO,28,34,28,24,0,114
602,1/12/2018,HOU,27,30,33,22,0,112,PHO,23,21,24,27,0,95
603,1/14/2018,IND,30,34,32,24,0,120,PHO,16,28,22,31,0,97
604,1/16/2018,PHO,31,20,21,39,0,111,POR,36,30,26,26,0,118
605,1/19/2018,PHO,29,31,25,23,0,108,DEN,31,19,23,27,0,100
606,1/24/2018,PHO,18,26,21,36,0,101,IND,32,31,36,17,0,116
607,1/26/2018,NYK,33,20,28,26,0,107,PHO,23,26,18,18,0,85
608,1/28/2018,PHO,24,29,24,25,0,102,HOU,28,32,32,21,0,113
609,1/29/2018,PHO,26,21,27,35,0,109,MEM,22,42,26,30,0,120
610,2/2/2018,UTA,28,34,32,35,0,129,PHO,23,17,33,24,0,97
611,2/6/2018,PHO,28,29,22,14,0,93,LAL,33,24,31,24,0,112
612,2/7/2018,SAS,28,41,28,32,0,129,PHO,9,22,19,31,0,81
613,2/10/2018,DEN,28,34,32,29,0,123,PHO,23,37,29,24,0,113
614,2/12/2018,PHO,24,21,26,12,0,83,GSW,25,37,37,30,0,129
615,2/14/2018,PHO,23,18,30,26,0,97,UTA,27,23,22,35,0,107
616,2/23/2018,LAC,40,39,16,33,0,128,PHO,18,32,28,39,0,117
617,2/24/2018,POR,28,27,16,35,0,106,PHO,24,26,31,23,0,104
618,2/26/2018,PHO,36,29,24,27,0,116,NOP,26,32,38,29,0,125
619,2/28/2018,PHO,21,36,25,28,0,110,MEM,27,27,18,30,0,102
620,3/2/2018,OKC,32,28,37,27,0,124,PHO,37,30,32,17,0,116
621,3/4/2018,PHO,23,33,31,25,0,112,ATL,29,27,30,27,0,113
622,3/5/2018,PHO,27,21,32,23,0,103,MIA,30,31,32,32,0,125
623,3/8/2018,PHO,23,15,29,20,0,87,OKC,26,23,39,27,0,115
624,3/15/2018,PHO,23,20,23,22,0,88,UTA,20,36,25,35,0,116
625,3/17/2018,GSW,30,22,42,30,0,124,PHO,34,26,25,24,0,109
626,3/20/2018,DET,19,25,36,35,0,115,PHO,19,19,26,24,0,88
627,3/24/2018,PHO,23,23,28,25,0,99,ORL,26,12,39,28,0,105
628,3/28/2018,LAC,27,31,27,26,0,111,PHO,32,24,26,17,0,99
629,3/30/2018,PHO,25,32,29,17,0,103,HOU,22,18,35,29,0,104
630,4/1/2018,PHO,24,35,18,30,0,107,GSW,22,36,36,23,0,117
631,4/3/2018,SAC,22,18,29,25,0,94,PHO,22,24,27,24,0,97
632,4/6/2018,NOP,39,24,23,36,0,122,PHO,21,25,24,33,0,103
633,4/8/2018,GSW,33,31,27,26,0,117,PHO,29,21,22,28,0,100
634,10/19/2017,LAC,27,26,34,21,0,108,LAL,19,23,21,29,0,92
635,10/22/2017,NOP,34,34,26,25,0,119,LAL,22,33,28,29,0,112
636,10/27/2017,TOR,19,26,27,29,0,101,LAL,26,25,20,21,0,92
637,10/28/2017,LAL,16,29,19,17,0,81,UTA,31,25,19,21,0,96
638,10/31/2017,DET,22,23,27,21,0,93,LAL,25,33,29,26,0,113
639,11/2/2017,LAL,25,37,23,25,0,110,POR,41,25,21,26,0,113
640,11/3/2017,BRK,29,26,29,28,0,112,LAL,30,34,31,29,0,124
641,11/5/2017,MEM,24,30,16,32,0,102,LAL,27,35,26,19,0,107
642,11/19/2017,DEN,26,22,36,25,0,109,LAL,32,38,29,28,0,127
643,11/21/2017,CHI,27,29,19,19,0,94,LAL,23,19,30,31,0,103
644,11/22/2017,LAL,19,22,26,35,0,102,SAC,31,23,22,37,0,113
645,11/27/2017,LAL,32,30,27,26,0,115,LAC,34,26,27,33,0,120
646,11/29/2017,GSW,30,20,34,25,18,127,LAL,20,34,30,25,14,123
647,12/2/2017,LAL,29,30,21,20,0,100,DEN,34,21,23,37,0,115
648,12/3/2017,HOU,27,34,24,33,0,118,LAL,27,19,27,22,0,95
649,12/12/2017,LAL,29,22,28,20,10,109,NYK,25,25,26,23,14,113
650,12/18/2017,GSW,32,25,26,19,14,116,LAL,24,29,29,20,12,114
651,12/20/2017,LAL,37,26,31,28,0,122,HOU,22,37,30,27,0,116
652,12/22/2017,LAL,24,20,28,34,0,106,GSW,27,34,23,29,0,113
653,12/23/2017,POR,17,27,26,25,0,95,LAL,24,25,21,22,0,92
654,12/27/2017,MEM,24,30,22,33,0,109,LAL,18,29,29,23,0,99
655,12/29/2017,LAC,35,27,29,30,0,121,LAL,22,26,28,30,0,106
656,12/31/2017,LAL,37,35,29,21,11,142,HOU,44,21,25,32,11,148
657,1/3/2018,OKC,26,37,33,37,0,133,LAL,26,18,26,26,0,96
658,1/7/2018,ATL,27,21,32,33,0,113,LAL,29,37,30,36,0,132
659,1/9/2018,SAC,27,25,22,12,0,86,LAL,31,22,31,15,0,99
660,1/11/2018,SAS,15,23,24,19,0,81,LAL,20,29,19,25,0,93
661,1/15/2018,LAL,27,23,27,37,0,114,MEM,34,26,37,26,0,123
662,1/17/2018,LAL,25,29,18,18,0,90,OKC,33,27,33,21,0,114
663,1/19/2018,IND,25,14,27,20,0,86,LAL,18,29,27,25,0,99
664,1/21/2018,NYK,29,34,26,18,0,107,LAL,30,37,30,30,0,127
665,1/26/2018,LAL,32,30,22,24,0,108,CHI,25,32,15,31,0,103
666,1/28/2018,LAL,21,28,28,34,0,111,TOR,28,31,32,32,0,123
667,1/31/2018,LAL,25,26,30,24,0,105,ORL,29,29,43,26,0,127
668,2/2/2018,LAL,24,35,26,17,0,102,BRK,26,31,28,14,0,99
669,2/4/2018,LAL,25,26,31,26,0,108,OKC,22,27,30,25,0,104
670,2/8/2018,OKC,27,19,20,15,0,81,LAL,30,22,31,23,0,106
671,2/14/2018,LAL,33,33,25,26,0,117,NOP,46,33,24,36,0,139
672,2/24/2018,LAL,25,25,37,26,0,113,SAC,29,29,25,25,0,108
673,2/26/2018,LAL,28,36,32,27,0,123,ATL,22,24,29,29,0,104
674,3/1/2018,LAL,33,40,31,27,0,131,MIA,36,26,32,19,0,113
675,3/3/2018,LAL,23,30,27,36,0,116,SAS,30,30,31,21,0,112
676,3/5/2018,POR,27,31,15,35,0,108,LAL,24,31,25,23,0,103
677,3/7/2018,ORL,32,19,28,28,0,107,LAL,23,33,25,27,0,108
678,3/9/2018,LAL,28,34,34,20,0,116,DEN,37,28,29,31,0,125
679,3/13/2018,DEN,22,25,35,21,0,103,LAL,35,13,29,35,0,112
680,3/14/2018,LAL,23,32,27,24,0,106,GSW,26,29,34,28,0,117
681,3/16/2018,MIA,25,25,24,18,0,92,LAL,24,26,21,20,0,91
682,3/19/2018,LAL,37,22,21,20,0,100,IND,29,28,35,18,0,110
683,3/22/2018,LAL,44,29,35,17,0,125,NOP,40,31,26,31,0,128
684,3/24/2018,LAL,17,35,19,29,0,100,MEM,28,29,14,22,0,93
685,3/26/2018,LAL,29,26,21,30,0,106,DET,26,27,28,31,0,112
686,4/1/2018,SAC,19,24,17,24,0,84,LAL,22,21,21,19,0,83
687,4/3/2018,LAL,31,29,29,21,0,110,UTA,24,41,30,22,0,117
688,4/4/2018,SAS,30,31,26,21,4,112,LAL,29,29,23,27,14,122
689,4/8/2018,UTA,30,20,32,30,0,112,LAL,21,23,23,30,0,97
690,4/10/2018,HOU,23,33,26,23,0,105,LAL,16,32,27,24,0,99
691,4/11/2018,LAL,39,25,28,23,0,115,LAC,32,21,21,26,0,100
692,10/18/2017,DEN,30,28,25,13,0,96,UTA,21,28,29,28,0,106
693,10/21/2017,OKC,14,20,23,30,0,87,UTA,21,23,29,23,0,96
694,10/24/2017,UTA,20,21,15,28,0,84,LAC,27,15,33,27,0,102
695,11/1/2017,POR,20,19,30,25,9,103,UTA,22,17,25,30,18,112
696,11/3/2017,TOR,29,24,36,20,0,109,UTA,26,28,28,18,0,100
697,11/5/2017,UTA,28,21,36,25,0,110,HOU,39,28,48,22,0,137
698,11/10/2017,MIA,25,12,20,27,0,84,UTA,22,27,8,17,0,74
699,11/11/2017,BRK,25,20,30,31,0,106,UTA,25,36,24,29,0,114
700,11/15/2017,UTA,30,30,22,19,0,101,NYK,27,23,27,29,0,106
701,11/17/2017,UTA,25,24,31,27,0,107,BRK,39,26,24,29,0,118
702,11/18/2017,UTA,29,34,34,28,0,125,ORL,26,22,19,18,0,85
703,11/22/2017,CHI,24,22,23,11,0,80,UTA,25,30,32,23,0,110
704,11/28/2017,DEN,24,25,17,11,0,77,UTA,26,22,28,30,0,106
705,11/30/2017,UTA,26,35,33,32,0,126,LAC,27,34,26,20,0,107
706,12/1/2017,NOP,29,26,29,24,0,108,UTA,27,16,37,34,0,114
707,12/5/2017,UTA,28,19,33,14,0,94,OKC,19,20,29,32,0,100
708,12/7/2017,HOU,25,26,37,24,0,112,UTA,20,26,20,35,0,101
709,12/13/2017,UTA,24,24,26,26,0,100,CHI,30,19,28,26,0,103
710,12/18/2017,UTA,26,24,34,15,0,99,HOU,25,26,28,41,0,120
711,12/20/2017,UTA,9,28,23,19,0,79,OKC,25,28,34,20,0,107
712,12/21/2017,SAS,17,21,32,19,0,89,UTA,24,26,22,28,0,100
713,12/23/2017,OKC,28,19,29,27,0,103,UTA,22,21,21,25,0,89
714,12/26/2017,UTA,20,14,25,24,0,83,DEN,28,22,26,31,0,107
715,12/27/2017,UTA,24,23,22,32,0,101,GSW,23,25,42,36,0,126
716,1/3/2018,NOP,27,31,23,27,0,108,UTA,28,27,17,26,0,98
717,1/5/2018,UTA,26,23,16,26,0,91,DEN,23,23,38,15,0,99
718,1/7/2018,UTA,22,25,28,27,0,102,MIA,27,22,25,29,0,103
719,1/15/2018,IND,31,27,27,24,0,109,UTA,21,26,18,29,0,94
720,1/17/2018,UTA,23,29,36,32,0,120,SAC,21,21,31,32,0,105
721,1/19/2018,NYK,22,27,36,32,0,117,UTA,25,30,23,37,0,115
722,1/20/2018,LAC,29,30,28,26,0,113,UTA,39,37,28,21,0,125
723,1/22/2018,UTA,20,21,22,27,0,90,ATL,19,23,32,30,0,104
724,1/24/2018,UTA,24,19,22,24,9,98,DET,24,25,15,25,6,95
725,1/26/2018,UTA,30,15,30,22,0,97,TOR,24,24,21,24,0,93
726,1/30/2018,GSW,30,26,29,14,0,99,UTA,35,34,34,26,0,129
727,2/3/2018,UTA,33,28,26,33,0,120,SAS,24,25,29,33,0,111
728,2/5/2018,UTA,34,36,29,34,0,133,NOP,23,41,22,23,0,109
729,2/7/2018,UTA,21,23,24,24,0,92,MEM,16,23,24,25,0,88
730,2/11/2018,UTA,19,24,38,34,0,115,POR,26,18,19,33,0,96
731,2/12/2018,SAS,22,26,29,22,0,99,UTA,25,29,15,32,0,101
732,2/23/2018,POR,31,22,27,20,0,100,UTA,30,17,17,17,0,81
733,2/26/2018,HOU,19,20,31,26,0,96,UTA,21,23,19,22,0,85
734,3/3/2018,UTA,25,27,23,23,0,98,SAC,17,26,23,25,0,91
735,3/5/2018,ORL,29,15,23,13,0,80,UTA,25,29,20,20,0,94
736,3/7/2018,UTA,32,22,25,25,0,104,IND,20,24,25,15,0,84
737,3/9/2018,UTA,24,26,21,24,0,95,MEM,23,15,20,20,0,78
738,3/11/2018,UTA,29,19,30,38,0,116,NOP,23,28,23,25,0,99
739,3/13/2018,DET,21,18,20,20,0,79,UTA,42,22,22,24,0,110
740,3/17/2018,SAC,27,27,25,18,0,97,UTA,32,18,30,23,0,103
741,3/20/2018,ATL,21,20,22,36,0,99,UTA,27,15,25,27,0,94
742,3/23/2018,UTA,21,30,22,41,6,120,SAS,29,27,21,37,10,124
743,3/25/2018,UTA,18,35,36,21,0,110,GSW,22,25,18,26,0,91
744,3/30/2018,MEM,14,33,29,21,0,97,UTA,29,23,28,27,0,107
745,4/5/2018,LAC,26,23,18,28,0,95,UTA,36,29,29,23,0,117
746,4/10/2018,GSW,16,17,23,23,0,79,UTA,33,29,31,26,0,119
747,4/11/2018,UTA,21,20,18,34,0,93,POR,28,27,25,22,0,102
748,10/18/2017,HOU,26,26,23,30,0,105,SAC,25,23,24,28,0,100
749,10/21/2017,SAC,18,16,18,27,0,79,DEN,17,25,24,30,0,96
750,10/26/2017,NOP,27,29,32,26,0,114,SAC,40,30,17,19,0,106
751,10/31/2017,SAC,13,17,18,35,0,83,IND,24,31,14,32,0,101
752,11/4/2017,SAC,26,23,25,25,0,99,DET,29,23,33,23,0,108
753,11/7/2017,OKC,25,16,16,29,0,86,SAC,10,32,25,27,0,94
754,11/11/2017,SAC,23,26,17,25,0,91,NYK,32,32,26,28,0,118
755,11/15/2017,SAC,16,19,26,19,0,80,ATL,24,40,28,34,0,126
756,11/17/2017,POR,20,21,19,22,0,82,SAC,19,23,18,26,0,86
757,11/18/2017,SAC,20,21,22,27,0,90,POR,21,32,27,22,0,102
758,11/20/2017,DEN,22,25,34,33,0,114,SAC,22,25,23,28,0,98
759,11/25/2017,LAC,25,22,29,21,0,97,SAC,31,30,10,24,0,95
760,11/27/2017,SAC,27,26,30,27,0,110,GSW,27,28,27,24,0,106
761,12/1/2017,SAC,29,32,21,25,0,107,CHI,31,29,21,25,0,106
762,12/8/2017,SAC,24,23,30,25,14,116,NOP,25,28,29,20,7,109
763,12/10/2017,TOR,22,32,25,23,0,102,SAC,17,29,21,20,0,87
764,12/17/2017,SAC,30,33,14,16,0,93,TOR,35,26,22,25,0,108
765,12/20/2017,SAC,36,28,22,18,0,104,BRK,20,28,27,24,0,99
766,12/23/2017,SAS,33,29,22,24,0,108,SAC,33,16,27,23,0,99
767,12/26/2017,SAC,30,23,20,22,0,95,LAC,30,41,24,27,0,122
768,12/31/2017,MEM,36,28,26,24,0,114,SAC,22,24,17,33,0,96
769,1/6/2018,DEN,27,14,30,27,0,98,SAC,29,17,33,27,0,106
770,1/8/2018,SAS,21,25,27,34,0,107,SAC,25,31,20,24,0,100
771,1/11/2018,LAC,29,43,28,21,0,121,SAC,21,39,29,26,0,115
772,1/13/2018,SAC,17,28,23,37,0,105,LAC,30,34,27,35,0,126
773,1/15/2018,SAC,24,28,16,20,0,88,OKC,20,26,31,18,0,95
774,1/19/2018,SAC,17,23,19,29,0,88,MEM,30,10,27,39,0,106
775,1/23/2018,SAC,28,24,25,28,0,105,ORL,27,26,29,17,0,99
776,1/25/2018,SAC,19,28,24,18,0,89,MIA,17,30,25,16,0,88
777,1/28/2018,SAC,22,28,19,29,0,98,SAS,29,20,30,34,0,113
778,1/30/2018,SAC,25,36,29,24,0,114,NOP,29,33,23,18,0,103
779,2/2/2018,GSW,29,29,26,35,0,119,SAC,27,25,23,29,0,104
780,2/5/2018,CHI,28,27,24,19,0,98,SAC,9,32,36,27,0,104
781,2/9/2018,POR,33,29,30,26,0,118,SAC,31,21,22,26,0,100
782,2/14/2018,SAC,25,20,18,28,0,91,HOU,20,35,17,28,0,100
783,2/22/2018,OKC,44,23,18,25,0,110,SAC,21,39,30,17,0,107
784,2/27/2018,SAC,26,27,27,19,0,99,POR,36,30,22,28,0,116
785,3/1/2018,BRK,31,20,28,21,11,111,SAC,22,31,20,27,16,116
786,3/4/2018,NYK,20,26,26,27,0,99,SAC,32,19,32,19,0,102
787,3/7/2018,NOP,32,30,23,29,0,114,SAC,21,23,23,34,0,101
788,3/9/2018,ORL,14,22,26,26,0,88,SAC,22,19,33,20,0,94
789,3/11/2018,SAC,25,24,19,36,0,104,DEN,32,34,35,29,0,130
790,3/12/2018,SAC,16,24,39,22,0,101,OKC,19,27,32,28,0,106
791,3/14/2018,MIA,31,21,27,32,8,119,SAC,24,35,32,20,12,123
792,3/16/2018,SAC,29,28,18,23,0,98,GSW,36,23,16,18,0,93
793,3/19/2018,DET,25,19,29,33,0,106,SAC,21,23,22,24,0,90
794,3/22/2018,ATL,28,16,27,19,0,90,SAC,25,24,31,25,0,105
795,3/29/2018,IND,28,33,18,27,0,106,SAC,28,28,23,24,0,103
796,3/31/2018,GSW,28,29,36,19,0,112,SAC,25,24,20,27,0,96
797,4/6/2018,SAC,25,19,24,26,0,94,MEM,22,26,15,30,0,93
798,4/9/2018,SAC,25,25,16,19,0,85,SAS,17,26,17,38,0,98
799,4/11/2018,HOU,22,22,19,20,0,83,SAC,28,24,27,17,0,96
800,10/19/2017,NYK,24,18,17,25,0,84,OKC,27,26,26,26,0,105
801,10/21/2017,DET,19,32,28,32,0,111,NYK,28,36,16,27,0,107
802,10/27/2017,BRK,28,14,24,20,0,86,NYK,23,24,36,24,0,107
803,10/30/2017,DEN,25,18,38,29,0,110,NYK,35,30,19,32,0,116
804,11/1/2017,HOU,24,36,40,19,0,119,NYK,27,21,26,23,0,97
805,11/5/2017,IND,33,29,22,17,0,101,NYK,25,24,23,36,0,108
806,11/8/2017,NYK,28,22,26,23,0,99,ORL,27,27,30,28,0,112
807,11/17/2017,NYK,18,18,28,20,0,84,TOR,30,24,24,29,0,107
808,11/20/2017,LAC,20,24,24,17,0,85,NYK,20,36,27,24,0,107
809,11/22/2017,TOR,34,25,10,31,0,100,NYK,26,22,41,19,0,108
810,11/24/2017,NYK,39,28,19,18,0,104,ATL,24,35,30,27,0,116
811,11/25/2017,NYK,39,22,13,28,0,102,HOU,29,29,37,22,0,117
812,11/27/2017,POR,30,23,37,13,0,103,NYK,23,14,27,27,0,91
813,11/29/2017,MIA,22,22,20,22,0,86,NYK,33,32,23,27,0,115
814,12/3/2017,ORL,36,18,24,27,0,105,NYK,25,26,25,24,0,100
815,12/4/2017,NYK,19,21,25,32,0,97,IND,31,35,29,20,0,115
816,12/6/2017,MEM,32,17,18,21,0,88,NYK,23,26,27,23,0,99
817,12/9/2017,NYK,18,26,26,32,0,102,CHI,27,22,19,36,0,104
818,12/10/2017,ATL,21,31,23,32,0,107,NYK,24,27,25,35,0,111
819,12/14/2017,NYK,32,31,24,24,0,111,BRK,26,24,32,22,0,104
820,12/16/2017,OKC,26,18,29,23,0,96,NYK,23,27,30,31,0,111
821,12/22/2017,NYK,21,23,31,26,0,101,DET,25,27,22,30,0,104
822,12/27/2017,NYK,28,24,21,14,0,87,CHI,17,32,22,21,0,92
823,12/28/2017,NYK,24,29,26,28,0,107,SAS,32,22,32,33,0,119
824,12/30/2017,NYK,28,28,23,26,0,105,NOP,21,24,33,25,0,103
825,1/2/2018,SAS,25,27,29,19,0,100,NYK,29,20,18,24,0,91
826,1/5/2018,NYK,25,20,26,26,6,103,MIA,26,25,24,22,10,107
827,1/10/2018,CHI,26,22,30,27,7,122,NYK,25,27,30,23,7,119
828,1/14/2018,NOP,13,35,34,27,14,123,NYK,29,28,39,13,9,118
829,1/15/2018,NYK,26,26,31,36,0,119,BRK,24,18,39,23,0,104
830,1/17/2018,NYK,31,22,20,26,0,99,MEM,32,29,27,17,0,105
831,1/23/2018,NYK,31,29,26,26,0,112,GSW,21,37,37,28,0,123
832,1/25/2018,NYK,28,32,32,26,0,118,DEN,39,34,26,31,0,130
833,1/30/2018,BRK,22,19,28,26,0,95,NYK,30,31,25,25,0,111
834,2/4/2018,ATL,21,23,25,30,0,99,NYK,22,16,33,25,0,96
835,2/8/2018,NYK,18,23,25,22,0,88,TOR,23,29,30,31,0,113
836,2/11/2018,NYK,37,25,22,29,0,113,IND,36,32,26,27,0,121
837,2/22/2018,NYK,31,32,30,27,0,120,ORL,41,28,21,23,0,113
838,2/26/2018,GSW,37,26,39,23,0,125,NYK,39,25,18,29,0,111
839,3/2/2018,NYK,25,35,18,27,0,105,LAC,32,25,35,36,0,128
840,3/6/2018,NYK,28,24,19,16,0,87,POR,35,22,30,24,0,111
841,3/11/2018,TOR,32,33,37,30,0,132,NYK,27,30,29,20,0,106
842,3/19/2018,CHI,18,19,30,25,0,92,NYK,19,28,36,27,0,110
843,3/21/2018,NYK,26,21,30,21,0,98,MIA,27,37,35,20,0,119
844,3/31/2018,DET,30,26,29,30,0,115,NYK,27,27,30,25,0,109
845,4/3/2018,ORL,27,19,22,29,0,97,NYK,25,20,16,12,0,73
846,4/6/2018,MIA,23,27,28,20,0,98,NYK,34,29,33,26,0,122
847,10/18/2017,NOP,34,18,18,21,0,91,MEM,27,27,25,24,0,103
848,10/20/2017,GSW,26,35,37,30,0,128,NOP,39,25,26,30,0,120
849,10/24/2017,NOP,19,29,25,20,0,93,POR,29,18,24,32,0,103
850,10/30/2017,ORL,33,27,27,28,0,115,NOP,24,40,20,15,0,99
851,11/4/2017,NOP,17,21,19,26,13,96,CHI,19,19,26,19,7,90
852,11/7/2017,NOP,34,27,35,21,0,117,IND,37,38,19,18,0,112
853,11/9/2017,NOP,32,28,32,26,0,118,TOR,34,32,26,30,0,122
854,11/11/2017,LAC,26,32,24,21,0,103,NOP,31,32,25,23,0,111
855,11/13/2017,ATL,32,18,30,25,0,105,NOP,23,22,33,28,0,106
856,11/15/2017,TOR,29,35,34,27,0,125,NOP,34,29,23,30,0,116
857,11/17/2017,NOP,19,37,24,34,0,114,DEN,37,27,42,40,0,146
858,11/20/2017,OKC,33,32,21,21,0,107,NOP,24,33,30,27,0,114
859,11/22/2017,SAS,29,13,17,31,0,90,NOP,19,31,37,20,0,107
860,11/25/2017,NOP,31,22,22,20,0,95,GSW,17,36,31,26,0,110
861,12/2/2017,NOP,26,34,38,25,0,123,POR,33,24,25,34,0,116
862,12/4/2017,GSW,26,23,39,37,0,125,NOP,33,36,22,24,0,115
863,12/6/2017,DEN,33,33,25,23,0,114,NOP,33,34,30,26,0,123
864,12/11/2017,NOP,41,35,27,20,0,123,HOU,35,43,18,34,0,130
865,12/15/2017,NOP,33,25,28,18,7,111,DEN,20,26,30,28,13,117
866,12/22/2017,NOP,32,28,28,23,0,111,ORL,20,30,22,25,0,97
867,12/23/2017,NOP,27,29,27,26,0,109,MIA,28,25,16,25,0,94
868,12/27/2017,BRK,23,23,29,38,0,113,NOP,31,38,22,37,0,128
869,1/8/2018,DET,34,22,28,25,0,109,NOP,37,22,27,26,0,112
870,1/10/2018,NOP,38,23,9,32,0,102,MEM,29,31,17,28,0,105
871,1/12/2018,POR,25,36,25,27,0,113,NOP,31,30,27,31,0,119
872,1/17/2018,NOP,32,28,10,23,0,93,ATL,25,20,26,23,0,94
873,1/20/2018,MEM,18,26,37,23,0,104,NOP,34,25,24,28,0,111
874,1/22/2018,CHI,21,27,33,33,8,128,NOP,25,29,27,33,8,132
875,1/26/2018,HOU,30,23,27,33,0,113,NOP,29,37,24,25,0,115
876,1/28/2018,LAC,26,25,29,32,0,112,NOP,34,28,15,26,0,103
877,2/2/2018,NOP,22,32,36,24,0,114,OKC,32,26,25,17,0,100
878,2/10/2018,NOP,34,38,28,16,8,138,BRK,22,30,33,31,8,128
879,2/12/2018,NOP,32,28,35,23,0,118,DET,31,21,28,23,0,103
880,2/23/2018,MIA,27,32,30,19,15,123,NOP,22,35,27,24,16,124
881,2/28/2018,NOP,24,27,36,34,0,121,SAS,29,31,35,21,0,116
882,3/6/2018,NOP,35,32,30,24,0,121,LAC,27,25,30,34,0,116
883,3/15/2018,NOP,26,32,15,20,0,93,SAS,37,23,18,20,0,98
884,3/17/2018,HOU,32,28,24,23,0,107,NOP,29,25,18,29,0,101
885,3/21/2018,IND,25,25,19,23,0,92,NOP,24,27,16,29,0,96
886,3/24/2018,NOP,16,21,24,30,0,91,HOU,29,35,19,31,0,114
887,3/27/2018,POR,20,26,25,36,0,107,NOP,24,25,26,28,0,103
888,4/1/2018,OKC,20,33,27,29,0,109,NOP,28,22,25,29,0,104
889,4/4/2018,MEM,23,30,20,22,0,95,NOP,32,33,32,26,0,123
890,4/7/2018,NOP,40,27,21,38,0,126,GSW,32,33,27,28,0,120
891,4/9/2018,NOP,31,28,34,20,0,113,LAC,23,26,22,29,0,100
892,4/11/2018,SAS,26,17,29,26,0,98,NOP,27,34,29,32,0,122
893,10/28/2017,DET,27,18,22,28,0,95,LAC,24,31,17,15,0,87
894,10/29/2017,DET,27,25,30,33,0,115,GSW,35,22,24,26,0,107
895,11/8/2017,IND,30,22,23,22,0,97,DET,22,37,23,32,0,114
896,11/10/2017,ATL,22,19,28,35,0,104,DET,26,31,19,35,0,111
897,11/12/2017,MIA,29,29,23,22,0,103,DET,31,24,28,29,0,112
898,11/17/2017,DET,32,26,23,19,0,100,IND,23,24,24,36,0,107
899,11/24/2017,DET,25,24,24,26,0,99,OKC,29,30,18,21,0,98
900,12/4/2017,DET,29,24,20,20,0,93,SAS,28,22,19,27,0,96
901,12/8/2017,GSW,30,16,31,25,0,102,DET,24,26,17,31,0,98
902,12/12/2017,DEN,26,23,31,23,0,103,DET,18,22,20,24,0,84
903,12/14/2017,DET,30,29,26,20,0,105,ATL,31,15,18,27,0,91
904,12/15/2017,DET,27,25,34,18,0,104,IND,19,35,20,24,0,98
905,12/17/2017,ORL,23,20,36,31,0,110,DET,36,24,36,18,0,114
906,12/26/2017,IND,19,26,21,17,0,83,DET,40,18,24,25,0,107
907,12/28/2017,DET,28,22,23,16,0,89,ORL,33,17,27,25,0,102
908,12/30/2017,SAS,13,23,21,22,0,79,DET,24,15,24,30,0,93
909,1/3/2018,DET,29,23,29,23,0,104,MIA,24,32,25,30,0,111
910,1/6/2018,HOU,37,21,19,24,0,101,DET,31,26,31,20,0,108
911,1/10/2018,DET,34,29,27,24,0,114,BRK,26,15,20,19,0,80
912,1/13/2018,DET,31,30,23,21,0,105,CHI,36,24,27,20,0,107
913,1/17/2018,DET,18,33,22,18,0,91,TOR,31,23,19,23,0,96
914,1/21/2018,BRK,30,23,24,24,0,101,DET,20,28,20,32,0,100
915,1/27/2018,OKC,36,33,29,23,0,121,DET,24,33,24,27,0,108
916,2/1/2018,MEM,25,26,25,26,0,102,DET,27,24,31,22,0,104
917,2/3/2018,MIA,26,24,27,30,0,107,DET,27,27,22,35,0,111
918,2/5/2018,POR,20,23,24,24,0,91,DET,22,27,30,32,0,111
919,2/7/2018,BRK,21,29,23,33,0,106,DET,26,27,26,36,0,115
920,2/9/2018,LAC,31,21,25,31,0,108,DET,30,26,24,15,0,95
921,2/11/2018,DET,23,33,24,35,0,115,ATL,28,27,27,36,0,118
922,2/14/2018,ATL,14,19,28,37,0,98,DET,22,23,37,22,0,104
923,2/26/2018,DET,26,27,22,19,0,94,TOR,30,29,34,30,0,123
924,3/2/2018,DET,29,23,30,22,2,106,ORL,31,22,29,22,11,115
925,3/3/2018,DET,28,18,24,26,0,96,MIA,27,32,15,31,0,105
926,3/7/2018,TOR,27,18,40,29,7,121,DET,23,36,25,30,5,119
927,3/9/2018,CHI,26,21,15,21,0,83,DET,21,28,24,26,0,99
928,3/15/2018,DET,29,22,33,29,0,113,DEN,33,32,33,22,0,120
929,3/17/2018,DET,20,25,18,24,0,87,POR,31,29,20,20,0,100
930,3/22/2018,DET,27,23,18,20,8,96,HOU,21,27,23,17,12,100
931,3/24/2018,CHI,22,25,29,19,0,95,DET,36,30,29,22,0,117
932,4/1/2018,DET,33,29,21,25,0,108,BRK,28,20,22,26,0,96
933,4/8/2018,DET,22,34,28,33,0,117,MEM,30,32,34,34,0,130
934,4/9/2018,TOR,32,25,28,23,0,108,DET,32,28,20,18,0,98
935,4/11/2018,DET,35,31,28,25,0,119,CHI,21,29,24,13,0,87
936,10/22/2017,ATL,25,28,24,27,0,104,BRK,19,37,35,25,0,116
937,10/23/2017,ATL,23,21,29,20,0,93,MIA,26,36,15,27,0,104
938,10/26/2017,ATL,20,19,20,27,0,86,CHI,18,19,28,26,0,91
939,10/27/2017,DEN,26,27,22,30,0,105,ATL,23,29,19,29,0,100
940,11/3/2017,HOU,36,33,28,22,0,119,ATL,25,26,25,28,0,104
941,11/20/2017,ATL,22,16,27,20,0,85,SAS,24,22,24,26,0,96
942,11/22/2017,LAC,29,33,26,28,0,116,ATL,30,33,21,19,0,103
943,11/25/2017,TOR,28,39,32,13,0,112,ATL,25,14,19,20,0,78
944,12/2/2017,ATL,25,29,27,33,0,114,BRK,22,23,30,27,0,102
945,12/4/2017,BRK,33,20,31,26,0,110,ATL,32,22,15,21,0,90
946,12/6/2017,ATL,23,29,27,17,10,106,ORL,31,13,30,22,14,110
947,12/9/2017,ORL,22,32,33,23,0,110,ATL,32,25,32,28,0,117
948,12/15/2017,ATL,21,26,26,21,0,94,MEM,17,23,32,24,0,96
949,12/18/2017,MIA,30,27,19,28,0,104,ATL,29,29,29,23,0,110
950,12/20/2017,IND,28,25,25,27,0,105,ATL,27,24,20,24,0,95
951,12/22/2017,ATL,28,22,31,36,0,117,OKC,28,36,18,38,0,120
952,12/29/2017,ATL,22,25,22,29,0,98,TOR,30,32,26,23,0,111
953,12/30/2017,POR,23,29,17,20,0,89,ATL,24,22,26,32,0,104
954,1/5/2018,ATL,22,24,22,21,0,89,POR,30,22,30,28,0,110
955,1/8/2018,ATL,25,22,30,30,0,107,LAC,32,26,22,28,0,108
956,1/10/2018,ATL,29,25,28,28,0,110,DEN,21,25,32,19,0,97
957,1/12/2018,BRK,25,28,21,36,0,110,ATL,25,25,24,31,0,105
958,1/15/2018,SAS,23,25,25,26,0,99,ATL,21,23,28,30,0,102
959,1/20/2018,CHI,29,26,22,36,0,113,ATL,21,17,25,34,0,97
960,1/24/2018,TOR,28,30,27,23,0,108,ATL,16,24,25,28,0,93
961,2/6/2018,MEM,15,20,19,28,0,82,ATL,22,29,28,29,0,108
962,2/8/2018,ATL,23,16,31,28,0,98,ORL,26,13,30,31,0,100
963,2/23/2018,ATL,22,22,22,27,0,93,IND,27,34,22,33,0,116
964,2/28/2018,IND,27,23,15,37,0,102,ATL,28,27,30,22,0,107
965,3/2/2018,GSW,33,29,28,24,0,114,ATL,31,19,34,25,0,109
966,3/6/2018,ATL,28,23,26,13,0,90,TOR,27,23,26,30,0,106
967,3/9/2018,ATL,15,22,26,24,0,87,IND,34,19,34,25,0,112
968,3/11/2018,CHI,20,33,38,38,0,129,ATL,34,16,35,37,0,122
969,3/13/2018,OKC,31,23,36,29,0,119,ATL,28,38,22,19,0,107
970,3/23/2018,ATL,18,33,23,20,0,94,GSW,16,27,36,27,0,106
971,3/25/2018,ATL,20,25,29,25,0,99,HOU,33,36,25,24,0,118
972,4/1/2018,ORL,18,25,21,24,0,88,ATL,21,35,13,25,0,94
973,4/3/2018,ATL,25,31,22,20,0,98,MIA,30,22,26,23,0,101
974,4/4/2018,MIA,23,30,31,31,0,115,ATL,29,18,21,18,0,86
975,10/19/2017,CHI,23,14,27,36,0,100,TOR,25,33,26,33,0,117
976,10/21/2017,SAS,19,22,24,22,0,87,CHI,21,17,17,22,0,77
977,10/28/2017,OKC,26,24,32,19,0,101,CHI,23,8,22,16,0,69
978,11/1/2017,CHI,17,30,17,27,0,91,MIA,27,22,18,30,0,97
979,11/3/2017,CHI,28,16,29,32,0,105,ORL,26,19,15,23,0,83
980,11/7/2017,CHI,26,19,36,33,0,114,TOR,29,36,33,21,0,119
981,11/10/2017,IND,27,18,35,25,0,105,CHI,16,19,26,26,0,87
982,11/11/2017,CHI,15,32,23,24,0,94,SAS,37,26,34,36,0,133
983,11/15/2017,CHI,7,27,22,23,0,79,OKC,27,31,19,15,0,92
984,11/24/2017,CHI,32,21,13,28,0,94,GSW,29,45,36,33,0,143
985,11/26/2017,MIA,7,38,19,36,0,100,CHI,13,29,19,32,0,93
986,11/30/2017,CHI,39,29,24,18,0,110,DEN,30,32,29,20,0,111
987,12/6/2017,CHI,30,25,28,13,0,96,IND,20,19,30,29,0,98
988,12/20/2017,ORL,24,24,18,28,0,94,CHI,31,28,31,22,0,112
989,12/29/2017,IND,27,25,25,30,0,107,CHI,37,27,22,33,0,119
990,1/1/2018,POR,31,21,31,29,12,124,CHI,23,30,34,25,8,120
991,1/3/2018,TOR,21,35,34,34,0,124,CHI,31,28,31,25,0,115
992,1/6/2018,CHI,26,11,30,19,0,86,IND,31,33,37,24,0,125
993,1/8/2018,HOU,35,25,27,29,0,116,CHI,22,33,21,31,0,107
994,1/15/2018,MIA,25,23,24,39,0,111,CHI,32,23,29,35,0,119
995,1/17/2018,GSW,38,25,32,24,0,119,CHI,40,26,12,34,0,112
996,1/31/2018,CHI,19,25,31,33,0,108,POR,43,24,35,22,0,124
997,2/3/2018,CHI,17,35,29,22,0,103,LAC,22,35,30,26,0,113
998,2/12/2018,ORL,27,24,20,30,0,101,CHI,30,23,24,28,0,105
999,2/14/2018,TOR,27,34,34,27,0,122,CHI,33,16,27,22,0,98
1000,2/26/2018,CHI,19,32,19,17,0,87,BRK,28,21,35,20,0,104
1001,3/7/2018,MEM,22,29,24,35,0,110,CHI,30,34,26,29,0,119
1002,3/13/2018,LAC,31,31,28,22,0,112,CHI,27,33,18,28,0,106
1003,3/15/2018,CHI,22,30,26,33,0,111,MEM,29,23,23,35,0,110
1004,3/21/2018,DEN,39,38,36,22,0,135,CHI,25,21,24,32,0,102
1005,3/27/2018,CHI,23,16,18,29,0,86,HOU,31,29,27,31,0,118
1006,3/29/2018,CHI,21,25,22,24,0,92,MIA,29,22,27,25,0,103
1007,3/30/2018,CHI,30,27,9,24,0,90,ORL,24,20,25,13,0,82
1008,4/7/2018,BRK,28,35,33,28,0,124,CHI,23,28,26,19,0,96
1009,4/9/2018,CHI,26,29,28,22,0,105,BRK,29,33,24,28,0,114
1010,10/18/2017,MIA,37,18,23,31,0,109,ORL,32,26,30,28,0,116
1011,10/21/2017,IND,31,19,26,32,0,108,MIA,26,37,28,21,0,112
1012,10/25/2017,SAS,30,26,32,29,0,117,MIA,30,21,22,27,0,100
1013,11/3/2017,MIA,37,21,13,23,0,94,DEN,28,23,25,19,0,95
1014,11/5/2017,MIA,34,28,27,15,0,104,LAC,20,29,17,35,0,101
1015,11/6/2017,MIA,21,16,20,23,0,80,GSW,22,28,25,22,0,97
1016,11/19/2017,IND,29,29,32,30,0,120,MIA,27,28,13,27,0,95
1017,12/3/2017,GSW,33,29,37,24,0,123,MIA,36,24,17,18,0,95
1018,12/6/2017,MIA,35,23,24,23,0,105,SAS,27,30,29,31,0,117
1019,12/9/2017,MIA,24,26,25,26,0,101,BRK,26,27,19,17,0,89
1020,12/11/2017,MIA,21,24,25,37,0,107,MEM,23,19,18,22,0,82
1021,12/13/2017,POR,21,29,20,32,0,102,MIA,33,27,19,16,0,95
1022,12/16/2017,LAC,17,23,25,20,0,85,MIA,24,22,23,21,0,90
1023,12/26/2017,ORL,18,31,19,21,0,89,MIA,21,22,25,39,0,107
1024,12/29/2017,BRK,24,35,36,16,0,111,MIA,20,19,21,27,0,87
1025,12/30/2017,MIA,21,29,36,31,0,117,ORL,32,34,26,19,0,111
1026,1/9/2018,MIA,22,29,21,18,0,90,TOR,21,20,23,25,0,89
1027,1/10/2018,MIA,38,20,26,30,0,114,IND,26,21,31,28,0,106
1028,1/19/2018,MIA,24,29,16,26,0,95,BRK,21,22,24,34,0,101
1029,1/22/2018,MIA,33,17,18,22,0,90,HOU,25,21,25,28,0,99
1030,2/5/2018,ORL,26,33,34,18,0,111,MIA,35,25,27,22,0,109
1031,2/7/2018,HOU,35,26,22,26,0,109,MIA,24,33,23,21,0,101
1032,2/13/2018,MIA,24,31,26,31,0,112,TOR,28,29,41,17,0,115
1033,2/24/2018,MEM,31,21,18,19,0,89,MIA,34,26,32,23,0,115
1034,3/12/2018,MIA,25,22,25,27,0,99,POR,34,25,29,27,0,115
1035,3/19/2018,DEN,37,26,28,27,13,141,MIA,36,28,28,26,13,149
1036,3/23/2018,MIA,18,22,26,33,0,99,OKC,24,20,20,41,0,105
1037,3/25/2018,MIA,30,23,21,22,11,107,IND,21,31,30,14,17,113
1038,3/31/2018,BRK,22,26,32,21,9,110,MIA,32,23,21,25,8,109
1039,4/9/2018,OKC,21,28,27,39,0,115,MIA,27,25,29,12,0,93
1040,4/11/2018,TOR,29,24,25,27,4,109,MIA,27,20,24,34,11,116
1041,10/21/2017,GSW,26,25,20,30,0,101,MEM,31,25,32,23,0,111
1042,10/23/2017,MEM,24,26,20,28,0,98,HOU,26,31,19,14,0,90
1043,10/28/2017,HOU,32,17,23,17,0,89,MEM,30,24,27,22,0,103
1044,11/1/2017,ORL,23,31,27,20,0,101,MEM,26,28,21,24,0,99
1045,11/4/2017,MEM,27,33,27,26,0,113,LAC,25,31,24,24,0,104
1046,11/7/2017,MEM,23,24,27,24,0,98,POR,21,29,21,26,0,97
1047,11/11/2017,MEM,22,28,20,26,0,96,HOU,33,29,31,18,0,111
1048,11/15/2017,IND,34,33,30,19,0,116,MEM,25,28,31,29,0,113
1049,11/18/2017,HOU,33,26,23,23,0,105,MEM,25,25,17,16,0,83
1050,11/20/2017,POR,23,32,17,28,0,100,MEM,24,22,25,21,0,92
1051,11/24/2017,MEM,18,27,29,18,0,92,DEN,27,34,15,28,0,104
1052,11/26/2017,BRK,19,28,32,19,0,98,MEM,22,25,18,23,0,88
1053,11/29/2017,MEM,21,28,24,22,0,95,SAS,28,30,21,25,0,104
1054,12/1/2017,SAS,24,23,21,27,0,95,MEM,18,20,21,20,0,79
1055,12/8/2017,TOR,25,32,35,24,0,116,MEM,34,28,31,14,0,107
1056,12/9/2017,OKC,19,27,21,25,10,102,MEM,34,23,9,26,9,101
1057,12/20/2017,MEM,28,23,14,19,0,84,GSW,24,32,18,23,0,97
1058,12/23/2017,LAC,33,26,22,31,0,112,MEM,30,33,27,25,0,115
1059,12/30/2017,MEM,38,29,31,30,0,128,GSW,40,38,38,25,0,141
1060,1/2/2018,MEM,31,31,22,21,0,105,LAC,34,33,19,27,0,113
1061,1/12/2018,MEM,26,21,13,18,0,78,DEN,16,27,24,20,0,87
1062,1/24/2018,SAS,22,29,26,31,0,108,MEM,21,19,24,21,0,85
1063,1/26/2018,LAC,24,34,25,26,0,109,MEM,20,30,26,24,0,100
1064,1/31/2018,MEM,25,28,22,26,0,101,IND,21,34,29,21,0,105
1065,2/4/2018,MEM,24,20,30,12,0,86,TOR,25,31,20,25,0,101
1066,2/11/2018,MEM,18,36,26,12,0,92,OKC,35,39,21,15,0,110
1067,2/14/2018,OKC,34,39,19,29,0,121,MEM,33,20,31,30,0,114
1068,3/2/2018,DEN,35,28,28,17,0,108,MEM,29,25,26,22,0,102
1069,3/3/2018,MEM,27,25,27,21,0,100,ORL,31,21,25,30,0,107
1070,3/5/2018,MEM,23,22,27,26,0,98,SAS,21,26,23,30,0,100
1071,3/17/2018,DEN,17,31,27,19,0,94,MEM,34,19,31,17,0,101
1072,3/19/2018,MEM,31,32,31,21,0,115,BRK,32,33,22,31,0,118
1073,3/28/2018,POR,28,30,23,22,0,103,MEM,20,33,23,32,0,108
1074,4/1/2018,MEM,24,27,24,23,0,98,POR,32,23,43,15,0,113
1075,4/11/2018,MEM,28,29,39,27,0,123,OKC,38,39,28,32,0,137
1076,10/17/2017,HOU,34,28,26,34,0,122,GSW,35,36,30,20,0,121
1077,10/25/2017,TOR,26,27,33,26,0,112,GSW,29,32,30,26,0,117
1078,10/30/2017,GSW,34,40,33,34,0,141,LAC,28,29,29,27,0,113
1079,11/2/2017,GSW,24,26,34,28,0,112,SAS,33,22,23,14,0,92
1080,11/4/2017,GSW,36,24,43,24,0,127,DEN,23,32,21,32,0,108
1081,11/13/2017,ORL,29,27,19,25,0,100,GSW,27,29,32,22,0,110
1082,11/19/2017,GSW,32,32,34,20,0,118,BRK,20,22,42,27,0,111
1083,11/22/2017,GSW,26,22,23,20,0,91,OKC,33,32,29,14,0,108
1084,12/1/2017,GSW,41,37,24,31,0,133,ORL,34,29,28,21,0,112
1085,12/11/2017,POR,28,19,28,29,0,104,GSW,27,33,33,18,0,111
1086,12/23/2017,DEN,22,31,20,23,0,96,GSW,20,21,21,19,0,81
1087,1/4/2018,GSW,33,29,31,31,0,124,HOU,37,26,27,24,0,114
1088,1/6/2018,GSW,31,33,39,18,0,121,LAC,28,27,21,29,0,105
1089,1/8/2018,DEN,28,29,24,33,0,114,GSW,37,27,29,31,0,124
1090,1/10/2018,LAC,32,26,39,28,0,125,GSW,35,27,28,16,0,106
1091,1/13/2018,GSW,43,38,27,19,0,127,TOR,35,19,35,36,0,125
1092,1/20/2018,GSW,28,30,33,17,0,108,HOU,40,25,27,24,0,116
1093,2/3/2018,GSW,32,24,27,25,0,108,DEN,29,26,22,38,0,115
1094,2/6/2018,OKC,42,28,29,26,0,125,GSW,30,27,20,28,0,105
1095,2/10/2018,SAS,37,18,20,30,0,105,GSW,27,31,33,31,0,122
1096,2/14/2018,GSW,27,24,36,30,0,117,POR,40,23,29,31,0,123
1097,2/22/2018,LAC,23,35,34,35,0,127,GSW,34,36,32,32,0,134
1098,2/24/2018,OKC,19,26,21,14,0,80,GSW,24,28,32,28,0,112
1099,3/6/2018,BRK,19,34,27,21,0,101,GSW,35,13,38,28,0,114
1100,3/8/2018,SAS,21,29,37,20,0,107,GSW,28,18,32,32,0,110
1101,3/9/2018,GSW,27,25,31,25,0,108,POR,33,28,26,38,0,125
1102,3/19/2018,GSW,21,20,22,12,0,75,SAS,30,19,12,28,0,89
1103,3/27/2018,IND,18,21,29,24,0,92,GSW,27,21,22,11,0,81
1104,4/3/2018,GSW,24,33,27,27,0,111,OKC,27,20,34,26,0,107
1105,4/5/2018,GSW,26,25,26,29,0,106,IND,27,35,35,29,0,126
1106,10/29/2017,DEN,29,31,40,24,0,124,BRK,36,27,21,27,0,111
1107,11/1/2017,TOR,19,27,25,40,0,111,DEN,34,26,43,26,0,129
1108,11/7/2017,BRK,21,25,27,31,0,104,DEN,28,29,36,19,0,112
1109,11/9/2017,OKC,28,25,22,19,0,94,DEN,22,29,24,27,0,102
1110,11/11/2017,ORL,23,24,30,30,0,107,DEN,39,31,28,27,0,125
1111,11/13/2017,DEN,21,28,17,16,0,82,POR,25,29,30,15,0,99
1112,11/22/2017,DEN,17,23,27,28,0,95,HOU,36,39,26,24,0,125
1113,12/8/2017,DEN,14,35,32,22,0,103,ORL,25,23,22,19,0,89
1114,12/10/2017,DEN,35,31,22,26,2,116,IND,22,37,31,24,12,126
1115,12/18/2017,DEN,18,26,32,18,0,94,OKC,32,20,18,25,0,95
1116,12/22/2017,DEN,28,24,28,22,0,102,POR,22,19,25,19,0,85
1117,1/13/2018,DEN,16,28,25,11,0,80,SAS,32,24,26,30,0,112
1118,1/17/2018,DEN,27,32,22,23,0,104,LAC,29,21,30,29,0,109
1119,1/22/2018,POR,19,30,29,23,0,101,DEN,20,25,31,28,0,104
1120,1/30/2018,DEN,30,25,26,23,0,104,SAS,30,30,20,26,0,106
1121,2/1/2018,OKC,33,24,32,35,0,124,DEN,40,32,32,23,0,127
1122,2/9/2018,DEN,23,23,24,34,0,104,HOU,35,28,34,33,0,130
1123,2/13/2018,SAS,32,29,29,19,0,109,DEN,30,28,29,30,0,117
1124,2/23/2018,SAS,30,31,28,30,0,119,DEN,32,31,33,26,0,122
1125,2/25/2018,HOU,38,28,26,27,0,119,DEN,25,27,27,35,0,114
1126,2/27/2018,LAC,24,28,29,41,0,122,DEN,33,25,30,32,0,120
1127,3/27/2018,DEN,23,35,27,25,0,110,TOR,25,33,24,32,0,114
1128,3/30/2018,DEN,27,35,30,22,12,126,OKC,28,30,21,35,11,125
1129,4/3/2018,IND,26,20,27,31,0,104,DEN,27,22,28,30,0,107
1130,4/7/2018,DEN,33,33,35,33,0,134,LAC,26,32,31,26,0,115
1131,4/9/2018,POR,23,26,20,13,0,82,DEN,28,14,24,22,0,88
1132,10/18/2017,BRK,30,33,35,33,0,131,IND,29,36,41,34,0,140
1133,10/20/2017,ORL,27,28,36,30,0,121,BRK,29,29,31,37,0,126
1134,10/24/2017,BRK,30,31,35,25,0,121,ORL,30,31,26,38,0,125
1135,11/10/2017,BRK,21,25,31,24,0,101,POR,28,24,18,27,0,97
1136,11/24/2017,POR,23,28,41,35,0,127,BRK,32,21,39,33,0,125
1137,11/27/2017,BRK,26,29,25,23,0,103,HOU,43,23,30,21,0,117
1138,12/7/2017,OKC,33,25,21,16,0,95,BRK,20,29,25,26,0,100
1139,12/15/2017,BRK,20,24,20,23,0,87,TOR,30,28,33,29,0,120
1140,12/17/2017,IND,28,31,21,29,0,109,BRK,29,19,24,25,0,97
1141,12/23/2017,BRK,28,29,24,30,8,119,IND,21,20,39,31,12,123
1142,12/26/2017,BRK,16,28,25,28,0,97,SAS,19,31,30,29,0,109
1143,1/1/2018,ORL,27,21,22,25,0,95,BRK,22,25,24,27,0,98
1144,1/8/2018,TOR,26,19,33,29,7,114,BRK,19,25,27,36,6,113
1145,1/17/2018,SAS,31,20,25,24,0,100,BRK,26,20,18,31,0,95
1146,1/23/2018,BRK,26,33,26,23,0,108,OKC,30,17,27,35,0,109
1147,2/6/2018,HOU,38,27,31,27,0,123,BRK,31,32,23,27,0,113
1148,2/12/2018,LAC,34,32,24,24,0,114,BRK,22,29,16,34,0,101
1149,2/14/2018,IND,22,32,19,35,0,108,BRK,23,31,25,24,0,103
1150,3/4/2018,BRK,27,26,33,34,0,120,LAC,32,33,26,32,0,123
1151,3/13/2018,TOR,32,25,30,29,0,116,BRK,40,27,18,17,0,102
1152,3/23/2018,BRK,32,32,27,21,0,112,TOR,31,28,25,32,0,116
1153,3/28/2018,BRK,36,22,27,26,0,111,ORL,33,18,30,23,0,104
1154,10/26/2017,LAC,30,32,18,24,0,104,POR,24,29,26,24,0,103
1155,11/7/2017,LAC,26,29,21,31,0,107,SAS,32,20,40,28,0,120
1156,11/10/2017,LAC,31,24,31,25,0,111,OKC,30,33,31,26,0,120
1157,12/11/2017,TOR,30,23,21,17,0,91,LAC,19,32,19,26,0,96
1158,12/13/2017,LAC,13,32,29,32,0,106,ORL,24,16,28,27,0,95
1159,12/18/2017,LAC,17,32,21,21,0,91,SAS,31,26,28,24,0,109
1160,12/22/2017,LAC,23,29,35,41,0,128,HOU,33,32,20,33,0,118
1161,1/4/2018,OKC,30,34,30,33,0,127,LAC,33,31,33,20,0,117
1162,1/15/2018,HOU,31,25,28,18,0,102,LAC,30,29,33,21,0,113
1163,1/30/2018,POR,30,26,30,18,0,104,LAC,27,24,16,29,0,96
1164,2/28/2018,HOU,34,27,22,22,0,105,LAC,12,31,29,20,0,92
1165,3/10/2018,ORL,27,31,31,16,0,105,LAC,30,26,31,26,0,113
1166,3/15/2018,LAC,26,25,23,22,0,96,HOU,28,19,31,23,0,101
1167,3/16/2018,LAC,30,26,28,29,0,113,OKC,27,36,26,32,0,121
1168,3/18/2018,POR,24,34,33,31,0,122,LAC,18,34,29,28,0,109
1169,3/23/2018,LAC,28,25,23,28,0,104,IND,27,31,24,27,0,109
1170,3/25/2018,LAC,28,25,27,37,0,117,TOR,35,25,20,26,0,106
1171,3/30/2018,LAC,23,26,17,30,0,96,POR,26,38,23,18,0,105
1172,4/1/2018,IND,22,28,26,35,0,111,LAC,30,21,27,26,0,104
1173,4/3/2018,SAS,31,25,27,27,0,110,LAC,17,32,23,41,0,113
1174,10/20/2017,POR,31,31,29,23,0,114,IND,25,27,21,23,0,96
1175,10/30/2017,TOR,29,25,27,18,0,99,POR,29,6,26,24,0,85
1176,11/5/2017,OKC,20,26,21,32,0,99,POR,28,22,28,25,0,103
1177,11/15/2017,ORL,33,14,24,23,0,94,POR,24,27,24,24,0,99
1178,12/9/2017,HOU,31,31,22,40,0,124,POR,37,25,36,19,0,117
1179,12/15/2017,POR,24,26,25,20,0,95,ORL,20,23,23,22,0,88
1180,12/20/2017,SAS,25,29,20,19,0,93,POR,22,24,26,19,0,91
1181,1/7/2018,SAS,27,26,27,30,0,110,POR,27,21,32,31,0,111
1182,1/9/2018,POR,24,30,34,29,0,117,OKC,26,24,26,30,0,106
1183,1/10/2018,POR,19,26,32,35,0,112,HOU,25,30,31,35,0,121
1184,1/18/2018,IND,28,19,27,12,0,86,POR,29,23,22,26,0,100
1185,2/2/2018,POR,18,34,28,25,0,105,TOR,37,37,27,29,0,130
1186,3/3/2018,OKC,28,22,25,25,0,100,POR,25,28,30,25,0,108
1187,3/20/2018,HOU,27,28,31,29,0,115,POR,31,24,32,24,0,111
1188,3/25/2018,POR,34,23,25,26,0,108,OKC,17,35,28,25,0,105
1189,4/5/2018,POR,17,27,27,23,0,94,HOU,36,30,18,12,0,96
1190,4/7/2018,POR,33,23,21,28,0,105,SAS,32,22,27,35,0,116
1191,10/25/2017,IND,27,21,26,22,0,96,OKC,30,24,32,28,0,114
1192,10/29/2017,SAS,24,24,16,30,0,94,IND,26,27,15,29,0,97
1193,11/12/2017,HOU,35,28,24,31,0,118,IND,18,33,20,24,0,95
1194,11/20/2017,IND,34,16,28,27,0,105,ORL,31,24,17,25,0,97
1195,11/24/2017,TOR,25,35,20,24,0,104,IND,29,21,31,26,0,107
1196,11/27/2017,ORL,25,25,34,25,0,109,IND,33,24,28,36,0,121
1197,11/29/2017,IND,27,22,22,26,0,97,HOU,22,32,35,29,0,118
1198,12/1/2017,IND,32,26,31,26,0,115,TOR,27,38,29,26,0,120
1199,12/13/2017,OKC,22,29,22,27,0,100,IND,27,19,23,26,0,95
1200,1/21/2018,IND,22,24,25,23,0,94,SAS,23,20,16,27,0,86
1201,1/27/2018,ORL,32,38,22,20,0,112,IND,22,31,31,30,0,114
1202,3/15/2018,TOR,25,24,28,29,0,106,IND,27,30,22,20,0,99
1203,4/6/2018,IND,14,19,16,24,0,73,TOR,26,19,27,20,0,92
1204,10/23/2017,TOR,23,27,24,23,0,97,SAS,21,29,25,26,0,101
1205,10/27/2017,SAS,18,16,30,23,0,87,ORL,32,29,34,19,0,114
1206,11/17/2017,OKC,32,23,23,23,0,101,SAS,15,33,30,26,0,104
1207,12/3/2017,SAS,18,25,30,14,0,87,OKC,25,29,22,14,0,90
1208,12/15/2017,SAS,16,27,29,37,0,109,HOU,31,29,32,32,0,124
1209,1/19/2018,SAS,18,19,23,23,0,83,TOR,17,27,19,23,0,86
1210,2/1/2018,HOU,27,27,28,20,0,102,SAS,14,24,32,21,0,91
1211,3/10/2018,SAS,19,24,25,26,0,94,OKC,24,28,25,27,0,104
1212,3/12/2018,SAS,21,22,24,26,0,93,HOU,25,29,34,21,0,109
1213,3/13/2018,ORL,18,19,20,15,0,72,SAS,24,38,34,12,0,108
1214,3/29/2018,OKC,29,27,25,18,0,99,SAS,24,35,18,26,0,103
1215,4/1/2018,HOU,17,21,28,17,0,83,SAS,26,20,29,25,0,100
1216,11/14/2017,TOR,31,45,27,26,0,129,HOU,33,31,30,19,0,113
1217,12/25/2017,HOU,31,26,31,19,0,107,OKC,28,30,30,24,0,112
1218,1/3/2018,HOU,25,30,34,27,0,116,ORL,12,29,25,32,0,98
1219,1/30/2018,ORL,30,25,33,19,0,107,HOU,27,27,36,24,0,114
1220,3/6/2018,HOU,26,28,33,35,0,122,OKC,24,21,29,38,0,112
1221,3/9/2018,HOU,16,27,32,30,0,105,TOR,32,26,25,25,0,108
1222,4/7/2018,OKC,36,25,19,28,0,108,HOU,30,32,21,19,0,102
1223,11/29/2017,OKC,25,32,23,28,0,108,ORL,31,28,28,34,0,121
1224,12/27/2017,TOR,38,25,25,19,0,107,OKC,32,34,36,22,0,124
1225,2/26/2018,ORL,38,24,15,28,0,105,OKC,31,30,23,28,0,112
1226,3/18/2018,OKC,40,26,31,35,0,132,TOR,34,30,34,27,0,125
1227,2/28/2018,TOR,42,27,21,27,0,117,ORL,37,26,26,15,0,104
1228,3/20/2018,TOR,24,28,16,25,0,93,ORL,25,26,25,10,0,86
1229,4/8/2018,ORL,24,26,24,27,0,101,TOR,35,26,28,23,0,112
